1894, Illinois, 5, 3, 0, 0.62500, 188, 76, 112, 
1967, Illinois, 4, 6, 0, 0.40000, 143, 213, -70, 
1968, Illinois, 1, 9, 0, 0.10000, 107, 333, -226, 
1969, Illinois, 0, 10, 0, 0.00000, 106, 397, -291, 
1970, Illinois, 3, 7, 0, 0.30000, 165, 279, -114, 
1986, Kansas, 3, 8, 0, 0.27273, 112, 327, -215, 
1987, Kansas, 1, 9, 1, 0.13636, 135, 398, -263, 
1948, Harvard (MA), 4, 4, 0, 0.50000, 130, 184, -54, 
1949, Harvard (MA), 1, 8, 0, 0.11111, 103, 276, -173, 
1950, Connecticut, 3, 5, 0, 0.37500, 82, 134, -52, 
1951, Connecticut, 4, 4, 0, 0.50000, 106, 102, 4, 
1913, Fort Hays St. (KS), 4, 2, 0, 0.66667, 289, 45, 244, 
1914, Fort Hays St. (KS), 5, 2, 0, 0.71429, 180, 41, 139, 
1955, Tuskegee (AL), 2, 6, 2, 0.30000, 97, 126, -29, 
1956, Tuskegee (AL), 6, 3, 0, 0.66667, 197, 128, 69, 
1957, Tuskegee (AL), 4, 4, 0, 0.50000, 140, 111, 29, 
1958, Tuskegee (AL), 6, 3, 1, 0.65000, 183, 118, 65, 
1959, Tuskegee (AL), 4, 4, 1, 0.50000, 124, 97, 27, 
1960, Tuskegee (AL), 7, 2, 0, 0.77778, 168, 100, 68, 
1961, Tuskegee (AL), 4, 4, 1, 0.50000, 145, 136, 9, 
1962, Tuskegee (AL), 4, 5, 0, 0.44444, 124, 112, 12, 
1963, Tuskegee (AL), 5, 4, 0, 0.55556, 156, 171, -15, 
1964, Alabama St., 4, 6, 0, 0.40000, 99, 145, -46, 
1965, Alabama St., 6, 4, 0, 0.60000, 207, 222, -15, 
1966, Alabama St., 8, 2, 0, 0.80000, 256, 138, 118, 
1967, Alabama St., 9, 1, 0, 0.90000, 240, 105, 135, 
1968, Alabama St., 8, 1, 1, 0.85000, 317, 166, 151, 
1969, Hampton (VA), 0, 9, 0, 0.00000, 53, 257, -204, 
1970, Hampton (VA), 0, 9, 0, 0.00000, 56, 403, -347, 
1971, Hampton (VA), 1, 9, 0, 0.10000, 89, 309, -220, 
1972, Hampton (VA), 1, 10, 0, 0.09091, 79, 276, -197, 
1973, Hampton (VA), 1, 7, 2, 0.20000, 59, 184, -125, 
2013, Carroll (MT), 12, 2, 0, 0.85714, 477, 230, 247, 
1916, Texas, 7, 2, 0, 0.77778, 218, 35, 183, 
1920, California-Davis, 3, 4, 1, 0.43750, 61, 67, -6, 
1921, Stanford (CA), 4, 2, 2, 0.62500, 100, 97, 3, 
1902, Rutgers (NJ), 3, 7, 0, 0.30000, 42, 188, -146, 
1908, Sewanee (TN), 4, 1, 3, 0.68750, 94, 20, 74, 
1920, Texas-El Paso, 2, 4, 0, 0.33333, 73, 180, -107, 
1926, Elon (NC), 0, 10, 0, 0.00000, 20, 284, -264, 
1982, Angelo St. (TX), 2, 8, 0, 0.20000, 269, 205, 64, 
1983, Angelo St. (TX), 5, 6, 0, 0.45455, 165, 196, -31, 
1984, Angelo St. (TX), 8, 3, 0, 0.72727, 254, 126, 128, 
1985, Angelo St. (TX), 7, 4, 0, 0.63636, 306, 199, 107, 
1986, Angelo St. (TX), 6, 5, 0, 0.54545, 298, 299, -1, 
1987, Angelo St. (TX), 8, 3, 0, 0.72727, 260, 175, 85, 
1988, Angelo St. (TX), 6, 4, 0, 0.60000, 322, 182, 140, 
1989, Angelo St. (TX), 11, 3, 0, 0.78571, 466, 285, 181, 
1990, Angelo St. (TX), 7, 3, 0, 0.70000, 258, 152, 106, 
1991, Angelo St. (TX), 6, 3, 1, 0.65000, 285, 134, 151, 
1992, Angelo St. (TX), 5, 5, 0, 0.50000, 204, 127, 77, 
1993, Angelo St. (TX), 7, 3, 0, 0.70000, 296, 159, 137, 
1994, Angelo St. (TX), 6, 5, 0, 0.54545, 247, 202, 45, 
1995, Angelo St. (TX), 6, 3, 1, 0.65000, 225, 137, 88, 
1996, Angelo St. (TX), 6, 4, 0, 0.60000, 282, 231, 51, 
1997, Angelo St. (TX), 10, 2, 0, 0.83333, 409, 241, 168, 
1998, Angelo St. (TX), 6, 4, 0, 0.60000, 216, 206, 10, 
1999, Angelo St. (TX), 7, 4, 0, 0.63636, 308, 247, 61, 
2000, Angelo St. (TX), 6, 4, 0, 0.60000, 227, 138, 89, 
2001, Angelo St. (TX), 6, 4, 0, 0.60000, 170, 185, -15, 
2002, Angelo St. (TX), 2, 8, 0, 0.20000, 164, 273, -109, 
2003, Angelo St. (TX), 3, 8, 0, 0.27273, 200, 341, -141, 
2004, Angelo St. (TX), 2, 9, 0, 0.18182, 247, 373, -126, 
1997, Maryland, 2, 9, 0, 0.18182, 161, 355, -194, 
1998, Maryland, 3, 8, 0, 0.27273, 202, 290, -88, 
1999, Maryland, 5, 6, 0, 0.45455, 292, 260, 32, 
2000, Maryland, 5, 6, 0, 0.45455, 247, 284, -37, 
1923, Florida, 6, 1, 2, 0.77778, 179, 60, 119, 
1924, Florida, 6, 2, 2, 0.70000, 211, 44, 167, 
2006, Georgia Southern, 3, 8, 0, 0.27273, 235, 260, -25, 
1949, Southern Mississippi, 7, 3, 0, 0.70000, 299, 274, 25, 
1950, Southern Mississippi, 5, 5, 0, 0.50000, 134, 233, -99, 
1951, Southern Mississippi, 6, 5, 0, 0.54545, 306, 132, 174, 
1952, Southern Mississippi, 10, 2, 0, 0.83333, 409, 189, 220, 
1953, Southern Mississippi, 9, 2, 0, 0.81818, 280, 122, 158, 
1954, Southern Mississippi, 6, 4, 0, 0.60000, 172, 103, 69, 
1955, Southern Mississippi, 9, 1, 0, 0.90000, 277, 49, 228, 
1956, Southern Mississippi, 7, 2, 1, 0.75000, 219, 92, 127, 
1957, Southern Mississippi, 8, 3, 0, 0.72727, 152, 72, 80, 
1958, Southern Mississippi, 9, 0, 0, 1.00000, 210, 55, 155, 
1959, Southern Mississippi, 6, 4, 0, 0.60000, 171, 122, 49, 
1960, Southern Mississippi, 6, 4, 0, 0.60000, 189, 96, 93, 
1961, Southern Mississippi, 8, 2, 0, 0.80000, 183, 68, 115, 
1962, Southern Mississippi, 9, 1, 0, 0.90000, 265, 67, 198, 
1963, Southern Mississippi, 5, 3, 1, 0.61111, 128, 64, 64, 
1964, Southern Mississippi, 6, 3, 0, 0.66667, 143, 144, -1, 
1965, Southern Mississippi, 7, 2, 0, 0.77778, 127, 60, 67, 
1966, Southern Mississippi, 6, 4, 0, 0.60000, 156, 103, 53, 
1967, Southern Mississippi, 6, 3, 0, 0.66667, 201, 114, 87, 
1968, Southern Mississippi, 4, 6, 0, 0.40000, 228, 231, -3, 
1980, Lenoir-Rhyne (NC), 4, 7, 0, 0.36364, 176, 300, -124, 
1981, Lenoir-Rhyne (NC), 2, 9, 0, 0.18182, 152, 290, -138, 
1982, Lenoir-Rhyne (NC), 6, 5, 1, 0.54167, 196, 217, -21, 
1983, Lenoir-Rhyne (NC), 4, 6, 0, 0.40000, 119, 166, -47, 
1908, Gonzaga (WA), 1, 0, 0, 1.00000, 17, 0, 17, 
1909, Gonzaga (WA), 1, 0, 0, 1.00000, 17, 0, 17, 
1910, Gonzaga (WA), 3, 1, 0, 0.75000, 74, 57, 17, 
1911, Gonzaga (WA), 1, 3, 1, 0.30000, 63, 107, -44, 
1960, Fort Valley St. (GA), 1, 5, 3, 0.27778, 39, 123, -84, 
1962, Fort Valley St. (GA), 2, 7, 0, 0.22222, 95, 156, -61, 
1915, Virginia, 8, 1, 0, 0.88889, 219, 26, 193, 
1953, Elon (NC), 1, 6, 1, 0.18750, 97, 196, -99, 
1954, Elon (NC), 5, 3, 1, 0.61111, 143, 130, 13, 
1955, Elon (NC), 3, 7, 0, 0.30000, 113, 175, -62, 
1956, Elon (NC), 5, 5, 0, 0.50000, 192, 151, 41, 
1957, Elon (NC), 6, 0, 0, 1.00000, 161, 60, 101, 
1958, Elon (NC), 3, 6, 0, 0.33333, 112, 171, -59, 
1959, Elon (NC), 1, 9, 0, 0.10000, 94, 259, -165, 
1952, Hawaii, 5, 5, 2, 0.50000, 285, 280, 5, 
1953, Hawaii, 5, 6, 0, 0.45455, 189, 216, -27, 
1954, Hawaii, 4, 4, 0, 0.50000, 133, 178, -45, 
1955, Hawaii, 8, 3, 0, 0.72727, 187, 166, 21, 
1956, Hawaii, 7, 3, 0, 0.70000, 291, 113, 178, 
1957, Hawaii, 4, 4, 1, 0.50000, 152, 96, 56, 
1958, Hawaii, 5, 7, 0, 0.41667, 139, 260, -121, 
1959, Hawaii, 3, 6, 0, 0.33333, 100, 174, -74, 
1960, Hawaii, 3, 7, 0, 0.30000, 113, 200, -87, 
1911, Ohio St., 5, 3, 2, 0.60000, 47, 40, 7, 
1915, Fordham (NY), 4, 4, 0, 0.50000, 72, 85, -13, 
1905, Lake Forest (IL), 6, 5, 0, 0.54545, 158, 114, 44, 
1906, Lake Forest (IL), 3, 2, 0, 0.60000, 55, 26, 29, 
1919, Wabash (IN), 4, 3, 2, 0.55556, 217, 67, 150, 
1920, Wabash (IN), 3, 4, 0, 0.42857, 103, 91, 12, 
1921, Wabash (IN), 7, 2, 0, 0.77778, 146, 31, 115, 
1922, Wabash (IN), 7, 3, 0, 0.70000, 210, 68, 142, 
1923, Wabash (IN), 4, 3, 2, 0.55556, 100, 62, 38, 
1924, Wabash (IN), 5, 4, 0, 0.55556, 125, 108, 17, 
1925, Wabash (IN), 5, 3, 1, 0.61111, 148, 88, 60, 
1926, Wabash (IN), 5, 4, 0, 0.55556, 177, 135, 42, 
1927, Wabash (IN), 7, 2, 0, 0.77778, 134, 74, 60, 
1928, Wabash (IN), 4, 4, 1, 0.50000, 108, 80, 28, 
1929, Wabash (IN), 4, 5, 0, 0.44444, 62, 151, -89, 
1930, Wabash (IN), 3, 6, 0, 0.33333, 89, 119, -30, 
1931, Wabash (IN), 3, 5, 1, 0.38889, 90, 152, -62, 
1932, Wabash (IN), 4, 2, 2, 0.62500, 110, 53, 57, 
1933, Wabash (IN), 4, 2, 1, 0.64286, 57, 49, 8, 
1934, Wabash (IN), 4, 2, 2, 0.62500, 62, 59, 3, 
1935, Wabash (IN), 6, 1, 1, 0.81250, 209, 30, 179, 
1936, Wabash (IN), 7, 1, 0, 0.87500, 129, 17, 112, 
1937, Wabash (IN), 3, 3, 2, 0.50000, 82, 71, 11, 
1938, Wabash (IN), 1, 6, 1, 0.18750, 40, 140, -100, 
1939, Wabash (IN), 3, 5, 1, 0.38889, 26, 129, -103, 
1940, Wabash (IN), 4, 4, 1, 0.50000, 79, 76, 3, 
1941, Wabash (IN), 5, 3, 1, 0.61111, 113, 102, 11, 
1942, Wabash (IN), 4, 2, 1, 0.64286, 104, 38, 66, 
1943, Wabash (IN), 1, 2, 1, 0.37500, 35, 92, -57, 
1944, Wabash (IN), 6, 1, 2, 0.77778, 184, 84, 100, 
1945, Wabash (IN), 2, 3, 1, 0.41667, 95, 77, 18, 
1931, Morehouse (GA), 2, 5, 1, 0.31250, 50, 99, -49, 
1932, Morehouse (GA), 3, 4, 1, 0.43750, 64, 71, -7, 
1947, Mississippi, 9, 2, 0, 0.81818, 269, 110, 159, 
1948, Mississippi, 8, 1, 0, 0.88889, 226, 93, 133, 
1949, Mississippi, 4, 5, 1, 0.45000, 246, 243, 3, 
1950, Mississippi, 5, 5, 0, 0.50000, 207, 183, 24, 
1951, Mississippi, 6, 3, 1, 0.65000, 254, 157, 97, 
1952, Mississippi, 8, 1, 2, 0.81818, 244, 120, 124, 
1953, Mississippi, 7, 2, 1, 0.75000, 236, 113, 123, 
1954, Mississippi, 9, 2, 0, 0.81818, 283, 68, 215, 
1955, Mississippi, 10, 1, 0, 0.90909, 265, 110, 155, 
1956, Mississippi, 7, 3, 0, 0.70000, 207, 82, 125, 
1957, Mississippi, 9, 1, 1, 0.86364, 271, 59, 212, 
1958, Mississippi, 9, 2, 0, 0.81818, 222, 68, 154, 
1959, Mississippi, 10, 1, 0, 0.90909, 350, 21, 329, 
1960, Mississippi, 10, 0, 1, 0.95455, 280, 70, 210, 
1961, Mississippi, 9, 2, 0, 0.81818, 333, 52, 281, 
1962, Mississippi, 10, 0, 0, 1.00000, 247, 53, 194, 
1963, Mississippi, 7, 1, 2, 0.80000, 214, 45, 169, 
1964, Mississippi, 5, 5, 1, 0.50000, 217, 127, 90, 
1965, Mississippi, 7, 4, 0, 0.63636, 179, 115, 64, 
1966, Mississippi, 8, 3, 0, 0.72727, 170, 65, 105, 
1967, Mississippi, 6, 4, 1, 0.59091, 181, 165, 16, 
1968, Mississippi, 7, 3, 1, 0.68182, 212, 197, 15, 
1969, Mississippi, 8, 3, 0, 0.72727, 334, 162, 172, 
1970, Mississippi, 7, 4, 0, 0.63636, 313, 255, 58, 
1973, Mississippi, 5, 3, 0, 0.62500, 165, 137, 28, 
1927, Kentucky St., 0, 2, 0, 0.00000, 0, 77, -77, 
1893, Maine, 0, 5, 0, 0.00000, 24, 122, -98, 
1931, Iowa St., 5, 3, 0, 0.62500, 72, 74, -2, 
1932, Iowa St., 3, 4, 1, 0.43750, 105, 101, 4, 
1933, Iowa St., 3, 5, 1, 0.38889, 73, 120, -47, 
1934, Iowa St., 5, 3, 1, 0.61111, 132, 66, 66, 
1935, Iowa St., 2, 4, 3, 0.38889, 82, 101, -19, 
1936, Iowa St., 3, 3, 2, 0.50000, 94, 112, -18, 
1912, North Dakota, 1, 4, 0, 0.20000, 9, 110, -101, 
2008, Bluffton (OH), 1, 9, 0, 0.10000, 103, 377, -274, 
2009, Bluffton (OH), 0, 10, 0, 0.00000, 123, 370, -247, 
2010, Bluffton (OH), 4, 6, 0, 0.40000, 187, 336, -149, 
2011, Bluffton (OH), 5, 5, 0, 0.50000, 238, 284, -46, 
2012, Bluffton (OH), 6, 4, 0, 0.60000, 188, 217, -29, 
2013, Bluffton (OH), 4, 6, 0, 0.40000, 207, 298, -91, 
1945, Augsburg (MN), 0, 3, 0, 0.00000, 0, 98, -98, 
1962, Indianapolis (IN), 1, 6, 2, 0.22222, 128, 278, -150, 
1963, Indianapolis (IN), 3, 6, 0, 0.33333, 147, 204, -57, 
1964, Indianapolis (IN), 3, 6, 0, 0.33333, 138, 261, -123, 
1965, Indianapolis (IN), 6, 3, 0, 0.66667, 163, 157, 6, 
1966, Indianapolis (IN), 1, 8, 0, 0.11111, 64, 216, -152, 
1946, Hanover (IN), 4, 3, 0, 0.57143, 76, 74, 2, 
1948, Florida St., 7, 1, 0, 0.87500, 152, 64, 88, 
1949, Florida St., 9, 1, 0, 0.90000, 291, 59, 232, 
1950, Florida St., 8, 0, 0, 1.00000, 219, 54, 165, 
1951, Florida St., 6, 2, 0, 0.75000, 194, 72, 122, 
1952, Florida St., 1, 8, 1, 0.15000, 101, 261, -160, 
1978, Northwestern (IL), 0, 10, 1, 0.04545, 92, 440, -348, 
1979, Northwestern (IL), 1, 10, 0, 0.09091, 115, 386, -271, 
1980, Northwestern (IL), 0, 11, 0, 0.00000, 151, 444, -293, 
1929, Howard (DC), 0, 7, 2, 0.11111, 6, 129, -123, 
1930, Howard (DC), 4, 3, 1, 0.56250, 84, 50, 34, 
1931, Howard (DC), 3, 5, 0, 0.37500, 111, 101, 10, 
1932, Howard (DC), 4, 4, 0, 0.50000, 76, 71, 5, 
1933, Howard (DC), 3, 5, 0, 0.37500, 64, 93, -29, 
1948, Saint Mary's (CA), 4, 6, 0, 0.40000, 150, 161, -11, 
1949, Saint Mary's (CA), 3, 6, 1, 0.35000, 168, 243, -75, 
2005, Fort Hays St. (KS), 2, 8, 0, 0.20000, 137, 383, -246, 
2006, Fort Hays St. (KS), 1, 10, 0, 0.09091, 153, 367, -214, 
2007, Fort Hays St. (KS), 4, 7, 0, 0.36364, 201, 235, -34, 
2008, Fort Hays St. (KS), 2, 9, 0, 0.18182, 175, 295, -120, 
2009, Fort Hays St. (KS), 6, 5, 0, 0.54545, 365, 402, -37, 
2010, Fort Hays St. (KS), 3, 8, 0, 0.27273, 313, 352, -39, 
1974, UCLA, 6, 3, 2, 0.63636, 240, 174, 66, 
1975, UCLA, 9, 2, 1, 0.79167, 349, 243, 106, 
1941, Idaho St., 5, 1, 2, 0.75000, 138, 53, 85, 
1942, Idaho St., 4, 2, 0, 0.66667, 77, 60, 17, 
1944, Idaho St., 4, 5, 0, 0.44444, 94, 199, -105, 
1946, Idaho St., 4, 3, 1, 0.56250, 75, 146, -71, 
1947, Idaho St., 3, 5, 1, 0.38889, 166, 137, 29, 
1948, Idaho St., 6, 1, 1, 0.81250, 169, 105, 64, 
1949, Idaho St., 6, 2, 1, 0.72222, 222, 137, 85, 
1950, Idaho St., 4, 4, 0, 0.50000, 180, 105, 75, 
1951, Idaho St., 5, 4, 0, 0.55556, 158, 186, -28, 
2006, McNeese St. (LA), 6, 2, 0, 0.75000, 193, 169, 24, 
2007, McNeese St. (LA), 11, 1, 0, 0.91667, 422, 220, 202, 
2008, McNeese St. (LA), 7, 4, 0, 0.63636, 413, 322, 91, 
2009, McNeese St. (LA), 9, 3, 0, 0.75000, 420, 327, 93, 
2010, McNeese St. (LA), 6, 5, 0, 0.54545, 241, 274, -33, 
2011, McNeese St. (LA), 6, 5, 0, 0.54545, 281, 276, 5, 
2012, McNeese St. (LA), 7, 4, 0, 0.63636, 357, 233, 124, 
2013, McNeese St. (LA), 10, 3, 0, 0.76923, 520, 370, 150, 
2010, Saint Francis (PA), 1, 10, 0, 0.09091, 177, 360, -183, 
2011, Saint Francis (PA), 2, 9, 0, 0.18182, 303, 485, -182, 
2012, Saint Francis (PA), 5, 6, 0, 0.45455, 307, 333, -26, 
2013, Saint Francis (PA), 5, 6, 0, 0.45455, 239, 240, -1, 
1908, Marshall (WV), 2, 6, 0, 0.25000, 36, 113, -77, 
1980, Glenville St. (WV), 1, 8, 1, 0.15000, 151, 281, -130, 
1981, Glenville St. (WV), 1, 8, 0, 0.11111, 89, 238, -149, 
1982, Glenville St. (WV), 3, 6, 1, 0.35000, 136, 118, 18, 
1983, Glenville St. (WV), 6, 2, 1, 0.72222, 119, 84, 35, 
1984, Glenville St. (WV), 6, 3, 0, 0.66667, 153, 110, 43, 
1985, Glenville St. (WV), 2, 7, 0, 0.22222, 96, 203, -107, 
1986, Glenville St. (WV), 2, 8, 0, 0.20000, 85, 222, -137, 
1926, Lamar (TX), 2, 4, 0, 0.33333, 40, 125, -85, 
1985, Fort Hays St. (KS), 7, 2, 1, 0.75000, 297, 204, 93, 
1986, Fort Hays St. (KS), 4, 6, 0, 0.40000, 251, 208, 43, 
1987, Fort Hays St. (KS), 5, 5, 0, 0.50000, 216, 331, -115, 
1988, Fort Hays St. (KS), 3, 6, 1, 0.35000, 170, 259, -89, 
1989, Fort Hays St. (KS), 3, 7, 0, 0.30000, 196, 261, -65, 
1972, San Diego (CA), 6, 3, 1, 0.65000, 209, 174, 35, 
1973, San Diego (CA), 9, 2, 1, 0.79167, 455, 169, 286, 
2009, Truman St. (MO), 2, 9, 0, 0.18182, 190, 371, -181, 
1915, Saint Francis (PA), 2, 3, 0, 0.40000, 56, 95, -39, 
1947, Northwestern (IL), 3, 6, 0, 0.33333, 129, 196, -67, 
1948, Northwestern (IL), 8, 2, 0, 0.80000, 191, 91, 100, 
1949, Northwestern (IL), 4, 5, 0, 0.44444, 137, 156, -19, 
1950, Northwestern (IL), 6, 3, 0, 0.66667, 155, 143, 12, 
1951, Northwestern (IL), 5, 4, 0, 0.55556, 112, 124, -12, 
1952, Northwestern (IL), 2, 6, 1, 0.27778, 166, 252, -86, 
1953, Northwestern (IL), 3, 6, 0, 0.33333, 166, 205, -39, 
1954, Northwestern (IL), 2, 7, 0, 0.22222, 101, 142, -41, 
1995, Cal St.-Sacramento, 4, 6, 1, 0.40909, 255, 377, -122, 
1996, Cal St.-Sacramento, 1, 10, 0, 0.09091, 248, 466, -218, 
1997, Cal St.-Sacramento, 1, 10, 0, 0.09091, 188, 408, -220, 
1998, Cal St.-Sacramento, 5, 6, 0, 0.45455, 289, 300, -11, 
1999, Cal St.-Sacramento, 6, 5, 0, 0.54545, 414, 310, 104, 
2000, Cal St.-Sacramento, 7, 4, 0, 0.63636, 329, 279, 50, 
2001, Cal St.-Sacramento, 2, 9, 0, 0.18182, 249, 424, -175, 
2002, Cal St.-Sacramento, 5, 7, 0, 0.41667, 325, 380, -55, 
1935, Central Missouri St., 3, 4, 1, 0.43750, 118, 65, 53, 
1936, Central Missouri St., 6, 2, 0, 0.75000, 101, 63, 38, 
1937, Central Missouri St., 7, 1, 0, 0.87500, 121, 39, 82, 
1938, Central Missouri St., 2, 5, 1, 0.31250, 104, 100, 4, 
1939, Central Missouri St., 3, 3, 3, 0.50000, 80, 70, 10, 
1940, Central Missouri St., 5, 4, 0, 0.55556, 91, 64, 27, 
1941, Central Missouri St., 3, 2, 3, 0.56250, 47, 33, 14, 
1942, Central Missouri St., 0, 7, 0, 0.00000, 41, 235, -194, 
1943, Central Missouri St., 4, 4, 2, 0.50000, 143, 99, 44, 
1926, Clarion (PA), 1, 2, 2, 0.40000, 28, 43, -15, 
1996, Hawaii, 2, 10, 0, 0.16667, 161, 433, -272, 
1997, Hawaii, 3, 9, 0, 0.25000, 189, 308, -119, 
1998, Hawaii, 0, 12, 0, 0.00000, 149, 422, -273, 
2006, Butler (IN), 3, 8, 0, 0.27273, 156, 331, -175, 
2007, Butler (IN), 4, 7, 0, 0.36364, 241, 345, -104, 
2008, Butler (IN), 6, 5, 0, 0.54545, 326, 269, 57, 
2009, Butler (IN), 11, 1, 0, 0.91667, 332, 229, 103, 
2010, Butler (IN), 4, 7, 0, 0.36364, 202, 211, -9, 
2011, Butler (IN), 5, 6, 0, 0.45455, 282, 298, -16, 
2012, Butler (IN), 8, 3, 0, 0.72727, 302, 243, 59, 
2013, Butler (IN), 9, 4, 0, 0.69231, 433, 349, 84, 
1958, Virginia, 1, 9, 0, 0.10000, 89, 301, -212, 
1959, Virginia, 0, 10, 0, 0.00000, 80, 393, -313, 
1960, Virginia, 0, 10, 0, 0.00000, 103, 332, -229, 
2013, Saint John Fisher (NY), 10, 3, 0, 0.76923, 410, 275, 135, 
1922, Texas-El Paso, 5, 4, 0, 0.55556, 157, 108, 49, 
1923, Texas-El Paso, 3, 4, 0, 0.42857, 115, 65, 50, 
1939, William & Mary (VA), 6, 2, 1, 0.72222, 158, 95, 63, 
1940, William & Mary (VA), 6, 2, 1, 0.72222, 185, 60, 125, 
1941, William & Mary (VA), 8, 2, 0, 0.80000, 259, 64, 195, 
1942, William & Mary (VA), 9, 1, 1, 0.86364, 245, 55, 190, 
1944, Auburn (AL), 4, 4, 0, 0.50000, 181, 137, 44, 
1945, Auburn (AL), 5, 5, 0, 0.50000, 172, 129, 43, 
1946, Auburn (AL), 4, 6, 0, 0.40000, 132, 210, -78, 
1947, Auburn (AL), 2, 7, 0, 0.22222, 78, 204, -126, 
1962, Mount Union (OH), 3, 6, 0, 0.33333, 107, 144, -37, 
1963, Mount Union (OH), 1, 8, 0, 0.11111, 55, 221, -166, 
1964, Mount Union (OH), 4, 5, 0, 0.44444, 109, 152, -43, 
1965, Mount Union (OH), 7, 2, 0, 0.77778, 229, 106, 123, 
1966, Mount Union (OH), 4, 5, 0, 0.44444, 119, 80, 39, 
1967, Mount Union (OH), 2, 6, 1, 0.27778, 97, 98, -1, 
1968, Mount Union (OH), 5, 4, 0, 0.55556, 144, 90, 54, 
1969, Mount Union (OH), 5, 4, 0, 0.55556, 263, 147, 116, 
1970, Mount Union (OH), 8, 1, 0, 0.88889, 312, 168, 144, 
1971, Mount Union (OH), 7, 2, 0, 0.77778, 228, 123, 105, 
1972, Mount Union (OH), 1, 8, 0, 0.11111, 123, 196, -73, 
1973, Mount Union (OH), 3, 6, 0, 0.33333, 159, 215, -56, 
1974, Mount Union (OH), 7, 2, 0, 0.77778, 197, 131, 66, 
1975, Mount Union (OH), 7, 2, 0, 0.77778, 280, 82, 198, 
1976, Mount Union (OH), 3, 6, 0, 0.33333, 95, 141, -46, 
1977, Mount Union (OH), 4, 5, 0, 0.44444, 144, 144, 0, 
1978, Mount Union (OH), 4, 4, 1, 0.50000, 192, 184, 8, 
1979, Mount Union (OH), 7, 2, 0, 0.77778, 240, 129, 111, 
1980, Mount Union (OH), 5, 4, 0, 0.55556, 138, 100, 38, 
1981, Mount Union (OH), 5, 4, 0, 0.55556, 187, 109, 78, 
1982, Mount Union (OH), 8, 1, 0, 0.88889, 262, 106, 156, 
1983, Mount Union (OH), 6, 3, 0, 0.66667, 221, 137, 84, 
1984, Mount Union (OH), 6, 4, 0, 0.60000, 260, 167, 93, 
1985, Mount Union (OH), 11, 1, 0, 0.91667, 401, 121, 280, 
1976, North Dakota St., 9, 3, 0, 0.75000, 221, 125, 96, 
1977, North Dakota St., 9, 2, 1, 0.79167, 374, 163, 211, 
1978, North Dakota St., 6, 4, 0, 0.60000, 308, 187, 121, 
1979, Texas St., 7, 4, 0, 0.63636, 271, 202, 69, 
1980, Texas St., 8, 3, 0, 0.72727, 356, 140, 216, 
1981, Texas St., 13, 1, 0, 0.92857, 554, 138, 416, 
1982, Texas St., 14, 0, 0, 1.00000, 446, 199, 247, 
1983, Texas Christian, 1, 8, 2, 0.18182, 174, 252, -78, 
1984, Texas Christian, 8, 4, 0, 0.66667, 376, 280, 96, 
1985, Texas Christian, 3, 8, 0, 0.27273, 150, 383, -233, 
1986, Texas Christian, 3, 8, 0, 0.27273, 259, 376, -117, 
1987, Texas Christian, 5, 6, 0, 0.45455, 261, 226, 35, 
1988, Texas Christian, 4, 7, 0, 0.36364, 206, 286, -80, 
1989, Texas Christian, 4, 7, 0, 0.36364, 183, 301, -118, 
1990, Texas Christian, 5, 6, 0, 0.45455, 292, 353, -61, 
1991, Texas Christian, 7, 4, 0, 0.63636, 279, 267, 12, 
1992, Minnesota, 2, 9, 0, 0.18182, 200, 313, -113, 
1993, Minnesota, 4, 7, 0, 0.36364, 253, 354, -101, 
1994, Minnesota, 3, 8, 0, 0.27273, 256, 348, -92, 
1995, Minnesota, 3, 8, 0, 0.27273, 272, 368, -96, 
1996, Minnesota, 4, 7, 0, 0.36364, 236, 340, -104, 
2013, Marietta (OH), 1, 9, 0, 0.10000, 159, 444, -285, 
1968, Tennessee Tech, 2, 8, 0, 0.20000, 82, 179, -97, 
1969, Tennessee Tech, 5, 5, 0, 0.50000, 209, 218, -9, 
1970, Tennessee Tech, 4, 6, 0, 0.40000, 130, 185, -55, 
1971, Tennessee Tech, 8, 2, 0, 0.80000, 189, 89, 100, 
1972, Tennessee Tech, 10, 2, 0, 0.83333, 236, 158, 78, 
1973, Tennessee Tech, 2, 8, 1, 0.22727, 125, 224, -99, 
1974, Tennessee Tech, 6, 5, 0, 0.54545, 174, 130, 44, 
1975, Tennessee Tech, 8, 3, 0, 0.72727, 225, 89, 136, 
1976, Tennessee Tech, 8, 3, 0, 0.72727, 276, 180, 96, 
1977, Tennessee Tech, 9, 2, 0, 0.81818, 343, 233, 110, 
1978, Tennessee Tech, 5, 6, 0, 0.45455, 203, 248, -45, 
1979, Tennessee Tech, 1, 8, 2, 0.18182, 103, 232, -129, 
1980, Tennessee Tech, 4, 7, 0, 0.36364, 165, 266, -101, 
1981, Tennessee Tech, 6, 5, 0, 0.54545, 229, 231, -2, 
1982, Tennessee Tech, 3, 8, 0, 0.27273, 165, 254, -89, 
1895, DePauw (IN), 3, 3, 1, 0.50000, 70, 68, 2, 
1897, Syracuse (NY), 5, 3, 1, 0.61111, 160, 48, 112, 
1898, Syracuse (NY), 8, 2, 1, 0.77273, 192, 69, 123, 
1899, Syracuse (NY), 4, 4, 0, 0.50000, 63, 63, 0, 
1951, Truman St. (MO), 7, 1, 1, 0.83333, 170, 99, 71, 
1952, Truman St. (MO), 7, 1, 0, 0.87500, 213, 61, 152, 
1953, Truman St. (MO), 6, 2, 0, 0.75000, 153, 99, 54, 
1954, Truman St. (MO), 7, 1, 0, 0.87500, 149, 45, 104, 
1955, Truman St. (MO), 3, 5, 0, 0.37500, 92, 134, -42, 
1956, Truman St. (MO), 3, 5, 0, 0.37500, 154, 207, -53, 
1957, Truman St. (MO), 4, 5, 0, 0.44444, 175, 185, -10, 
1958, Truman St. (MO), 5, 4, 0, 0.55556, 213, 186, 27, 
1959, Truman St. (MO), 7, 1, 1, 0.83333, 165, 122, 43, 
1960, Truman St. (MO), 8, 1, 0, 0.88889, 216, 85, 131, 
1961, Truman St. (MO), 9, 1, 0, 0.90000, 218, 86, 132, 
1962, Truman St. (MO), 7, 2, 0, 0.77778, 334, 102, 232, 
1963, Truman St. (MO), 8, 2, 0, 0.80000, 229, 77, 152, 
1964, Truman St. (MO), 7, 2, 0, 0.77778, 217, 112, 105, 
1965, Truman St. (MO), 8, 2, 0, 0.80000, 279, 120, 159, 
1966, Truman St. (MO), 3, 6, 0, 0.33333, 156, 192, -36, 
1923, Alabama, 7, 2, 1, 0.75000, 222, 50, 172, 
1924, Alabama, 8, 1, 0, 0.88889, 290, 24, 266, 
1925, Alabama, 10, 0, 0, 1.00000, 297, 26, 271, 
1926, Alabama, 9, 0, 1, 0.95000, 249, 27, 222, 
1927, Alabama, 5, 4, 1, 0.55000, 154, 73, 81, 
1928, Alabama, 6, 3, 0, 0.66667, 187, 75, 112, 
1929, Alabama, 6, 3, 0, 0.66667, 196, 58, 138, 
1930, Alabama, 10, 0, 0, 1.00000, 271, 13, 258, 
1931, Duke (NC), 5, 3, 2, 0.60000, 74, 46, 28, 
1932, Duke (NC), 7, 3, 0, 0.70000, 153, 40, 113, 
1933, Duke (NC), 9, 1, 0, 0.90000, 181, 42, 139, 
1934, Duke (NC), 7, 2, 0, 0.77778, 185, 40, 145, 
1935, Duke (NC), 8, 2, 0, 0.80000, 214, 45, 169, 
1936, Duke (NC), 9, 1, 0, 0.90000, 208, 28, 180, 
1937, Duke (NC), 7, 2, 1, 0.75000, 228, 56, 172, 
1938, Duke (NC), 9, 1, 0, 0.90000, 117, 7, 110, 
1939, Duke (NC), 8, 1, 0, 0.88889, 183, 42, 141, 
1940, Duke (NC), 7, 2, 0, 0.77778, 203, 52, 151, 
1941, Duke (NC), 9, 1, 0, 0.90000, 327, 61, 266, 
1946, Duke (NC), 4, 5, 0, 0.44444, 134, 86, 48, 
1947, Duke (NC), 4, 3, 2, 0.55556, 79, 90, -11, 
1948, Duke (NC), 4, 3, 2, 0.55556, 144, 92, 52, 
1949, Duke (NC), 6, 3, 0, 0.66667, 260, 117, 143, 
1950, Duke (NC), 7, 3, 0, 0.70000, 202, 108, 94, 
1888, Pennsylvania, 10, 7, 0, 0.58824, 288, 296, -8, 
1889, Pennsylvania, 7, 6, 0, 0.53846, 198, 167, 31, 
1890, Pennsylvania, 11, 3, 0, 0.78571, 259, 134, 125, 
1891, Pennsylvania, 11, 2, 0, 0.84615, 267, 109, 158, 
1987, Hawaii, 5, 7, 0, 0.41667, 337, 299, 38, 
1988, Hawaii, 9, 3, 0, 0.75000, 383, 283, 100, 
1989, Hawaii, 9, 3, 1, 0.73077, 470, 281, 189, 
1990, Hawaii, 7, 5, 0, 0.58333, 374, 257, 117, 
1991, Hawaii, 4, 7, 1, 0.37500, 335, 388, -53, 
1992, Hawaii, 11, 2, 0, 0.84615, 421, 317, 104, 
1993, Hawaii, 6, 6, 0, 0.50000, 393, 357, 36, 
1994, Hawaii, 3, 8, 1, 0.29167, 260, 273, -13, 
1995, Hawaii, 4, 8, 0, 0.33333, 285, 401, -116, 
2008, Western Carolina (NC), 3, 9, 0, 0.25000, 211, 347, -136, 
2009, Western Carolina (NC), 2, 9, 0, 0.18182, 155, 285, -130, 
2010, Western Carolina (NC), 2, 9, 0, 0.18182, 182, 380, -198, 
2011, Western Carolina (NC), 1, 9, 0, 0.10000, 221, 457, -236, 
1936, Carthage (WI), 2, 5, 1, 0.31250, 72, 144, -72, 
1937, Carthage (WI), 1, 6, 0, 0.14286, 78, 56, 22, 
1938, Carthage (WI), 6, 1, 1, 0.81250, 144, 32, 112, 
1939, Carthage (WI), 2, 6, 1, 0.27778, 82, 131, -49, 
1940, Carthage (WI), 5, 2, 1, 0.68750, 95, 54, 41, 
1941, Carthage (WI), 1, 5, 2, 0.25000, 36, 98, -62, 
1942, Carthage (WI), 3, 4, 0, 0.42857, 54, 61, -7, 
1983, Carthage (WI), 4, 5, 0, 0.44444, 145, 189, -44, 
1984, Carthage (WI), 2, 7, 0, 0.22222, 153, 275, -122, 
2011, Angelo St. (TX), 5, 6, 0, 0.45455, 304, 287, 17, 
2012, Angelo St. (TX), 5, 6, 0, 0.45455, 286, 313, -27, 
2013, Angelo St. (TX), 5, 6, 0, 0.45455, 329, 341, -12, 
1942, Colorado St., 4, 3, 0, 0.57143, 97, 99, -2, 
1945, Colorado St., 2, 5, 1, 0.31250, 89, 179, -90, 
1946, Colorado St., 2, 3, 0, 0.40000, 32, 107, -75, 
1925, Kent St. (OH), 1, 1, 3, 0.50000, 13, 24, -11, 
1926, Kent St. (OH), 2, 6, 0, 0.25000, 35, 176, -141, 
1927, Kent St. (OH), 1, 5, 1, 0.21429, 25, 80, -55, 
1928, Kent St. (OH), 4, 2, 2, 0.62500, 89, 32, 57, 
1929, Kent St. (OH), 1, 7, 0, 0.12500, 20, 161, -141, 
1930, Kent St. (OH), 3, 3, 1, 0.50000, 64, 42, 22, 
1931, Kent St. (OH), 3, 4, 0, 0.42857, 59, 80, -21, 
1932, Kent St. (OH), 0, 5, 2, 0.14286, 0, 80, -80, 
1896, Alabama, 2, 1, 0, 0.66667, 56, 10, 46, 
1897, Iowa, 4, 4, 0, 0.50000, 76, 110, -34, 
2005, West Liberty St. (WV), 6, 5, 0, 0.54545, 289, 263, 26, 
2006, West Liberty St. (WV), 7, 4, 0, 0.63636, 271, 234, 37, 
2007, West Liberty St. (WV), 8, 3, 0, 0.72727, 432, 223, 209, 
2008, West Liberty St. (WV), 7, 4, 0, 0.63636, 326, 276, 50, 
2009, West Liberty St. (WV), 11, 2, 0, 0.84615, 615, 424, 191, 
2010, West Liberty St. (WV), 7, 3, 0, 0.70000, 460, 313, 147, 
2011, West Liberty St. (WV), 1, 10, 0, 0.09091, 204, 376, -172, 
2012, West Liberty St. (WV), 6, 5, 0, 0.54545, 234, 229, 5, 
2013, West Liberty St. (WV), 3, 8, 0, 0.27273, 147, 241, -94, 
1908, Cedarville (OH), 1, 2, 1, 0.37500, 6, 36, -30, 
1895, Washington St., 2, 0, 0, 1.00000, 36, 8, 28, 
1923, Louisiana College, 5, 4, 0, 0.55556, 151, 106, 45, 
1924, Louisiana College, 3, 5, 2, 0.40000, 139, 144, -5, 
1925, Louisiana College, 2, 6, 1, 0.27778, 47, 205, -158, 
1926, Louisiana College, 3, 5, 0, 0.37500, 97, 171, -74, 
1927, Louisiana College, 5, 3, 0, 0.62500, 135, 70, 65, 
1928, Louisiana College, 3, 5, 0, 0.37500, 95, 153, -58, 
1929, Louisiana College, 6, 2, 1, 0.72222, 208, 121, 87, 
1930, Louisiana College, 2, 6, 0, 0.25000, 98, 188, -90, 
1931, Louisiana College, 2, 6, 0, 0.25000, 83, 171, -88, 
1932, Louisiana College, 2, 4, 1, 0.35714, 31, 70, -39, 
1933, Louisiana College, 3, 4, 0, 0.42857, 68, 112, -44, 
1934, Louisiana College, 3, 4, 1, 0.43750, 71, 65, 6, 
1935, Louisiana College, 6, 4, 0, 0.60000, 85, 103, -18, 
1936, Louisiana College, 3, 4, 1, 0.43750, 44, 85, -41, 
1978, Washington St., 4, 6, 1, 0.40909, 276, 296, -20, 
1979, Washington St., 5, 6, 0, 0.45455, 241, 366, -125, 
1980, Washington St., 4, 7, 0, 0.36364, 287, 271, 16, 
1981, Washington St., 8, 3, 1, 0.70833, 297, 197, 100, 
1982, Washington St., 3, 7, 1, 0.31818, 170, 255, -85, 
1983, Washington St., 7, 4, 0, 0.63636, 237, 211, 26, 
1984, Washington St., 6, 5, 0, 0.54545, 317, 319, -2, 
1985, Washington St., 4, 7, 0, 0.36364, 313, 282, 31, 
1986, Washington St., 3, 7, 1, 0.31818, 221, 312, -91, 
1987, Iowa St., 3, 8, 0, 0.27273, 195, 417, -222, 
1988, Iowa St., 5, 6, 0, 0.45455, 195, 258, -63, 
1989, Iowa St., 6, 5, 0, 0.54545, 294, 305, -11, 
1990, Iowa St., 4, 6, 1, 0.40909, 270, 307, -37, 
1991, Iowa St., 3, 7, 1, 0.31818, 157, 266, -109, 
1992, Iowa St., 4, 7, 0, 0.36364, 231, 242, -11, 
1993, Iowa St., 3, 8, 0, 0.27273, 251, 324, -73, 
1994, Iowa St., 0, 10, 1, 0.04545, 192, 363, -171, 
1909, Cornell (NY), 3, 4, 1, 0.43750, 66, 65, 1, 
1929, Oklahoma St., 4, 3, 2, 0.55556, 107, 79, 28, 
1930, Oklahoma St., 7, 2, 1, 0.75000, 124, 40, 84, 
1931, Oklahoma St., 8, 2, 1, 0.77273, 183, 52, 131, 
1932, Oklahoma St., 9, 1, 2, 0.83333, 178, 48, 130, 
1933, Oklahoma St., 6, 2, 1, 0.72222, 132, 57, 75, 
1934, Kansas St., 7, 2, 1, 0.75000, 149, 81, 68, 
1935, Northwestern (IL), 4, 3, 1, 0.56250, 90, 79, 11, 
1936, Northwestern (IL), 7, 1, 0, 0.87500, 132, 73, 59, 
1937, Northwestern (IL), 4, 4, 0, 0.50000, 68, 40, 28, 
1938, Northwestern (IL), 4, 2, 2, 0.62500, 93, 32, 61, 
1939, Northwestern (IL), 3, 4, 1, 0.43750, 47, 67, -20, 
1940, Northwestern (IL), 6, 2, 0, 0.75000, 170, 64, 106, 
1941, Northwestern (IL), 5, 3, 0, 0.62500, 173, 67, 106, 
1942, Northwestern (IL), 1, 9, 0, 0.10000, 96, 209, -113, 
1943, Northwestern (IL), 6, 2, 0, 0.75000, 189, 64, 125, 
1944, Northwestern (IL), 1, 7, 1, 0.16667, 102, 160, -58, 
1945, Northwestern (IL), 4, 4, 1, 0.50000, 127, 148, -21, 
1946, Northwestern (IL), 4, 4, 1, 0.50000, 156, 136, 20, 
1947, California, 9, 1, 0, 0.90000, 275, 111, 164, 
1948, California, 10, 1, 0, 0.90909, 291, 100, 191, 
1949, California, 10, 1, 0, 0.90909, 319, 131, 188, 
1950, California, 9, 1, 1, 0.86364, 224, 90, 134, 
1951, California, 8, 2, 0, 0.80000, 307, 166, 141, 
1952, California, 7, 3, 0, 0.70000, 247, 127, 120, 
1953, California, 4, 4, 2, 0.50000, 220, 170, 50, 
1954, California, 5, 5, 0, 0.50000, 249, 177, 72, 
1955, California, 2, 7, 1, 0.25000, 107, 216, -109, 
1956, California, 3, 7, 0, 0.30000, 135, 181, -46, 
1936, Fort Hays St. (KS), 6, 3, 0, 0.66667, 141, 64, 77, 
1937, Fort Hays St. (KS), 6, 2, 1, 0.72222, 100, 57, 43, 
1938, Fort Hays St. (KS), 7, 2, 0, 0.77778, 181, 65, 116, 
1939, Fort Hays St. (KS), 2, 5, 2, 0.33333, 94, 146, -52, 
1940, Fort Hays St. (KS), 3, 3, 3, 0.50000, 64, 45, 19, 
1941, Fort Hays St. (KS), 1, 6, 2, 0.22222, 89, 123, -34, 
1899, Duquesne (PA), 2, 0, 2, 0.75000, 24, 12, 12, 
2013, Catawba (NC), 6, 5, 0, 0.54545, 262, 287, -25, 
1893, Lawrence (WI), 1, 1, 1, 0.50000, 58, 28, 30, 
2007, UCLA, 0, 1, 0, 0.00000, 16, 17, -1, 
2009, New Mexico St., 3, 10, 0, 0.23077, 149, 411, -262, 
2010, New Mexico St., 2, 10, 0, 0.16667, 188, 474, -286, 
2011, New Mexico St., 4, 9, 0, 0.30769, 319, 478, -159, 
2012, New Mexico St., 1, 11, 0, 0.08333, 224, 473, -249, 
1926, Atlantic Christian (NC), 6, 1, 1, 0.81250, 139, 7, 132, 
1927, Elon (NC), 3, 4, 1, 0.43750, 64, 104, -40, 
1928, Elon (NC), 2, 7, 0, 0.22222, 59, 237, -178, 
1929, Elon (NC), 5, 3, 0, 0.62500, 130, 92, 38, 
1930, Elon (NC), 6, 3, 0, 0.66667, 178, 112, 66, 
1931, Elon (NC), 3, 5, 0, 0.37500, 106, 128, -22, 
1932, Elon (NC), 2, 6, 0, 0.25000, 46, 113, -67, 
1933, Elon (NC), 5, 3, 1, 0.61111, 151, 81, 70, 
1934, Elon (NC), 6, 2, 1, 0.72222, 133, 51, 82, 
1935, Elon (NC), 6, 3, 0, 0.66667, 168, 29, 139, 
1936, Elon (NC), 6, 5, 0, 0.54545, 204, 158, 46, 
1937, Wake Forest (NC), 3, 6, 0, 0.33333, 68, 220, -152, 
1938, Wake Forest (NC), 4, 5, 1, 0.45000, 161, 98, 63, 
1939, Wake Forest (NC), 7, 3, 0, 0.70000, 257, 89, 168, 
1940, Wake Forest (NC), 7, 3, 0, 0.70000, 193, 113, 80, 
1941, Wake Forest (NC), 5, 5, 1, 0.50000, 218, 168, 50, 
1942, Wake Forest (NC), 6, 2, 1, 0.72222, 134, 66, 68, 
1943, Wake Forest (NC), 4, 5, 0, 0.44444, 165, 101, 64, 
1944, Wake Forest (NC), 8, 1, 0, 0.88889, 178, 75, 103, 
1945, Wake Forest (NC), 5, 3, 1, 0.61111, 163, 151, 12, 
1946, Wake Forest (NC), 6, 3, 0, 0.66667, 156, 92, 64, 
1947, Wake Forest (NC), 6, 4, 0, 0.60000, 133, 101, 32, 
1948, Wake Forest (NC), 6, 4, 0, 0.60000, 224, 168, 56, 
1949, Wake Forest (NC), 4, 6, 0, 0.40000, 207, 183, 24, 
1950, Wake Forest (NC), 6, 1, 2, 0.77778, 168, 47, 121, 
1930, Mississippi, 3, 5, 1, 0.38889, 128, 140, -12, 
1931, Mississippi, 2, 6, 1, 0.27778, 73, 210, -137, 
1932, Mississippi, 5, 6, 0, 0.45455, 148, 148, 0, 
1933, Mississippi, 6, 3, 2, 0.63636, 167, 79, 88, 
1934, Mississippi, 4, 5, 1, 0.45000, 114, 98, 16, 
1935, Mississippi, 9, 3, 0, 0.75000, 311, 86, 225, 
1936, Mississippi, 5, 5, 2, 0.50000, 150, 98, 52, 
1937, Mississippi, 4, 5, 1, 0.45000, 127, 106, 21, 
1944, Samford (AL), 0, 5, 0, 0.00000, 34, 145, -111, 
1945, Samford (AL), 0, 5, 0, 0.00000, 19, 201, -182, 
1907, Utah St., 6, 1, 0, 0.85714, 184, 25, 159, 
1908, Utah St., 4, 2, 0, 0.66667, 142, 39, 103, 
1921, DePauw (IN), 4, 3, 0, 0.57143, 167, 107, 60, 
1936, Wheaton (IL), 3, 2, 2, 0.57143, 50, 51, -1, 
1937, Wheaton (IL), 3, 5, 0, 0.37500, 61, 90, -29, 
1938, Wheaton (IL), 3, 3, 0, 0.50000, 53, 76, -23, 
1939, Wheaton (IL), 2, 4, 2, 0.37500, 65, 109, -44, 
1966, Lane (TN), 2, 6, 1, 0.27778, 113, 251, -138, 
1967, Lane (TN), 2, 7, 0, 0.22222, 104, 172, -68, 
1968, Lane (TN), 6, 2, 0, 0.75000, 193, 127, 66, 
1969, Lane (TN), 2, 6, 1, 0.27778, 148, 228, -80, 
1970, Lane (TN), 3, 7, 0, 0.30000, 128, 190, -62, 
1971, Lane (TN), 2, 7, 0, 0.22222, 78, 175, -97, 
1942, Arizona St., 2, 8, 0, 0.20000, 53, 235, -182, 
1901, Wofford (SC), 2, 3, 0, 0.40000, 40, 96, -56, 
1939, Louisiana College, 4, 6, 1, 0.40909, 93, 117, -24, 
1985, Kentucky St., 0, 11, 0, 0.00000, 35, 451, -416, 
1957, Central St. (OH), 3, 4, 1, 0.43750, 140, 163, -23, 
1958, Central St. (OH), 6, 2, 0, 0.75000, 125, 114, 11, 
1959, Central St. (OH), 4, 3, 1, 0.56250, 162, 120, 42, 
1960, Central St. (OH), 7, 2, 0, 0.77778, 227, 77, 150, 
1961, Central St. (OH), 6, 1, 0, 0.85714, 221, 79, 142, 
1962, Central St. (OH), 4, 3, 1, 0.56250, 158, 92, 66, 
1963, Central St. (OH), 4, 5, 0, 0.44444, 140, 153, -13, 
1964, Central St. (OH), 3, 5, 0, 0.37500, 109, 243, -134, 
1967, Central St. (OH), 1, 6, 0, 0.14286, 27, 187, -160, 
1968, Central St. (OH), 2, 6, 0, 0.25000, 90, 171, -81, 
1969, Central St. (OH), 5, 3, 0, 0.62500, 128, 105, 23, 
1970, Central St. (OH), 5, 4, 0, 0.55556, 202, 159, 43, 
1971, Central St. (OH), 3, 5, 0, 0.37500, 101, 172, -71, 
1972, Central St. (OH), 2, 7, 0, 0.22222, 100, 252, -152, 
1973, Central St. (OH), 6, 5, 0, 0.54545, 228, 278, -50, 
1903, Southern California, 5, 2, 0, 0.71429, 63, 27, 36, 
1944, Prairie View A&M; (TX), 3, 6, 0, 0.33333, 66, 113, -47, 
2006, DePauw (IN), 6, 4, 0, 0.60000, 227, 185, 42, 
2007, DePauw (IN), 8, 2, 0, 0.80000, 293, 193, 100, 
2008, DePauw (IN), 8, 2, 0, 0.80000, 314, 260, 54, 
2013, Wisconsin-River Falls, 0, 10, 0, 0.00000, 140, 313, -173, 
2013, Bluefield College (VA), 0, 11, 0, 0.00000, 181, 517, -336, 
1935, Mesa St. (CO), 6, 2, 0, 0.75000, 193, 43, 150, 
1990, Miami (OH), 5, 5, 1, 0.50000, 200, 225, -25, 
1991, Miami (OH), 6, 4, 1, 0.59091, 214, 140, 74, 
1992, Miami (OH), 6, 4, 1, 0.59091, 210, 204, 6, 
1993, Miami (OH), 4, 7, 0, 0.36364, 186, 248, -62, 
1994, Miami (OH), 6, 4, 1, 0.59091, 262, 260, 2, 
1995, Miami (OH), 8, 2, 1, 0.77273, 326, 165, 161, 
1996, Miami (OH), 6, 5, 0, 0.54545, 273, 168, 105, 
1997, Miami (OH), 8, 3, 0, 0.72727, 412, 226, 186, 
1998, Miami (OH), 10, 1, 0, 0.90909, 317, 142, 175, 
1999, Northwestern (IL), 3, 8, 0, 0.27273, 141, 301, -160, 
2000, Northwestern (IL), 8, 4, 0, 0.66667, 441, 400, 41, 
2001, Northwestern (IL), 4, 7, 0, 0.36364, 320, 378, -58, 
2002, Northwestern (IL), 3, 9, 0, 0.25000, 272, 493, -221, 
2003, Northwestern (IL), 6, 7, 0, 0.46154, 263, 326, -63, 
2004, Northwestern (IL), 6, 6, 0, 0.50000, 295, 342, -47, 
2005, Northwestern (IL), 7, 5, 0, 0.58333, 388, 407, -19, 
1900, Virginia Military Institute, 4, 1, 2, 0.71429, 85, 15, 70, 
1901, Virginia Military Institute, 4, 3, 0, 0.57143, 199, 60, 139, 
1902, Virginia Military Institute, 3, 3, 1, 0.50000, 99, 90, 9, 
1972, Simon Fraser (BC), 3, 5, 0, 0.37500, 142, 162, -20, 
1956, Mississippi St., 4, 6, 0, 0.40000, 148, 152, -4, 
1957, Mississippi St., 6, 2, 1, 0.72222, 175, 100, 75, 
1958, Mississippi St., 3, 6, 0, 0.33333, 127, 129, -2, 
1959, Mississippi St., 2, 7, 0, 0.22222, 96, 198, -102, 
1960, Mississippi St., 2, 6, 1, 0.27778, 101, 119, -18, 
1961, Mississippi St., 5, 5, 0, 0.50000, 111, 135, -24, 
1934, Charleston (WV), 3, 5, 1, 0.38889, 115, 161, -46, 
1935, Charleston (WV), 2, 7, 0, 0.22222, 51, 124, -73, 
2008, Tiffin (OH), 1, 10, 0, 0.09091, 215, 382, -167, 
2009, Tiffin (OH), 0, 11, 0, 0.00000, 153, 440, -287, 
2010, Tiffin (OH), 1, 10, 0, 0.09091, 203, 463, -260, 
1917, New York (NY), 2, 2, 3, 0.50000, 33, 32, 1, 
1904, Richmond (VA), 1, 5, 0, 0.16667, 45, 98, -53, 
1988, North Alabama, 2, 8, 0, 0.20000, 173, 282, -109, 
1989, North Alabama, 6, 5, 0, 0.54545, 208, 155, 53, 
1990, North Alabama, 8, 3, 0, 0.72727, 317, 169, 148, 
1991, North Alabama, 3, 7, 0, 0.30000, 160, 251, -91, 
1992, North Alabama, 7, 4, 1, 0.62500, 221, 163, 58, 
1993, North Alabama, 14, 0, 0, 1.00000, 557, 265, 292, 
1994, North Alabama, 13, 1, 0, 0.92857, 458, 165, 293, 
1995, North Alabama, 14, 0, 0, 1.00000, 514, 155, 359, 
1996, North Alabama, 6, 5, 0, 0.54545, 307, 202, 105, 
1997, North Alabama, 9, 3, 0, 0.75000, 344, 224, 120, 
1998, Temple (PA), 2, 9, 0, 0.18182, 198, 360, -162, 
1999, Temple (PA), 2, 9, 0, 0.18182, 153, 366, -213, 
2000, Temple (PA), 4, 7, 0, 0.36364, 224, 269, -45, 
2001, Temple (PA), 4, 7, 0, 0.36364, 198, 311, -113, 
2002, Temple (PA), 4, 8, 0, 0.33333, 242, 351, -109, 
2003, Temple (PA), 1, 11, 0, 0.08333, 235, 393, -158, 
2004, Temple (PA), 2, 9, 0, 0.18182, 238, 399, -161, 
2005, Temple (PA), 0, 11, 0, 0.00000, 107, 498, -391, 
2006, West Alabama, 6, 5, 0, 0.54545, 301, 235, 66, 
2007, West Alabama, 1, 9, 0, 0.10000, 200, 329, -129, 
2008, West Alabama, 4, 7, 0, 0.36364, 283, 273, 10, 
2009, West Alabama, 8, 5, 0, 0.61538, 415, 365, 50, 
2010, West Alabama, 7, 4, 0, 0.63636, 327, 245, 82, 
2012, North Alabama, 5, 5, 0, 0.50000, 261, 231, 30, 
2013, North Alabama, 10, 3, 0, 0.76923, 517, 257, 260, 
1970, Winston-Salem St. (NC), 3, 5, 0, 0.37500, 133, 219, -86, 
1971, Winston-Salem St. (NC), 6, 4, 0, 0.60000, 200, 200, 0, 
1972, Winston-Salem St. (NC), 5, 4, 0, 0.55556, 199, 145, 54, 
1973, Winston-Salem St. (NC), 3, 7, 1, 0.31818, 171, 265, -94, 
1974, Winston-Salem St. (NC), 4, 7, 0, 0.36364, 171, 217, -46, 
1975, Winston-Salem St. (NC), 1, 9, 0, 0.10000, 66, 330, -264, 
1978, Ball St. (IN), 10, 1, 0, 0.90909, 251, 82, 169, 
1979, Ball St. (IN), 6, 5, 0, 0.54545, 272, 191, 81, 
1980, Ball St. (IN), 6, 5, 0, 0.54545, 239, 198, 41, 
1981, Ball St. (IN), 4, 7, 0, 0.36364, 157, 218, -61, 
1982, Ball St. (IN), 5, 6, 0, 0.45455, 177, 207, -30, 
1983, Ball St. (IN), 6, 5, 0, 0.54545, 247, 302, -55, 
1984, Ball St. (IN), 3, 8, 0, 0.27273, 134, 275, -141, 
1885, Fordham (NY), 0, 3, 0, 0.00000, 0, 62, -62, 
1965, Drake (IA), 6, 4, 0, 0.60000, 212, 165, 47, 
1966, Drake (IA), 8, 2, 0, 0.80000, 277, 164, 113, 
1967, Drake (IA), 4, 5, 0, 0.44444, 146, 248, -102, 
1968, Drake (IA), 5, 5, 0, 0.50000, 266, 278, -12, 
1969, Drake (IA), 7, 2, 2, 0.72727, 308, 235, 73, 
1970, Drake (IA), 7, 4, 0, 0.63636, 293, 235, 58, 
1971, Drake (IA), 7, 4, 0, 0.63636, 267, 185, 82, 
1972, Drake (IA), 7, 5, 0, 0.58333, 287, 200, 87, 
1973, Drake (IA), 2, 9, 0, 0.18182, 132, 269, -137, 
1974, Drake (IA), 3, 7, 1, 0.31818, 213, 315, -102, 
1975, Drake (IA), 3, 8, 0, 0.27273, 188, 312, -124, 
1976, Drake (IA), 1, 10, 0, 0.09091, 200, 424, -224, 
1955, Indianapolis (IN), 5, 3, 1, 0.61111, 121, 145, -24, 
1956, Indianapolis (IN), 4, 5, 0, 0.44444, 162, 183, -21, 
1957, Indianapolis (IN), 3, 6, 1, 0.35000, 189, 223, -34, 
1946, Houston (TX), 4, 6, 0, 0.40000, 140, 136, 4, 
1947, Houston (TX), 3, 8, 0, 0.27273, 95, 214, -119, 
1924, Rutgers (NJ), 7, 1, 1, 0.83333, 249, 48, 201, 
1925, Rutgers (NJ), 2, 7, 0, 0.22222, 38, 146, -108, 
1926, Rutgers (NJ), 3, 6, 0, 0.33333, 49, 134, -85, 
1995, Colorado School of Mines, 1, 9, 0, 0.10000, 141, 370, -229, 
1996, Colorado School of Mines, 3, 8, 0, 0.27273, 177, 304, -127, 
1997, Colorado School of Mines, 3, 8, 0, 0.27273, 149, 313, -164, 
1998, Colorado School of Mines, 3, 7, 0, 0.30000, 163, 320, -157, 
1999, Colorado School of Mines, 1, 9, 0, 0.10000, 100, 447, -347, 
1993, Lambuth (TN), 6, 4, 0, 0.60000, 399, 257, 142, 
1994, Lambuth (TN), 10, 3, 0, 0.76923, 563, 288, 275, 
1995, Lambuth (TN), 10, 1, 1, 0.87500, 493, 243, 250, 
1996, Lambuth (TN), 9, 2, 0, 0.81818, 383, 224, 159, 
1997, Lambuth (TN), 4, 6, 0, 0.40000, 183, 192, -9, 
1998, Lambuth (TN), 7, 3, 0, 0.70000, 310, 256, 54, 
1999, Lambuth (TN), 8, 4, 0, 0.66667, 504, 312, 192, 
2000, Lambuth (TN), 7, 4, 0, 0.63636, 416, 282, 134, 
2001, Lambuth (TN), 3, 6, 0, 0.33333, 333, 310, 23, 
2002, Lambuth (TN), 6, 4, 0, 0.60000, 272, 283, -11, 
2003, Lambuth (TN), 9, 3, 0, 0.75000, 295, 207, 88, 
2004, Lambuth (TN), 6, 4, 0, 0.60000, 282, 239, 43, 
2005, Lambuth (TN), 5, 6, 0, 0.45455, 219, 339, -120, 
2006, Lambuth (TN), 4, 7, 0, 0.36364, 222, 329, -107, 
2007, Lambuth (TN), 3, 8, 0, 0.27273, 292, 457, -165, 
2011, Rockford (IL), 0, 10, 0, 0.00000, 169, 408, -239, 
2012, Rockford (IL), 2, 8, 0, 0.20000, 130, 322, -192, 
2013, Rockford (IL), 1, 9, 0, 0.10000, 188, 369, -181, 
1950, Southern Illinois, 3, 5, 1, 0.38889, 125, 180, -55, 
1951, Southern Illinois, 0, 9, 0, 0.00000, 70, 354, -284, 
1933, Middle Tennessee St., 1, 7, 1, 0.16667, 44, 194, -150, 
1934, Middle Tennessee St., 1, 8, 0, 0.11111, 32, 99, -67, 
1925, Santa Clara (CA), 2, 6, 0, 0.25000, 58, 126, -68, 
1926, Santa Clara (CA), 5, 4, 0, 0.55556, 147, 101, 46, 
1927, Santa Clara (CA), 5, 4, 2, 0.54545, 137, 143, -6, 
1928, Santa Clara (CA), 5, 4, 0, 0.55556, 180, 106, 74, 
1977, Stanford (CA), 9, 3, 0, 0.75000, 285, 279, 6, 
1978, Stanford (CA), 8, 4, 0, 0.66667, 326, 221, 105, 
1992, Stanford (CA), 10, 3, 0, 0.76923, 320, 196, 124, 
1993, Stanford (CA), 4, 7, 0, 0.36364, 291, 389, -98, 
1994, Stanford (CA), 3, 7, 1, 0.31818, 327, 359, -32, 
1942, Fordham (NY), 5, 3, 1, 0.61111, 103, 155, -52, 
2013, Aurora (IL), 3, 7, 0, 0.30000, 374, 357, 17, 
1989, Sonoma St. (CA), 4, 6, 0, 0.40000, 196, 205, -9, 
1990, Sonoma St. (CA), 7, 3, 0, 0.70000, 290, 156, 134, 
1991, Sonoma St. (CA), 9, 2, 0, 0.81818, 265, 175, 90, 
1992, Sonoma St. (CA), 7, 3, 0, 0.70000, 296, 266, 30, 
1993, Portland St. (OR), 8, 3, 0, 0.72727, 315, 246, 69, 
1994, Portland St. (OR), 9, 3, 0, 0.75000, 415, 247, 168, 
1995, Portland St. (OR), 8, 5, 0, 0.61538, 413, 293, 120, 
1996, Portland St. (OR), 3, 8, 0, 0.27273, 196, 359, -163, 
1997, Portland St. (OR), 4, 7, 0, 0.36364, 212, 294, -82, 
1998, Portland St. (OR), 5, 6, 0, 0.45455, 347, 353, -6, 
1999, Portland St. (OR), 8, 3, 0, 0.72727, 399, 334, 65, 
2000, Portland St. (OR), 8, 4, 0, 0.66667, 406, 325, 81, 
2001, Portland St. (OR), 7, 4, 0, 0.63636, 365, 314, 51, 
2002, Portland St. (OR), 6, 5, 0, 0.54545, 236, 245, -9, 
2003, Portland St. (OR), 4, 7, 0, 0.36364, 220, 327, -107, 
2004, Portland St. (OR), 7, 4, 0, 0.63636, 335, 223, 112, 
2005, Portland St. (OR), 6, 5, 0, 0.54545, 313, 273, 40, 
2006, Portland St. (OR), 7, 4, 0, 0.63636, 245, 202, 43, 
2009, Cal Poly-San Luis Obispo, 4, 7, 0, 0.36364, 258, 303, -45, 
2010, Cal Poly-San Luis Obispo, 7, 4, 0, 0.63636, 306, 280, 26, 
2011, Cal Poly-San Luis Obispo, 6, 5, 0, 0.54545, 356, 329, 27, 
2012, Cal Poly-San Luis Obispo, 9, 3, 0, 0.75000, 440, 284, 156, 
2013, Cal Poly-San Luis Obispo, 6, 6, 0, 0.50000, 342, 259, 83, 
1997, Idaho St., 3, 8, 0, 0.27273, 188, 356, -168, 
1998, Idaho St., 3, 8, 0, 0.27273, 221, 415, -194, 
1994, Robert Morris (PA), 7, 1, 1, 0.83333, 247, 154, 93, 
1995, Robert Morris (PA), 6, 4, 0, 0.60000, 270, 159, 111, 
1996, Robert Morris (PA), 9, 2, 0, 0.81818, 318, 142, 176, 
1997, Robert Morris (PA), 8, 3, 0, 0.72727, 306, 193, 113, 
1998, Robert Morris (PA), 4, 6, 0, 0.40000, 294, 201, 93, 
1999, Robert Morris (PA), 8, 2, 0, 0.80000, 328, 156, 172, 
2000, Robert Morris (PA), 10, 0, 0, 1.00000, 365, 140, 225, 
2001, Robert Morris (PA), 6, 3, 0, 0.66667, 310, 219, 91, 
2002, Robert Morris (PA), 3, 7, 0, 0.30000, 128, 227, -99, 
2003, Robert Morris (PA), 6, 4, 0, 0.60000, 246, 219, 27, 
2004, Robert Morris (PA), 6, 5, 0, 0.54545, 277, 213, 64, 
2005, Robert Morris (PA), 2, 8, 0, 0.20000, 243, 256, -13, 
2006, Robert Morris (PA), 7, 4, 0, 0.63636, 234, 161, 73, 
2007, Robert Morris (PA), 4, 6, 0, 0.40000, 177, 231, -54, 
2008, Robert Morris (PA), 5, 6, 0, 0.45455, 254, 251, 3, 
2009, Robert Morris (PA), 5, 6, 0, 0.45455, 214, 193, 21, 
2010, Robert Morris (PA), 8, 3, 0, 0.72727, 313, 226, 87, 
2011, Robert Morris (PA), 2, 9, 0, 0.18182, 210, 307, -97, 
2012, Robert Morris (PA), 4, 7, 0, 0.36364, 202, 293, -91, 
2013, Robert Morris (PA), 5, 6, 0, 0.45455, 240, 262, -22, 
1980, Elizabeth City St. (NC), 7, 2, 1, 0.75000, 202, 142, 60, 
1981, Elizabeth City St. (NC), 8, 3, 0, 0.72727, 202, 187, 15, 
1982, Elizabeth City St. (NC), 5, 5, 0, 0.50000, 104, 142, -38, 
1989, Elizabeth City St. (NC), 2, 8, 0, 0.20000, 127, 264, -137, 
1990, Elizabeth City St. (NC), 3, 6, 1, 0.35000, 131, 200, -69, 
1934, Ouachita Baptist (AR), 8, 2, 0, 0.80000, 142, 21, 121, 
1935, Ouachita Baptist (AR), 3, 5, 0, 0.37500, 99, 70, 29, 
1936, Ouachita Baptist (AR), 6, 1, 1, 0.81250, 137, 67, 70, 
1937, Ouachita Baptist (AR), 2, 6, 0, 0.25000, 126, 177, -51, 
1938, Ouachita Baptist (AR), 5, 3, 0, 0.62500, 106, 92, 14, 
1939, Ouachita Baptist (AR), 3, 5, 1, 0.38889, 60, 50, 10, 
1940, Ouachita Baptist (AR), 7, 3, 0, 0.70000, 158, 51, 107, 
1941, Ouachita Baptist (AR), 8, 3, 0, 0.72727, 147, 37, 110, 
1942, Ouachita Baptist (AR), 9, 1, 0, 0.90000, 375, 28, 347, 
1970, Colorado St., 4, 7, 0, 0.36364, 206, 246, -40, 
1971, Colorado St., 3, 8, 0, 0.27273, 177, 276, -99, 
1972, Colorado St., 1, 10, 0, 0.09091, 128, 413, -285, 
1926, Ball St. (IN), 5, 1, 1, 0.78571, 127, 53, 74, 
1927, Ball St. (IN), 5, 2, 1, 0.68750, 152, 109, 43, 
2005, Pittsburgh (PA), 5, 6, 0, 0.45455, 267, 243, 24, 
2006, Pittsburgh (PA), 6, 6, 0, 0.50000, 381, 274, 107, 
2007, Pittsburgh (PA), 5, 7, 0, 0.41667, 274, 291, -17, 
2008, Pittsburgh (PA), 9, 4, 0, 0.69231, 352, 279, 73, 
2009, Pittsburgh (PA), 10, 3, 0, 0.76923, 417, 257, 160, 
2010, Pittsburgh (PA), 7, 5, 0, 0.58333, 315, 237, 78, 
1912, Central Oklahoma, 5, 4, 0, 0.55556, 234, 209, 25, 
1913, Central Oklahoma, 5, 2, 2, 0.66667, 133, 133, 0, 
1914, Central Oklahoma, 5, 1, 0, 0.83333, 163, 70, 93, 
1915, Central Oklahoma, 9, 0, 0, 1.00000, 380, 16, 364, 
1916, Central Oklahoma, 8, 3, 0, 0.72727, 418, 84, 334, 
1917, Central Oklahoma, 3, 4, 0, 0.42857, 181, 141, 40, 
1918, Central Oklahoma, 6, 2, 0, 0.75000, 254, 77, 177, 
1919, Central Oklahoma, 6, 5, 0, 0.54545, 383, 255, 128, 
1921, Central Oklahoma, 9, 1, 0, 0.90000, 309, 57, 252, 
1922, Central Oklahoma, 7, 4, 0, 0.63636, 304, 96, 208, 
1923, Central Oklahoma, 7, 1, 1, 0.83333, 184, 25, 159, 
1924, Central Oklahoma, 9, 2, 0, 0.81818, 216, 40, 176, 
1925, Central Oklahoma, 4, 3, 2, 0.55556, 79, 66, 13, 
1926, Central Oklahoma, 3, 3, 3, 0.50000, 63, 44, 19, 
1927, Central Oklahoma, 3, 1, 4, 0.62500, 85, 44, 41, 
1928, Central Oklahoma, 5, 3, 1, 0.61111, 159, 63, 96, 
1929, Central Oklahoma, 6, 1, 2, 0.77778, 63, 22, 41, 
1930, Central Oklahoma, 6, 3, 0, 0.66667, 118, 65, 53, 
1967, Maryland, 0, 9, 0, 0.00000, 46, 231, -185, 
1968, Maryland, 2, 8, 0, 0.20000, 171, 299, -128, 
1948, Colorado, 3, 6, 0, 0.33333, 168, 164, 4, 
1949, Colorado, 3, 7, 0, 0.30000, 129, 184, -55, 
1950, Colorado, 5, 4, 1, 0.55000, 227, 172, 55, 
1951, Colorado, 7, 3, 0, 0.70000, 289, 229, 60, 
1952, Colorado, 6, 2, 2, 0.70000, 246, 158, 88, 
1953, Colorado, 6, 4, 0, 0.60000, 201, 194, 7, 
1954, Colorado, 7, 2, 1, 0.75000, 283, 91, 192, 
1955, Colorado, 6, 4, 0, 0.60000, 203, 149, 54, 
1956, Colorado, 8, 2, 1, 0.77273, 294, 143, 151, 
1957, Colorado, 6, 3, 1, 0.65000, 250, 137, 113, 
1958, Colorado, 6, 4, 0, 0.60000, 207, 122, 85, 
1904, New Hampshire, 2, 5, 0, 0.28571, 22, 70, -48, 
1992, Buffalo (NY), 4, 6, 0, 0.40000, 319, 395, -76, 
1993, Buffalo (NY), 2, 9, 0, 0.18182, 190, 359, -169, 
1994, Buffalo (NY), 3, 8, 0, 0.27273, 156, 331, -175, 
1937, Charleston (WV), 5, 4, 0, 0.55556, 87, 65, 22, 
1938, Charleston (WV), 7, 1, 1, 0.83333, 195, 44, 151, 
1939, Charleston (WV), 5, 3, 1, 0.61111, 156, 88, 68, 
1940, Charleston (WV), 6, 3, 1, 0.65000, 180, 110, 70, 
1941, Charleston (WV), 5, 3, 1, 0.61111, 235, 77, 158, 
1909, Kalamazoo (MI), 3, 3, 0, 0.50000, 48, 70, -22, 
1896, Michigan, 9, 1, 0, 0.90000, 262, 11, 251, 
1995, Truman St. (MO), 6, 5, 0, 0.54545, 366, 272, 94, 
1996, Truman St. (MO), 7, 4, 0, 0.63636, 361, 283, 78, 
1997, Truman St. (MO), 7, 3, 0, 0.70000, 311, 240, 71, 
1998, Truman St. (MO), 6, 5, 0, 0.54545, 240, 232, 8, 
1999, Truman St. (MO), 4, 7, 0, 0.36364, 247, 325, -78, 
2000, Truman St. (MO), 6, 5, 0, 0.54545, 333, 305, 28, 
2001, Truman St. (MO), 8, 3, 0, 0.72727, 366, 263, 103, 
2002, Truman St. (MO), 6, 5, 0, 0.54545, 363, 282, 81, 
2003, Truman St. (MO), 4, 7, 0, 0.36364, 161, 356, -195, 
2004, Missouri Southern St., 5, 6, 0, 0.45455, 342, 395, -53, 
2005, Missouri Southern St., 2, 3, 0, 0.40000, 140, 160, -20, 
1907, Lenoir-Rhyne (NC), 0, 3, 0, 0.00000, 3, 64, -61, 
1908, Lenoir-Rhyne (NC), 5, 2, 1, 0.68750, 82, 26, 56, 
1909, Catawba (NC), 2, 0, 0, 1.00000, 10, 0, 10, 
1910, Catawba (NC), 1, 3, 1, 0.30000, 46, 40, 6, 
1911, Catawba (NC), 1, 2, 1, 0.37500, 17, 47, -30, 
1922, Catawba (NC), 5, 1, 0, 0.83333, 52, 21, 31, 
1990, Kalamazoo (MI), 3, 5, 1, 0.38889, 159, 222, -63, 
1991, Kalamazoo (MI), 6, 3, 0, 0.66667, 162, 76, 86, 
1992, Kalamazoo (MI), 3, 6, 0, 0.33333, 119, 201, -82, 
1993, Kalamazoo (MI), 7, 2, 0, 0.77778, 229, 199, 30, 
1994, Kalamazoo (MI), 4, 5, 0, 0.44444, 159, 205, -46, 
1995, Kalamazoo (MI), 4, 5, 0, 0.44444, 231, 182, 49, 
1996, Kalamazoo (MI), 3, 6, 0, 0.33333, 288, 332, -44, 
1997, Kalamazoo (MI), 4, 5, 0, 0.44444, 114, 205, -91, 
1952, Mississippi St., 5, 4, 0, 0.55556, 225, 186, 39, 
1953, Mississippi St., 5, 2, 3, 0.65000, 196, 119, 77, 
1954, Minnesota, 7, 2, 0, 0.77778, 195, 127, 68, 
1955, Minnesota, 3, 6, 0, 0.33333, 110, 172, -62, 
1956, Minnesota, 6, 1, 2, 0.77778, 127, 87, 40, 
1957, Minnesota, 4, 5, 0, 0.44444, 201, 188, 13, 
1958, Minnesota, 1, 8, 0, 0.11111, 115, 157, -42, 
1959, Minnesota, 2, 7, 0, 0.22222, 98, 159, -61, 
1960, Minnesota, 8, 2, 0, 0.80000, 228, 88, 140, 
1961, Minnesota, 8, 2, 0, 0.80000, 161, 78, 83, 
1962, Minnesota, 6, 2, 1, 0.72222, 131, 61, 70, 
1963, Minnesota, 3, 6, 0, 0.33333, 95, 117, -22, 
1964, Minnesota, 5, 4, 0, 0.55556, 136, 131, 5, 
1965, Minnesota, 5, 4, 1, 0.55000, 188, 160, 28, 
1966, Minnesota, 4, 5, 1, 0.45000, 124, 160, -36, 
1967, Minnesota, 8, 2, 0, 0.80000, 163, 106, 57, 
1968, Minnesota, 6, 4, 0, 0.60000, 207, 190, 17, 
1969, Minnesota, 4, 5, 1, 0.45000, 210, 260, -50, 
1970, Minnesota, 3, 6, 1, 0.35000, 180, 237, -57, 
1971, Minnesota, 4, 7, 0, 0.36364, 212, 278, -66, 
1922, Cedarville (OH), 0, 5, 0, 0.00000, 0, 131, -131, 
1914, Connecticut, 3, 0, 0, 1.00000, 48, 9, 39, 
1895, Iowa St., 3, 5, 0, 0.37500, 108, 56, 52, 
1896, Georgia, 4, 0, 0, 1.00000, 86, 22, 64, 
1897, Cornell (NY), 5, 3, 1, 0.61111, 133, 42, 91, 
1898, Cornell (NY), 10, 2, 0, 0.83333, 296, 29, 267, 
1899, Carlisle Indian School (PA), 9, 2, 0, 0.81818, 365, 50, 315, 
1900, Carlisle Indian School (PA), 6, 4, 1, 0.59091, 212, 92, 120, 
1901, Carlisle Indian School (PA), 5, 7, 1, 0.42308, 133, 168, -35, 
1902, Carlisle Indian School (PA), 8, 3, 0, 0.72727, 251, 51, 200, 
1903, Carlisle Indian School (PA), 11, 2, 1, 0.82143, 274, 52, 222, 
1904, Cornell (NY), 7, 3, 0, 0.70000, 226, 92, 134, 
1905, Cornell (NY), 6, 4, 0, 0.60000, 173, 59, 114, 
1906, Cornell (NY), 8, 1, 2, 0.81818, 237, 37, 200, 
1907, Carlisle Indian School (PA), 10, 1, 0, 0.90909, 267, 62, 205, 
1908, Carlisle Indian School (PA), 10, 2, 1, 0.80769, 222, 55, 167, 
1909, Carlisle Indian School (PA), 8, 3, 1, 0.70833, 243, 94, 149, 
1910, Carlisle Indian School (PA), 8, 6, 0, 0.57143, 235, 69, 166, 
1911, Carlisle Indian School (PA), 11, 1, 0, 0.91667, 298, 49, 249, 
1912, Carlisle Indian School (PA), 12, 1, 1, 0.89286, 503, 120, 383, 
1913, Carlisle Indian School (PA), 10, 1, 1, 0.87500, 296, 63, 233, 
1914, Carlisle Indian School (PA), 5, 9, 1, 0.36667, 125, 174, -49, 
1915, Pittsburgh (PA), 8, 0, 0, 1.00000, 247, 19, 228, 
1916, Pittsburgh (PA), 8, 0, 0, 1.00000, 255, 25, 230, 
1917, Pittsburgh (PA), 10, 0, 0, 1.00000, 260, 21, 239, 
1918, Pittsburgh (PA), 4, 1, 0, 0.80000, 140, 16, 124, 
1919, Pittsburgh (PA), 6, 2, 1, 0.72222, 119, 66, 53, 
1920, Pittsburgh (PA), 6, 0, 2, 0.87500, 146, 44, 102, 
1921, Pittsburgh (PA), 5, 3, 1, 0.61111, 133, 51, 82, 
1922, Pittsburgh (PA), 8, 2, 0, 0.80000, 190, 43, 147, 
1923, Pittsburgh (PA), 5, 4, 0, 0.55556, 83, 39, 44, 
1924, Stanford (CA), 7, 1, 1, 0.83333, 179, 69, 110, 
1925, Stanford (CA), 7, 2, 0, 0.77778, 231, 71, 160, 
1926, Stanford (CA), 10, 0, 1, 0.95455, 268, 86, 182, 
1927, Stanford (CA), 8, 2, 1, 0.77273, 151, 75, 76, 
1928, Stanford (CA), 8, 3, 1, 0.70833, 274, 69, 205, 
1929, Stanford (CA), 9, 2, 0, 0.81818, 288, 53, 235, 
1930, Stanford (CA), 9, 1, 1, 0.86364, 252, 69, 183, 
1931, Stanford (CA), 7, 2, 2, 0.72727, 160, 44, 116, 
1932, Stanford (CA), 6, 4, 1, 0.59091, 171, 58, 113, 
1933, Temple (PA), 5, 3, 0, 0.62500, 110, 96, 14, 
1934, Temple (PA), 7, 1, 2, 0.80000, 220, 57, 163, 
1935, Temple (PA), 7, 3, 0, 0.70000, 181, 68, 113, 
1936, Temple (PA), 6, 3, 2, 0.63636, 117, 66, 51, 
1937, Temple (PA), 3, 2, 4, 0.55556, 38, 59, -21, 
1938, Temple (PA), 3, 6, 1, 0.35000, 97, 170, -73, 
1912, Sam Houston St. (TX), 2, 2, 0, 0.50000, 58, 51, 7, 
1913, Sam Houston St. (TX), 3, 2, 0, 0.60000, 91, 42, 49, 
1903, Cornell (NY), 6, 3, 1, 0.65000, 120, 103, 17, 
1905, North Carolina, 4, 3, 1, 0.56250, 82, 90, -8, 
1906, Colgate (NY), 4, 2, 2, 0.62500, 102, 56, 46, 
1907, Colgate (NY), 4, 4, 1, 0.50000, 108, 61, 47, 
1910, Oregon, 4, 1, 0, 0.80000, 172, 11, 161, 
1911, Oregon, 3, 2, 0, 0.60000, 59, 51, 8, 
1966, Bluffton (OH), 3, 4, 1, 0.43750, 89, 153, -64, 
1967, Bluffton (OH), 5, 3, 1, 0.61111, 177, 114, 63, 
1968, Bluffton (OH), 2, 7, 0, 0.22222, 119, 145, -26, 
1942, Oregon, 2, 6, 0, 0.25000, 67, 138, -71, 
1900, Amherst (MA), 4, 7, 1, 0.37500, 109, 105, 4, 
1916, South Carolina, 2, 7, 0, 0.22222, 85, 168, -83, 
1913, Virginia, 7, 1, 0, 0.87500, 265, 28, 237, 
1920, Virginia, 5, 2, 2, 0.66667, 140, 53, 87, 
1921, Virginia, 5, 4, 0, 0.55556, 101, 83, 18, 
2002, Virginia-Wise, 3, 7, 0, 0.30000, 188, 372, -184, 
2003, Virginia-Wise, 3, 8, 0, 0.27273, 238, 437, -199, 
2004, Virginia-Wise, 3, 8, 0, 0.27273, 258, 421, -163, 
2005, Virginia-Wise, 4, 7, 0, 0.36364, 256, 330, -74, 
2006, Virginia-Wise, 8, 3, 0, 0.72727, 444, 309, 135, 
2007, Virginia-Wise, 9, 2, 0, 0.81818, 544, 386, 158, 
2008, Virginia-Wise, 8, 3, 0, 0.72727, 455, 290, 165, 
2009, Virginia-Wise, 5, 6, 0, 0.45455, 286, 305, -19, 
2010, Virginia-Wise, 3, 8, 0, 0.27273, 283, 407, -124, 
2011, Virginia-Wise, 5, 6, 0, 0.45455, 241, 347, -106, 
1901, Howard (DC), 4, 0, 0, 1.00000, 79, 0, 79, 
1902, Howard (DC), 1, 0, 0, 1.00000, 23, 0, 23, 
1903, Howard (DC), 2, 0, 0, 1.00000, 54, 0, 54, 
1904, Howard (DC), 1, 1, 1, 0.50000, 17, 4, 13, 
1905, Howard (DC), 1, 1, 0, 0.50000, 37, 6, 31, 
1906, Howard (DC), 2, 1, 2, 0.60000, 35, 15, 20, 
1981, Southern (LA), 3, 8, 0, 0.27273, 185, 266, -81, 
1982, Southern (LA), 8, 3, 0, 0.72727, 238, 176, 62, 
1983, Southern (LA), 7, 4, 0, 0.63636, 237, 252, -15, 
1984, Southern (LA), 6, 5, 0, 0.54545, 284, 279, 5, 
1985, Southern (LA), 6, 5, 0, 0.54545, 196, 252, -56, 
1986, Southern (LA), 5, 5, 1, 0.50000, 215, 188, 27, 
1957, Savannah St. (GA), 3, 3, 2, 0.50000, 102, 119, -17, 
1958, Savannah St. (GA), 5, 4, 0, 0.55556, 174, 136, 38, 
1959, Savannah St. (GA), 3, 4, 2, 0.44444, 124, 156, -32, 
1960, Savannah St. (GA), 3, 5, 1, 0.38889, 90, 181, -91, 
1961, Savannah St. (GA), 4, 4, 1, 0.50000, 108, 98, 10, 
1962, Savannah St. (GA), 4, 5, 0, 0.44444, 113, 117, -4, 
1963, Savannah St. (GA), 0, 6, 0, 0.00000, 32, 134, -102, 
1965, Delaware St., 4, 5, 0, 0.44444, 109, 195, -86, 
1966, Delaware St., 3, 5, 0, 0.37500, 72, 156, -84, 
1910, Texas, 6, 2, 0, 0.75000, 162, 32, 130, 
1911, Texas, 5, 2, 0, 0.71429, 66, 19, 47, 
1958, Lake Forest (IL), 5, 3, 0, 0.62500, 191, 139, 52, 
1959, Lake Forest (IL), 3, 5, 0, 0.37500, 153, 111, 42, 
1960, Lake Forest (IL), 4, 3, 1, 0.56250, 151, 74, 77, 
1961, Lake Forest (IL), 0, 8, 0, 0.00000, 53, 214, -161, 
1962, Lake Forest (IL), 0, 7, 0, 0.00000, 60, 190, -130, 
1963, Lake Forest (IL), 2, 4, 1, 0.35714, 93, 165, -72, 
1964, Lake Forest (IL), 3, 5, 0, 0.37500, 118, 154, -36, 
1965, Lake Forest (IL), 5, 3, 0, 0.62500, 143, 102, 41, 
1901, Kalamazoo (MI), 2, 5, 1, 0.31250, 69, 124, -55, 
1970, Kean (NJ), 4, 2, 0, 0.66667, 94, 62, 32, 
1971, Kean (NJ), 1, 6, 0, 0.14286, 63, 151, -88, 
1972, Kean (NJ), 1, 0, 0, 1.00000, 24, 3, 21, 
1927, North Carolina Central, 5, 3, 1, 0.61111, 165, 56, 109, 
1928, North Carolina Central, 2, 6, 1, 0.27778, 32, 130, -98, 
1896, Harvard (MA), 7, 4, 0, 0.63636, 132, 40, 92, 
1969, Western Carolina (NC), 9, 1, 0, 0.90000, 321, 150, 171, 
1970, Western Carolina (NC), 6, 3, 0, 0.66667, 232, 164, 68, 
1971, Western Carolina (NC), 4, 6, 0, 0.40000, 223, 209, 14, 
1972, Western Carolina (NC), 7, 2, 1, 0.75000, 199, 142, 57, 
1973, Western Carolina (NC), 6, 3, 1, 0.65000, 217, 157, 60, 
1974, Western Carolina (NC), 9, 2, 0, 0.81818, 210, 87, 123, 
1975, Western Carolina (NC), 3, 7, 0, 0.30000, 165, 265, -100, 
1976, Western Carolina (NC), 6, 4, 0, 0.60000, 163, 136, 27, 
1977, Western Carolina (NC), 6, 4, 1, 0.59091, 288, 207, 81, 
1978, Western Carolina (NC), 6, 5, 0, 0.54545, 234, 209, 25, 
1979, Western Carolina (NC), 6, 5, 0, 0.54545, 280, 202, 78, 
1980, Western Carolina (NC), 3, 7, 1, 0.31818, 180, 243, -63, 
1981, Western Carolina (NC), 4, 7, 0, 0.36364, 234, 297, -63, 
1982, Western Carolina (NC), 6, 5, 0, 0.54545, 245, 184, 61, 
1983, Western Carolina (NC), 11, 3, 1, 0.76667, 370, 283, 87, 
1984, Western Carolina (NC), 8, 3, 0, 0.72727, 310, 166, 144, 
1985, Western Carolina (NC), 4, 6, 1, 0.40909, 175, 211, -36, 
1986, Western Carolina (NC), 6, 5, 0, 0.54545, 258, 267, -9, 
1987, Western Carolina (NC), 4, 7, 0, 0.36364, 239, 310, -71, 
1988, Western Carolina (NC), 2, 9, 0, 0.18182, 219, 343, -124, 
1975, Saginaw Valley St. (MI), 3, 7, 0, 0.30000, 128, 219, -91, 
1976, Saginaw Valley St. (MI), 4, 7, 0, 0.36364, 213, 158, 55, 
1977, Saginaw Valley St. (MI), 6, 5, 0, 0.54545, 193, 188, 5, 
1978, Saginaw Valley St. (MI), 4, 5, 1, 0.45000, 211, 210, 1, 
1979, Saginaw Valley St. (MI), 8, 2, 1, 0.77273, 295, 130, 165, 
1980, Michigan St., 3, 8, 0, 0.27273, 221, 279, -58, 
1981, Michigan St., 5, 6, 0, 0.45455, 263, 249, 14, 
1982, Michigan St., 2, 9, 0, 0.18182, 202, 242, -40, 
1907, Louisiana Tech, 9, 1, 0, 0.90000, 248, 37, 211, 
1958, Ouachita Baptist (AR), 2, 5, 1, 0.31250, 78, 161, -83, 
1959, Ouachita Baptist (AR), 3, 7, 0, 0.30000, 107, 206, -99, 
1960, Ouachita Baptist (AR), 1, 7, 2, 0.20000, 39, 90, -51, 
1940, Appalachian St. (NC), 6, 4, 0, 0.60000, 154, 136, 18, 
1941, Appalachian St. (NC), 4, 5, 0, 0.44444, 181, 103, 78, 
1900, Auburn (AL), 4, 0, 0, 1.00000, 148, 5, 143, 
1901, Vanderbilt (TN), 8, 4, 2, 0.64286, 228, 86, 142, 
1902, Vanderbilt (TN), 8, 1, 0, 0.88889, 214, 60, 154, 
1941, California (PA), 0, 4, 0, 0.00000, 0, 120, -120, 
1919, Henderson St. (AR), 2, 4, 1, 0.35714, 66, 247, -181, 
1899, Eastern Michigan, 1, 1, 1, 0.50000, 29, 23, 6, 
1905, Hamilton (NY), 4, 3, 1, 0.56250, 105, 77, 28, 
1916, Utah St., 1, 5, 1, 0.21429, 69, 178, -109, 
1917, Utah St., 7, 0, 1, 0.93750, 267, 26, 241, 
1923, Howard (DC), 7, 0, 1, 0.93750, 96, 19, 77, 
1925, Howard (DC), 6, 0, 2, 0.87500, 140, 0, 140, 
1926, Howard (DC), 7, 0, 0, 1.00000, 199, 6, 193, 
1927, Howard (DC), 3, 3, 2, 0.50000, 74, 56, 18, 
1973, North Park (IL), 3, 6, 0, 0.33333, 220, 267, -47, 
1974, North Park (IL), 3, 6, 0, 0.33333, 89, 218, -129, 
1957, West Virginia Tech, 4, 4, 1, 0.50000, 146, 122, 24, 
1958, West Virginia Tech, 5, 3, 1, 0.61111, 207, 75, 132, 
1959, West Virginia Tech, 7, 1, 0, 0.87500, 230, 72, 158, 
1994, Southern Illinois, 1, 10, 0, 0.09091, 156, 351, -195, 
1995, Southern Illinois, 5, 6, 0, 0.45455, 198, 291, -93, 
1996, Southern Illinois, 5, 6, 0, 0.45455, 302, 302, 0, 
1917, Hendrix (AR), 3, 2, 0, 0.60000, 91, 39, 52, 
2002, Michigan St., 1, 2, 0, 0.33333, 105, 127, -22, 
1903, Baylor (TX), 4, 3, 1, 0.56250, 46, 69, -23, 
2013, Ohio Wesleyan, 5, 5, 0, 0.50000, 305, 258, 47, 
1904, West Virginia Wesleyan, 4, 2, 0, 0.66667, 58, 21, 37, 
1905, West Virginia Wesleyan, 3, 0, 0, 1.00000, 44, 0, 44, 
1906, West Virginia Wesleyan, 2, 5, 1, 0.31250, 76, 210, -134, 
1969, Dubuque (IA), 1, 7, 0, 0.12500, 59, 207, -148, 
1970, Dubuque (IA), 2, 7, 0, 0.22222, 81, 255, -174, 
1971, Dubuque (IA), 1, 7, 1, 0.16667, 86, 194, -108, 
1972, Dubuque (IA), 5, 4, 1, 0.55000, 151, 200, -49, 
1973, Dubuque (IA), 5, 4, 1, 0.55000, 187, 146, 41, 
1974, Dubuque (IA), 2, 8, 0, 0.20000, 114, 230, -116, 
1992, Lake Forest (IL), 3, 6, 0, 0.33333, 91, 202, -111, 
1993, Lake Forest (IL), 2, 7, 0, 0.22222, 145, 280, -135, 
1994, Lake Forest (IL), 1, 8, 0, 0.11111, 191, 317, -126, 
1921, Dayton (OH), 0, 7, 1, 0.06250, 28, 230, -202, 
1992, Utah St., 5, 6, 0, 0.45455, 300, 328, -28, 
1993, Utah St., 7, 5, 0, 0.58333, 363, 354, 9, 
1994, Utah St., 3, 8, 0, 0.27273, 209, 313, -104, 
1995, Navy (MD), 5, 6, 0, 0.45455, 223, 189, 34, 
1996, Navy (MD), 9, 3, 0, 0.75000, 392, 309, 83, 
1997, Navy (MD), 7, 4, 0, 0.63636, 398, 209, 189, 
1998, Navy (MD), 3, 8, 0, 0.27273, 255, 376, -121, 
1999, Navy (MD), 5, 7, 0, 0.41667, 326, 306, 20, 
2000, Navy (MD), 1, 10, 0, 0.09091, 182, 391, -209, 
2001, Navy (MD), 0, 7, 0, 0.00000, 122, 242, -120, 
2003, Louisiana-Monroe, 1, 11, 0, 0.08333, 239, 467, -228, 
2004, Louisiana-Monroe, 5, 6, 0, 0.45455, 211, 303, -92, 
2005, Louisiana-Monroe, 5, 6, 0, 0.45455, 239, 339, -100, 
2006, Louisiana-Monroe, 4, 8, 0, 0.33333, 262, 267, -5, 
2007, Louisiana-Monroe, 6, 6, 0, 0.50000, 282, 332, -50, 
2008, Louisiana-Monroe, 4, 8, 0, 0.33333, 284, 374, -90, 
2009, Louisiana-Monroe, 6, 6, 0, 0.50000, 307, 328, -21, 
1970, Mississippi Valley St., 1, 8, 0, 0.11111, 126, 243, -117, 
1971, Mississippi Valley St., 4, 7, 0, 0.36364, 114, 154, -40, 
1972, Mississippi Valley St., 5, 5, 0, 0.50000, 171, 174, -3, 
1973, Mississippi Valley St., 3, 5, 0, 0.37500, 96, 159, -63, 
1974, Mississippi Valley St., 5, 5, 0, 0.50000, 242, 184, 58, 
1975, Mississippi Valley St., 6, 4, 0, 0.60000, 187, 164, 23, 
1976, Mississippi Valley St., 4, 6, 0, 0.40000, 135, 189, -54, 
1977, Mississippi Valley St., 5, 5, 0, 0.50000, 216, 193, 23, 
1951, Texas Tech, 7, 4, 0, 0.63636, 301, 169, 132, 
1952, Texas Tech, 3, 7, 1, 0.31818, 233, 239, -6, 
1953, Texas Tech, 11, 1, 0, 0.91667, 463, 167, 296, 
1954, Texas Tech, 7, 2, 1, 0.75000, 367, 157, 210, 
1955, Texas Tech, 7, 3, 1, 0.68182, 202, 166, 36, 
1956, Texas Tech, 2, 7, 1, 0.25000, 117, 216, -99, 
1957, Texas Tech, 2, 8, 0, 0.20000, 120, 190, -70, 
1958, Texas Tech, 3, 7, 0, 0.30000, 126, 163, -37, 
1959, Texas Tech, 4, 6, 0, 0.40000, 139, 158, -19, 
1960, Texas Tech, 3, 6, 1, 0.35000, 148, 182, -34, 
1960, Kansas St., 1, 9, 0, 0.10000, 78, 316, -238, 
1961, Kansas St., 2, 8, 0, 0.20000, 58, 232, -174, 
1962, Kansas St., 0, 10, 0, 0.00000, 39, 283, -244, 
1963, Kansas St., 2, 7, 0, 0.22222, 91, 222, -131, 
1964, Kansas St., 3, 7, 0, 0.30000, 64, 186, -122, 
1965, Kansas St., 0, 10, 0, 0.00000, 43, 296, -253, 
1966, Kansas St., 0, 9, 1, 0.05000, 66, 226, -160, 
1974, Southern Illinois, 2, 9, 0, 0.18182, 147, 302, -155, 
1975, Southern Illinois, 1, 9, 1, 0.13636, 179, 364, -185, 
1921, West Virginia Tech, 4, 3, 1, 0.56250, 117, 52, 65, 
1932, Charleston (WV), 0, 9, 0, 0.00000, 18, 160, -142, 
1933, Charleston (WV), 1, 8, 0, 0.11111, 51, 185, -134, 
1974, Villanova (PA), 3, 5, 0, 0.37500, 74, 220, -146, 
1933, Wake Forest (NC), 0, 5, 1, 0.08333, 13, 93, -80, 
1934, Wake Forest (NC), 3, 7, 0, 0.30000, 118, 141, -23, 
1935, Wake Forest (NC), 2, 7, 0, 0.22222, 52, 106, -54, 
1936, Wake Forest (NC), 5, 4, 0, 0.55556, 110, 72, 38, 
1905, Baylor (TX), 1, 6, 0, 0.14286, 20, 159, -139, 
1926, Kentucky Wesleyan, 3, 6, 0, 0.33333, 92, 94, -2, 
1969, Arizona, 3, 7, 0, 0.30000, 210, 276, -66, 
1970, Arizona, 4, 6, 0, 0.40000, 168, 213, -45, 
1971, Arizona, 5, 6, 0, 0.45455, 191, 232, -41, 
1972, Arizona, 4, 7, 0, 0.36364, 226, 271, -45, 
1980, Louisville (KY), 5, 6, 0, 0.45455, 162, 203, -41, 
1981, Louisville (KY), 5, 6, 0, 0.45455, 180, 212, -32, 
1982, Louisville (KY), 5, 6, 0, 0.45455, 220, 355, -135, 
1983, Louisville (KY), 3, 8, 0, 0.27273, 157, 351, -194, 
1984, Louisville (KY), 2, 9, 0, 0.18182, 237, 360, -123, 
1909, Hanover (IN), 1, 4, 0, 0.20000, 38, 88, -50, 
1910, Hanover (IN), 2, 3, 0, 0.40000, 63, 71, -8, 
1965, Susquehanna (PA), 0, 2, 0, 0.00000, 56, 70, -14, 
1911, Middle Tennessee St., 0, 2, 0, 0.00000, 0, 26, -26, 
1912, Middle Tennessee St., 1, 0, 0, 1.00000, 29, 7, 22, 
1905, Henderson St. (AR), 2, 1, 0, 0.66667, 47, 16, 31, 
2005, Tennessee St., 2, 9, 0, 0.18182, 136, 303, -167, 
2006, Tennessee St., 6, 5, 0, 0.54545, 241, 242, -1, 
2007, Tennessee St., 5, 6, 0, 0.45455, 328, 367, -39, 
2008, Tennessee St., 8, 4, 0, 0.66667, 375, 287, 88, 
2009, Tennessee St., 4, 7, 0, 0.36364, 161, 208, -47, 
1953, Jacksonville St. (AL), 3, 5, 1, 0.38889, 115, 163, -48, 
1909, Akron (OH), 4, 4, 0, 0.50000, 54, 69, -15, 
1919, Pittsburg St. (KS), 7, 2, 1, 0.75000, 142, 76, 66, 
1920, Pittsburg St. (KS), 7, 2, 1, 0.75000, 117, 95, 22, 
1921, Pittsburg St. (KS), 7, 2, 1, 0.75000, 155, 65, 90, 
1922, Pittsburg St. (KS), 4, 5, 0, 0.44444, 79, 81, -2, 
1923, Pittsburg St. (KS), 3, 3, 2, 0.50000, 57, 85, -28, 
1924, Pittsburg St. (KS), 7, 0, 1, 0.93750, 111, 16, 95, 
1925, Pittsburg St. (KS), 6, 2, 1, 0.72222, 160, 37, 123, 
1926, Pittsburg St. (KS), 2, 6, 0, 0.25000, 49, 70, -21, 
1927, Pittsburg St. (KS), 6, 2, 0, 0.75000, 154, 45, 109, 
1928, Pittsburg St. (KS), 0, 7, 0, 0.00000, 12, 113, -101, 
1960, New Mexico, 5, 5, 0, 0.50000, 234, 182, 52, 
1961, New Mexico, 7, 4, 0, 0.63636, 215, 197, 18, 
1962, New Mexico, 7, 2, 1, 0.75000, 210, 159, 51, 
1963, New Mexico, 6, 4, 0, 0.60000, 177, 143, 34, 
1964, New Mexico, 9, 2, 0, 0.81818, 185, 90, 95, 
1965, New Mexico, 3, 7, 0, 0.30000, 127, 226, -99, 
1966, New Mexico, 2, 8, 0, 0.20000, 101, 320, -219, 
1967, New Mexico, 1, 9, 0, 0.10000, 152, 433, -281, 
1898, Massachusetts, 1, 4, 1, 0.25000, 40, 46, -6, 
1903, Kansas, 6, 3, 0, 0.66667, 118, 39, 79, 
1904, Beloit (WI), 5, 5, 1, 0.50000, 161, 117, 44, 
1923, Fort Hays St. (KS), 4, 3, 2, 0.55556, 94, 78, 16, 
1924, Fort Hays St. (KS), 4, 4, 0, 0.50000, 75, 81, -6, 
1925, Fort Hays St. (KS), 2, 4, 1, 0.35714, 37, 42, -5, 
1926, Fort Hays St. (KS), 3, 5, 0, 0.37500, 81, 58, 23, 
1927, Fort Hays St. (KS), 3, 5, 1, 0.38889, 64, 118, -54, 
1928, Fort Hays St. (KS), 3, 4, 1, 0.43750, 38, 116, -78, 
1911, Bloomsburg JV (PA), 3, 3, 3, 0.50000, 27, 100, -73, 
1912, Bloomsburg (PA), 5, 3, 1, 0.61111, 253, 59, 194, 
1913, Bloomsburg (PA), 5, 3, 0, 0.62500, 149, 151, -2, 
1914, Bloomsburg (PA), 5, 5, 0, 0.50000, 139, 149, -10, 
1915, Bloomsburg (PA), 5, 2, 1, 0.68750, 161, 36, 125, 
1916, Bloomsburg (PA), 4, 4, 1, 0.50000, 137, 179, -42, 
1917, Bloomsburg (PA), 4, 2, 1, 0.64286, 117, 105, 12, 
1944, New York (NY), 2, 5, 0, 0.28571, 71, 160, -89, 
1945, New York (NY), 3, 4, 0, 0.42857, 89, 125, -36, 
1946, New York (NY), 5, 3, 0, 0.62500, 101, 163, -62, 
1982, Central Florida, 0, 10, 0, 0.00000, 109, 356, -247, 
2005, Notre Dame (IN), 9, 3, 0, 0.75000, 440, 294, 146, 
2006, Notre Dame (IN), 10, 3, 0, 0.76923, 403, 310, 93, 
2007, Notre Dame (IN), 3, 9, 0, 0.25000, 197, 345, -148, 
2008, Notre Dame (IN), 7, 6, 0, 0.53846, 321, 288, 33, 
2009, Notre Dame (IN), 6, 6, 0, 0.50000, 361, 311, 50, 
2012, Kansas, 1, 11, 0, 0.08333, 219, 433, -214, 
2013, Kansas, 3, 9, 0, 0.25000, 184, 382, -198, 
1978, Worcester Tech (MA), 2, 6, 0, 0.25000, 84, 160, -76, 
1979, Worcester Tech (MA), 3, 5, 0, 0.37500, 102, 128, -26, 
1980, Worcester Tech (MA), 5, 3, 0, 0.62500, 144, 99, 45, 
1981, Worcester Tech (MA), 6, 2, 0, 0.75000, 172, 85, 87, 
1982, Worcester Tech (MA), 5, 3, 0, 0.62500, 211, 110, 101, 
1983, Worcester Tech (MA), 8, 0, 0, 1.00000, 225, 56, 169, 
1984, Worcester Tech (MA), 5, 3, 0, 0.62500, 204, 117, 87, 
1985, Worcester Tech (MA), 4, 4, 0, 0.50000, 132, 166, -34, 
1986, Worcester Tech (MA), 5, 3, 0, 0.62500, 190, 149, 41, 
1987, Worcester Tech (MA), 2, 6, 0, 0.25000, 159, 203, -44, 
2013, Connecticut, 3, 5, 0, 0.37500, 175, 233, -58, 
1928, Emporia St. (KS), 6, 1, 1, 0.81250, 182, 37, 145, 
1929, Emporia St. (KS), 6, 2, 0, 0.75000, 91, 44, 47, 
1930, Emporia St. (KS), 4, 2, 3, 0.61111, 180, 83, 97, 
1931, Emporia St. (KS), 4, 4, 0, 0.50000, 93, 98, -5, 
1932, Emporia St. (KS), 2, 6, 1, 0.27778, 64, 85, -21, 
1933, Emporia St. (KS), 3, 5, 1, 0.38889, 68, 119, -51, 
1934, Emporia St. (KS), 7, 2, 0, 0.77778, 93, 73, 20, 
1935, Emporia St. (KS), 5, 4, 0, 0.55556, 139, 63, 76, 
1936, Emporia St. (KS), 6, 4, 0, 0.60000, 172, 121, 51, 
1937, Emporia St. (KS), 5, 2, 2, 0.66667, 165, 152, 13, 
1938, Emporia St. (KS), 3, 6, 0, 0.33333, 115, 128, -13, 
1939, Emporia St. (KS), 6, 3, 0, 0.66667, 203, 45, 158, 
1940, Emporia St. (KS), 6, 2, 0, 0.75000, 174, 61, 113, 
1941, Emporia St. (KS), 4, 3, 2, 0.55556, 117, 103, 14, 
1942, Emporia St. (KS), 3, 4, 1, 0.43750, 117, 138, -21, 
1946, Emporia St. (KS), 4, 5, 0, 0.44444, 171, 163, 8, 
1947, Emporia St. (KS), 7, 1, 1, 0.83333, 186, 79, 107, 
1948, Emporia St. (KS), 8, 2, 0, 0.80000, 279, 115, 164, 
1949, Emporia St. (KS), 6, 4, 0, 0.60000, 252, 158, 94, 
1950, Emporia St. (KS), 6, 2, 1, 0.72222, 185, 119, 66, 
1951, Emporia St. (KS), 5, 3, 1, 0.61111, 173, 104, 69, 
1952, Emporia St. (KS), 7, 3, 0, 0.70000, 167, 146, 21, 
1953, Emporia St. (KS), 2, 5, 1, 0.31250, 118, 161, -43, 
1954, Emporia St. (KS), 2, 7, 0, 0.22222, 99, 213, -114, 
1931, Charleston (WV), 5, 5, 0, 0.50000, 83, 103, -20, 
1919, Washington St., 5, 2, 0, 0.71429, 156, 33, 123, 
1920, Washington St., 5, 1, 0, 0.83333, 129, 76, 53, 
1921, Washington St., 4, 2, 1, 0.64286, 109, 62, 47, 
1922, Washington St., 2, 5, 0, 0.28571, 44, 163, -119, 
1985, Kansas Wesleyan, 2, 8, 0, 0.20000, 150, 273, -123, 
1986, Kansas Wesleyan, 6, 4, 0, 0.60000, 250, 173, 77, 
1978, Chadron St. (NE), 7, 2, 2, 0.72727, 240, 187, 53, 
1979, Chadron St. (NE), 4, 5, 1, 0.45000, 108, 170, -62, 
1980, Chadron St. (NE), 5, 5, 0, 0.50000, 188, 206, -18, 
1981, Chadron St. (NE), 6, 5, 0, 0.54545, 252, 204, 48, 
1994, Ithaca (NY), 10, 3, 0, 0.76923, 223, 166, 57, 
1995, Ithaca (NY), 5, 4, 0, 0.55556, 240, 155, 85, 
1996, Ithaca (NY), 7, 3, 0, 0.70000, 302, 192, 110, 
1997, Ithaca (NY), 7, 3, 0, 0.70000, 316, 141, 175, 
1998, Ithaca (NY), 9, 2, 0, 0.81818, 395, 227, 168, 
1999, Ithaca (NY), 7, 4, 0, 0.63636, 308, 223, 85, 
2000, Ithaca (NY), 7, 3, 0, 0.70000, 262, 179, 83, 
2001, Ithaca (NY), 11, 2, 0, 0.84615, 446, 207, 239, 
2002, Ithaca (NY), 7, 3, 0, 0.70000, 230, 137, 93, 
2003, Ithaca (NY), 10, 3, 0, 0.76923, 358, 191, 167, 
2004, Ithaca (NY), 9, 2, 0, 0.81818, 420, 150, 270, 
2005, Ithaca (NY), 8, 3, 0, 0.72727, 422, 288, 134, 
2006, Ithaca (NY), 7, 3, 0, 0.70000, 294, 146, 148, 
2007, Ithaca (NY), 8, 3, 0, 0.72727, 367, 217, 150, 
2008, Ithaca (NY), 9, 2, 0, 0.81818, 400, 242, 158, 
2009, Ithaca (NY), 7, 3, 0, 0.70000, 275, 212, 63, 
2010, Ithaca (NY), 6, 4, 0, 0.60000, 242, 178, 64, 
2011, Ithaca (NY), 4, 6, 0, 0.40000, 183, 195, -12, 
2012, Ithaca (NY), 6, 4, 0, 0.60000, 228, 177, 51, 
2013, Ithaca (NY), 9, 3, 0, 0.75000, 255, 191, 64, 
1942, Washington, 4, 3, 3, 0.55000, 113, 60, 53, 
1943, Washington, 4, 1, 0, 0.80000, 150, 61, 89, 
1944, Washington, 5, 3, 0, 0.62500, 293, 132, 161, 
1945, Washington, 6, 3, 0, 0.66667, 91, 54, 37, 
1946, Washington, 5, 4, 0, 0.55556, 144, 140, 4, 
1947, Washington, 3, 6, 0, 0.33333, 98, 99, -1, 
1918, Franklin & Marshall (PA), 2, 1, 0, 0.66667, 31, 20, 11, 
1969, Lock Haven (PA), 3, 4, 0, 0.42857, 137, 165, -28, 
1970, Lock Haven (PA), 1, 7, 0, 0.12500, 153, 244, -91, 
1971, Lock Haven (PA), 4, 4, 0, 0.50000, 160, 113, 47, 
1972, Lock Haven (PA), 4, 5, 0, 0.44444, 198, 310, -112, 
1973, Lock Haven (PA), 2, 7, 0, 0.22222, 127, 335, -208, 
1974, Lock Haven (PA), 1, 8, 0, 0.11111, 53, 211, -158, 
1975, Lock Haven (PA), 1, 8, 0, 0.11111, 60, 283, -223, 
1941, Henderson St. (AR), 1, 7, 2, 0.20000, 40, 91, -51, 
1945, Henderson St. (AR), 3, 5, 0, 0.37500, 62, 92, -30, 
1946, Henderson St. (AR), 6, 3, 1, 0.65000, 142, 131, 11, 
1947, Henderson St. (AR), 1, 7, 1, 0.16667, 65, 148, -83, 
1948, Henderson St. (AR), 2, 7, 0, 0.22222, 96, 171, -75, 
1949, Henderson St. (AR), 7, 2, 0, 0.77778, 191, 110, 81, 
1950, Henderson St. (AR), 5, 2, 2, 0.66667, 183, 107, 76, 
1951, Henderson St. (AR), 5, 3, 1, 0.61111, 176, 113, 63, 
1952, Henderson St. (AR), 4, 4, 0, 0.50000, 177, 153, 24, 
1953, Henderson St. (AR), 3, 5, 0, 0.37500, 88, 143, -55, 
1954, Henderson St. (AR), 4, 4, 0, 0.50000, 134, 114, 20, 
1955, Henderson St. (AR), 5, 3, 1, 0.61111, 195, 136, 59, 
1956, Henderson St. (AR), 4, 4, 1, 0.50000, 118, 194, -76, 
1957, Henderson St. (AR), 2, 5, 1, 0.31250, 68, 122, -54, 
1958, Henderson St. (AR), 3, 6, 0, 0.33333, 118, 125, -7, 
1959, Henderson St. (AR), 6, 2, 1, 0.72222, 111, 75, 36, 
1960, Henderson St. (AR), 6, 4, 0, 0.60000, 200, 82, 118, 
1961, Henderson St. (AR), 4, 6, 0, 0.40000, 116, 169, -53, 
1908, Jacksonville St. (AL), 4, 3, 0, 0.57143, 32, 51, -19, 
1898, Alma (MI), 1, 2, 0, 0.33333, 27, 26, 1, 
2002, Endicott College (MA), 1, 6, 0, 0.14286, 78, 187, -109, 
2003, Endicott College (MA), 4, 5, 0, 0.44444, 170, 212, -42, 
2004, Endicott College (MA), 6, 4, 0, 0.60000, 214, 241, -27, 
2005, Endicott College (MA), 7, 3, 0, 0.70000, 252, 136, 116, 
2006, Endicott College (MA), 6, 4, 0, 0.60000, 203, 128, 75, 
2007, Endicott College (MA), 3, 6, 0, 0.33333, 171, 212, -41, 
2008, Endicott College (MA), 3, 7, 0, 0.30000, 226, 298, -72, 
2009, Endicott College (MA), 5, 5, 0, 0.50000, 237, 225, 12, 
2010, Endicott College (MA), 9, 3, 0, 0.75000, 353, 238, 115, 
2011, Endicott College (MA), 10, 1, 0, 0.90909, 446, 182, 264, 
2012, Endicott College (MA), 9, 2, 0, 0.81818, 448, 215, 233, 
2013, Endicott College (MA), 8, 3, 0, 0.72727, 376, 201, 175, 
1892, Syracuse (NY), 0, 8, 1, 0.05556, 4, 218, -214, 
1951, Augustana (SD), 3, 5, 0, 0.37500, 114, 257, -143, 
1952, Augustana (SD), 0, 9, 0, 0.00000, 105, 311, -206, 
2013, Utah St., 9, 5, 0, 0.64286, 445, 239, 206, 
2008, Savannah St. (GA), 5, 7, 0, 0.41667, 230, 241, -11, 
2009, Savannah St. (GA), 2, 8, 0, 0.20000, 202, 324, -122, 
1979, Maranatha Baptist Bible (WI), 1, 7, 0, 0.12500, 94, 232, -138, 
1980, Maranatha Baptist Bible (WI), 1, 6, 1, 0.18750, 50, 221, -171, 
1981, Maranatha Baptist Bible (WI), 2, 6, 0, 0.25000, 82, 184, -102, 
1982, Maranatha Baptist Bible (WI), 2, 6, 0, 0.25000, 53, 209, -156, 
1983, Maranatha Baptist Bible (WI), 0, 8, 0, 0.00000, 53, 289, -236, 
1944, Saint John's (MN), 1, 0, 1, 0.75000, 19, 18, 1, 
1973, Navy (MD), 4, 7, 0, 0.36364, 221, 232, -11, 
1974, Navy (MD), 4, 7, 0, 0.36364, 131, 229, -98, 
1975, Navy (MD), 7, 4, 0, 0.63636, 227, 125, 102, 
1976, Navy (MD), 4, 7, 0, 0.36364, 187, 257, -70, 
1977, Navy (MD), 5, 6, 0, 0.45455, 229, 230, -1, 
1978, Navy (MD), 9, 3, 0, 0.75000, 260, 136, 124, 
1979, Navy (MD), 7, 4, 0, 0.63636, 180, 154, 26, 
1980, Navy (MD), 8, 4, 0, 0.66667, 226, 146, 80, 
1981, Navy (MD), 7, 4, 1, 0.62500, 244, 183, 61, 
1982, Virginia, 2, 9, 0, 0.18182, 208, 320, -112, 
1983, Virginia, 6, 5, 0, 0.54545, 252, 280, -28, 
1984, Virginia, 8, 2, 2, 0.75000, 325, 233, 92, 
1985, Virginia, 6, 5, 0, 0.54545, 262, 217, 45, 
1986, Virginia, 3, 8, 0, 0.27273, 198, 315, -117, 
1987, Virginia, 8, 4, 0, 0.66667, 292, 276, 16, 
1988, Virginia, 7, 4, 0, 0.63636, 251, 244, 7, 
1989, Virginia, 10, 3, 0, 0.76923, 371, 272, 99, 
1990, Virginia, 8, 4, 0, 0.66667, 464, 227, 237, 
1991, Virginia, 8, 3, 1, 0.70833, 327, 167, 160, 
1992, Virginia, 7, 4, 0, 0.63636, 341, 229, 112, 
1993, Virginia, 7, 5, 0, 0.58333, 317, 217, 100, 
1994, Virginia, 9, 3, 0, 0.75000, 370, 195, 175, 
1995, Virginia, 9, 4, 0, 0.69231, 378, 270, 108, 
1996, Virginia, 7, 5, 0, 0.58333, 341, 203, 138, 
1997, Virginia, 7, 4, 0, 0.63636, 277, 242, 35, 
1998, Virginia, 9, 3, 0, 0.75000, 358, 247, 111, 
1999, Virginia, 7, 5, 0, 0.58333, 345, 365, -20, 
2000, Virginia, 6, 6, 0, 0.50000, 242, 292, -50, 
1997, Cal Poly-San Luis Obispo, 10, 1, 0, 0.90909, 382, 213, 169, 
1998, Cal Poly-San Luis Obispo, 3, 8, 0, 0.27273, 226, 329, -103, 
1999, Cal Poly-San Luis Obispo, 3, 8, 0, 0.27273, 246, 345, -99, 
2000, Cal Poly-San Luis Obispo, 3, 8, 0, 0.27273, 301, 395, -94, 
1905, Alabama St., 0, 2, 0, 0.00000, 0, 11, -11, 
2013, Westminster (MO), 2, 8, 0, 0.20000, 248, 319, -71, 
1920, Boston (MA), 4, 3, 1, 0.56250, 49, 48, 1, 
1925, Lehigh (PA), 3, 5, 1, 0.38889, 62, 113, -51, 
1926, Lehigh (PA), 1, 8, 0, 0.11111, 32, 168, -136, 
1927, Lehigh (PA), 1, 7, 1, 0.16667, 31, 196, -165, 
1950, North Dakota St., 2, 7, 0, 0.22222, 96, 240, -144, 
1951, North Dakota St., 1, 5, 1, 0.21429, 61, 123, -62, 
1952, North Dakota St., 5, 4, 0, 0.55556, 153, 174, -21, 
1953, North Dakota St., 3, 5, 0, 0.37500, 114, 168, -54, 
1894, Texas, 6, 1, 0, 0.85714, 191, 28, 163, 
1941, Allegheny (PA), 1, 5, 0, 0.16667, 39, 150, -111, 
1942, Allegheny (PA), 1, 5, 0, 0.16667, 39, 153, -114, 
1904, South Dakota St., 4, 2, 1, 0.64286, 90, 27, 63, 
1902, North Central (IL), 4, 2, 2, 0.62500, 42, 76, -34, 
1903, North Central (IL), 3, 3, 0, 0.50000, 95, 73, 22, 
1895, Wofford (SC), 3, 1, 0, 0.75000, 66, 34, 32, 
1897, Richmond (VA), 3, 5, 0, 0.37500, 40, 146, -106, 
1898, South Carolina, 1, 2, 0, 0.33333, 16, 35, -19, 
2006, Central St. (OH), 2, 5, 0, 0.28571, 200, 225, -25, 
2007, Central St. (OH), 5, 5, 0, 0.50000, 259, 322, -63, 
2008, Central St. (OH), 2, 7, 0, 0.22222, 159, 280, -121, 
1934, Howard (DC), 4, 2, 2, 0.62500, 63, 26, 37, 
1935, Howard (DC), 3, 6, 0, 0.33333, 46, 166, -120, 
1919, South Dakota St., 4, 1, 1, 0.75000, 78, 20, 58, 
1920, South Dakota St., 4, 2, 1, 0.64286, 67, 27, 40, 
1921, South Dakota St., 7, 1, 0, 0.87500, 255, 38, 217, 
1922, South Dakota St., 5, 4, 1, 0.55000, 208, 84, 124, 
1923, South Dakota St., 3, 4, 0, 0.42857, 121, 85, 36, 
1924, South Dakota St., 7, 1, 0, 0.87500, 105, 28, 77, 
1925, South Dakota St., 2, 3, 2, 0.42857, 20, 45, -25, 
1926, South Dakota St., 8, 1, 3, 0.79167, 171, 36, 135, 
1927, South Dakota St., 5, 3, 0, 0.62500, 181, 84, 97, 
1928, North Dakota, 6, 1, 1, 0.81250, 199, 33, 166, 
1929, North Dakota, 9, 1, 0, 0.90000, 193, 40, 153, 
1930, North Dakota, 9, 1, 0, 0.90000, 203, 55, 148, 
1931, North Dakota, 8, 1, 2, 0.81818, 276, 60, 216, 
1932, North Dakota, 7, 1, 0, 0.87500, 152, 26, 126, 
1933, North Dakota, 3, 5, 1, 0.38889, 102, 127, -25, 
1934, North Dakota, 7, 1, 0, 0.87500, 88, 7, 81, 
1935, North Dakota, 6, 2, 2, 0.70000, 163, 76, 87, 
1936, North Dakota, 9, 2, 0, 0.81818, 184, 70, 114, 
1937, North Dakota, 4, 4, 0, 0.50000, 97, 79, 18, 
1938, North Dakota, 6, 2, 0, 0.75000, 151, 86, 65, 
1939, North Dakota, 5, 3, 0, 0.62500, 124, 78, 46, 
1940, North Dakota, 5, 4, 0, 0.55556, 102, 110, -8, 
1941, North Dakota, 4, 5, 0, 0.44444, 110, 145, -35, 
1945, North Dakota, 1, 2, 0, 0.33333, 43, 59, -16, 
1892, Georgia Tech, 0, 3, 0, 0.00000, 16, 58, -42, 
1946, Texas St., 6, 2, 2, 0.70000, 115, 52, 63, 
1947, Texas St., 5, 4, 0, 0.55556, 115, 92, 23, 
1948, Texas St., 8, 1, 0, 0.88889, 111, 34, 77, 
1949, Texas St., 3, 6, 1, 0.35000, 124, 168, -44, 
1950, Texas St., 6, 3, 0, 0.66667, 145, 136, 9, 
2005, Indiana St., 0, 11, 0, 0.00000, 193, 476, -283, 
2006, Indiana St., 1, 10, 0, 0.09091, 236, 493, -257, 
2007, Indiana St., 0, 11, 0, 0.00000, 123, 541, -418, 
1927, Delta St. (MS), 3, 5, 0, 0.37500, 83, 92, -9, 
1920, Chadron St. (NE), 4, 3, 0, 0.57143, 179, 73, 106, 
1921, Chadron St. (NE), 2, 4, 0, 0.33333, 54, 86, -32, 
1922, Chadron St. (NE), 4, 2, 1, 0.64286, 68, 26, 42, 
1923, Chadron St. (NE), 7, 0, 1, 0.93750, 270, 24, 246, 
1993, Clemson (SC), 5, 7, 0, 0.41667, 264, 389, -125, 
1994, Clemson (SC), 5, 6, 0, 0.45455, 164, 188, -24, 
1995, Clemson (SC), 8, 4, 0, 0.66667, 303, 219, 84, 
1996, Clemson (SC), 7, 5, 0, 0.58333, 245, 241, 4, 
1997, Clemson (SC), 7, 5, 0, 0.58333, 292, 219, 73, 
1998, Clemson (SC), 3, 8, 0, 0.27273, 218, 272, -54, 
2001, Memphis (TN), 5, 6, 0, 0.45455, 294, 281, 13, 
2002, Memphis (TN), 3, 9, 0, 0.25000, 303, 327, -24, 
2003, Memphis (TN), 9, 4, 0, 0.69231, 393, 250, 143, 
2004, Memphis (TN), 8, 4, 0, 0.66667, 430, 375, 55, 
2005, Memphis (TN), 7, 5, 0, 0.58333, 326, 276, 50, 
2006, Memphis (TN), 2, 10, 0, 0.16667, 281, 365, -84, 
2007, Memphis (TN), 7, 6, 0, 0.53846, 380, 419, -39, 
2008, Memphis (TN), 6, 7, 0, 0.46154, 353, 353, 0, 
2009, Memphis (TN), 2, 10, 0, 0.16667, 262, 418, -156, 
1974, Western Illinois, 7, 3, 0, 0.70000, 252, 191, 61, 
1975, Western Illinois, 5, 4, 1, 0.55000, 159, 162, -3, 
1978, West Liberty St. (WV), 2, 8, 0, 0.20000, 107, 274, -167, 
1979, West Liberty St. (WV), 7, 2, 1, 0.75000, 153, 108, 45, 
1980, West Liberty St. (WV), 0, 10, 0, 0.00000, 129, 250, -121, 
1981, West Liberty St. (WV), 2, 7, 0, 0.22222, 168, 224, -56, 
1962, Parsons (IA), 9, 0, 0, 1.00000, 267, 63, 204, 
1963, Parsons (IA), 5, 4, 0, 0.55556, 202, 105, 97, 
1966, Albert Lea (MN), 5, 1, 1, 0.78571, 166, 72, 94, 
1967, Albert Lea (MN), 4, 5, 0, 0.44444, 237, 158, 79, 
1968, Albert Lea (MN), 6, 2, 1, 0.72222, 171, 114, 57, 
1969, Albert Lea (MN), 5, 5, 0, 0.50000, 197, 209, -12, 
1970, Albert Lea (MN), 4, 4, 0, 0.50000, 118, 124, -6, 
1971, Albert Lea (MN), 3, 5, 0, 0.37500, 147, 161, -14, 
1972, Pacific Lutheran (WA), 6, 3, 0, 0.66667, 202, 121, 81, 
1973, Pacific Lutheran (WA), 7, 3, 0, 0.70000, 265, 181, 84, 
1974, Pacific Lutheran (WA), 8, 1, 0, 0.88889, 325, 112, 213, 
1975, Pacific Lutheran (WA), 7, 2, 0, 0.77778, 305, 104, 201, 
1976, Pacific Lutheran (WA), 6, 4, 0, 0.60000, 283, 187, 96, 
1977, Pacific Lutheran (WA), 8, 2, 0, 0.80000, 311, 97, 214, 
1978, Pacific Lutheran (WA), 6, 3, 0, 0.66667, 202, 103, 99, 
1979, Pacific Lutheran (WA), 9, 2, 0, 0.81818, 260, 136, 124, 
1980, Pacific Lutheran (WA), 11, 1, 0, 0.91667, 397, 132, 265, 
1981, Pacific Lutheran (WA), 9, 1, 0, 0.90000, 286, 91, 195, 
1982, Pacific Lutheran (WA), 7, 2, 0, 0.77778, 269, 121, 148, 
1983, Pacific Lutheran (WA), 9, 3, 0, 0.75000, 365, 163, 202, 
1984, Pacific Lutheran (WA), 6, 3, 0, 0.66667, 235, 140, 95, 
1985, Pacific Lutheran (WA), 10, 1, 1, 0.87500, 447, 189, 258, 
1986, Pacific Lutheran (WA), 8, 2, 0, 0.80000, 362, 154, 208, 
1987, Pacific Lutheran (WA), 11, 1, 1, 0.88462, 398, 239, 159, 
1988, Pacific Lutheran (WA), 7, 3, 0, 0.70000, 365, 219, 146, 
1989, Pacific Lutheran (WA), 6, 2, 1, 0.72222, 357, 247, 110, 
1990, Pacific Lutheran (WA), 9, 2, 0, 0.81818, 313, 140, 173, 
1991, Pacific Lutheran (WA), 11, 2, 0, 0.84615, 421, 212, 209, 
1992, Pacific Lutheran (WA), 9, 2, 0, 0.81818, 402, 151, 251, 
1993, Pacific Lutheran (WA), 12, 0, 1, 0.96154, 573, 251, 322, 
1994, Pacific Lutheran (WA), 11, 2, 0, 0.84615, 340, 189, 151, 
1995, Pacific Lutheran (WA), 6, 3, 1, 0.65000, 269, 215, 54, 
1996, Pacific Lutheran (WA), 7, 3, 0, 0.70000, 312, 216, 96, 
1997, Pacific Lutheran (WA), 7, 2, 0, 0.77778, 316, 234, 82, 
1998, Pacific Lutheran (WA), 8, 2, 0, 0.80000, 273, 197, 76, 
1999, Pacific Lutheran (WA), 13, 1, 0, 0.92857, 559, 267, 292, 
2000, Pacific Lutheran (WA), 9, 2, 0, 0.81818, 459, 212, 247, 
2001, Pacific Lutheran (WA), 8, 3, 0, 0.72727, 356, 240, 116, 
2002, Pacific Lutheran (WA), 5, 4, 0, 0.55556, 286, 193, 93, 
2003, Pacific Lutheran (WA), 6, 3, 0, 0.66667, 258, 169, 89, 
2004, Pacific Lutheran (WA), 6, 3, 0, 0.66667, 284, 219, 65, 
2005, Pacific Lutheran (WA), 3, 6, 0, 0.33333, 262, 291, -29, 
2006, Pacific Lutheran (WA), 4, 5, 0, 0.44444, 232, 198, 34, 
2007, Pacific Lutheran (WA), 7, 2, 0, 0.77778, 292, 156, 136, 
2008, Pacific Lutheran (WA), 3, 6, 0, 0.33333, 157, 242, -85, 
2009, Pacific Lutheran (WA), 3, 6, 0, 0.33333, 242, 294, -52, 
2010, Pacific Lutheran (WA), 8, 1, 0, 0.88889, 289, 202, 87, 
2011, Pacific Lutheran (WA), 6, 3, 0, 0.66667, 186, 167, 19, 
2012, Pacific Lutheran (WA), 7, 3, 0, 0.70000, 326, 222, 104, 
2013, Pacific Lutheran (WA), 8, 2, 0, 0.80000, 271, 231, 40, 
1951, Maine, 6, 0, 1, 0.92857, 193, 40, 153, 
1952, Maine, 4, 3, 0, 0.57143, 141, 78, 63, 
1953, Maine, 4, 2, 1, 0.64286, 160, 79, 81, 
1954, Maine, 5, 2, 0, 0.71429, 176, 87, 89, 
1955, Maine, 5, 1, 1, 0.78571, 175, 34, 141, 
1956, Maine, 5, 2, 0, 0.71429, 162, 60, 102, 
1957, Maine, 4, 3, 0, 0.57143, 117, 64, 53, 
1958, Maine, 6, 2, 0, 0.75000, 191, 51, 140, 
1959, Maine, 3, 3, 2, 0.50000, 126, 82, 44, 
1960, Maine, 4, 3, 1, 0.56250, 124, 111, 13, 
1961, Maine, 8, 0, 1, 0.94444, 138, 76, 62, 
1962, Maine, 4, 4, 0, 0.50000, 102, 67, 35, 
1963, Maine, 5, 3, 0, 0.62500, 202, 86, 116, 
1964, Maine, 5, 3, 0, 0.62500, 178, 81, 97, 
1965, Maine, 8, 2, 0, 0.80000, 240, 109, 131, 
1966, Maine, 4, 5, 0, 0.44444, 157, 99, 58, 
2013, Clark Atlanta (GA), 3, 7, 0, 0.30000, 154, 291, -137, 
1921, Michigan Tech, 1, 1, 0, 0.50000, 18, 14, 4, 
1922, Michigan Tech, 1, 0, 1, 0.75000, 12, 0, 12, 
1915, Chadron St. (NE), 1, 1, 0, 0.50000, 27, 19, 8, 
1916, Chadron St. (NE), 0, 0, 1, 0.50000, 12, 12, 0, 
2013, Wesleyan (CT), 7, 1, 0, 0.87500, 243, 104, 139, 
1957, Hampton (VA), 4, 5, 0, 0.44444, 59, 138, -79, 
1958, Hampton (VA), 7, 3, 0, 0.70000, 202, 155, 47, 
1959, Hampton (VA), 4, 4, 1, 0.50000, 117, 96, 21, 
1960, Hampton (VA), 5, 4, 0, 0.55556, 174, 121, 53, 
1961, Hampton (VA), 6, 3, 0, 0.66667, 157, 77, 80, 
1962, Hampton (VA), 3, 6, 0, 0.33333, 100, 163, -63, 
1963, Hampton (VA), 4, 5, 0, 0.44444, 130, 209, -79, 
1964, Hampton (VA), 1, 8, 0, 0.11111, 104, 256, -152, 
1896, South Carolina, 1, 3, 0, 0.25000, 20, 30, -10, 
1929, Mesa St. (CO), 5, 3, 0, 0.62500, 136, 101, 35, 
1894, Drake (IA), 3, 2, 0, 0.60000, 50, 56, -6, 
1939, Western Carolina (NC), 1, 6, 1, 0.18750, 27, 177, -150, 
1940, Western Carolina (NC), 2, 5, 1, 0.31250, 64, 190, -126, 
1941, Western Carolina (NC), 3, 5, 0, 0.37500, 47, 141, -94, 
1914, Kansas, 5, 2, 1, 0.68750, 158, 84, 74, 
1963, Kentucky St., 5, 4, 0, 0.55556, 200, 115, 85, 
1964, Kentucky St., 7, 3, 0, 0.70000, 283, 134, 149, 
1965, Kentucky St., 4, 4, 0, 0.50000, 211, 145, 66, 
1966, Kentucky St., 3, 4, 1, 0.43750, 150, 161, -11, 
1967, Kentucky St., 5, 3, 1, 0.61111, 173, 89, 84, 
1930, Amherst (MA), 4, 2, 2, 0.62500, 156, 78, 78, 
1931, Amherst (MA), 2, 5, 0, 0.28571, 83, 106, -23, 
1962, Abilene Christian (TX), 6, 4, 0, 0.60000, 150, 162, -12, 
1963, Abilene Christian (TX), 8, 1, 0, 0.88889, 243, 94, 149, 
1964, Abilene Christian (TX), 5, 5, 0, 0.50000, 170, 168, 2, 
1965, Abilene Christian (TX), 4, 5, 0, 0.44444, 196, 168, 28, 
1966, Abilene Christian (TX), 4, 6, 0, 0.40000, 160, 237, -77, 
1967, Abilene Christian (TX), 3, 6, 0, 0.33333, 130, 201, -71, 
1968, Colgate (NY), 5, 5, 0, 0.50000, 208, 220, -12, 
1969, Colgate (NY), 5, 3, 1, 0.61111, 172, 197, -25, 
1970, Colgate (NY), 5, 6, 0, 0.45455, 198, 288, -90, 
1971, Colgate (NY), 6, 4, 0, 0.60000, 287, 262, 25, 
1972, Colgate (NY), 5, 4, 1, 0.55000, 219, 269, -50, 
1973, Colgate (NY), 5, 5, 0, 0.50000, 295, 264, 31, 
1974, Colgate (NY), 4, 6, 0, 0.40000, 220, 318, -98, 
1975, Colgate (NY), 6, 4, 0, 0.60000, 205, 218, -13, 
1976, Holy Cross (MA), 3, 8, 0, 0.27273, 204, 327, -123, 
1977, Holy Cross (MA), 2, 9, 0, 0.18182, 130, 270, -140, 
1978, Holy Cross (MA), 7, 4, 0, 0.63636, 258, 201, 57, 
1979, Holy Cross (MA), 5, 6, 0, 0.45455, 174, 179, -5, 
1980, Holy Cross (MA), 3, 8, 0, 0.27273, 163, 228, -65, 
1921, Boston (MA), 6, 2, 0, 0.75000, 115, 44, 71, 
1922, Boston (MA), 2, 4, 3, 0.38889, 63, 76, -13, 
1923, Boston (MA), 1, 6, 0, 0.14286, 21, 181, -160, 
1924, Boston (MA), 1, 5, 0, 0.16667, 13, 122, -109, 
1925, Boston (MA), 1, 5, 0, 0.16667, 34, 181, -147, 
1902, Allegheny (PA), 7, 3, 0, 0.70000, 74, 77, -3, 
1942, Navy (MD), 5, 4, 0, 0.55556, 82, 58, 24, 
1943, Navy (MD), 8, 1, 0, 0.88889, 237, 80, 157, 
2013, Trinity International (IL), 5, 5, 0, 0.50000, 304, 245, 59, 
1974, Troy (AL), 6, 4, 0, 0.60000, 274, 218, 56, 
1975, Troy (AL), 6, 4, 0, 0.60000, 194, 172, 22, 
1900, Creighton (NE), 3, 3, 1, 0.50000, 51, 39, 12, 
1901, Creighton (NE), 6, 1, 1, 0.81250, 82, 11, 71, 
1902, California, 8, 0, 0, 1.00000, 168, 12, 156, 
1903, California, 6, 1, 2, 0.77778, 128, 12, 116, 
1988, New Haven (CT), 7, 3, 0, 0.70000, 275, 214, 61, 
1989, New Haven (CT), 8, 2, 0, 0.80000, 285, 171, 114, 
1990, New Haven (CT), 7, 3, 0, 0.70000, 381, 311, 70, 
1991, New Haven (CT), 3, 7, 0, 0.30000, 320, 378, -58, 
1992, New Haven (CT), 12, 1, 0, 0.92308, 613, 289, 324, 
1993, New Haven (CT), 11, 1, 0, 0.91667, 630, 233, 397, 
1994, Brown (RI), 7, 3, 0, 0.70000, 229, 197, 32, 
1995, Brown (RI), 5, 5, 0, 0.50000, 282, 239, 43, 
1996, Brown (RI), 5, 5, 0, 0.50000, 238, 246, -8, 
1997, Brown (RI), 7, 3, 0, 0.70000, 274, 194, 80, 
1998, Massachusetts, 12, 3, 0, 0.80000, 524, 423, 101, 
1999, Massachusetts, 9, 4, 0, 0.69231, 415, 244, 171, 
2000, Massachusetts, 7, 4, 0, 0.63636, 312, 246, 66, 
2001, Massachusetts, 3, 8, 0, 0.27273, 178, 342, -164, 
2002, Massachusetts, 8, 4, 0, 0.66667, 327, 250, 77, 
2003, Massachusetts, 10, 3, 0, 0.76923, 368, 295, 73, 
1920, Texas, 9, 0, 0, 1.00000, 282, 13, 269, 
1921, Texas, 6, 1, 1, 0.81250, 268, 27, 241, 
1922, Texas, 7, 2, 0, 0.77778, 202, 68, 134, 
1936, Colorado School of Mines, 2, 6, 0, 0.25000, 100, 146, -46, 
1902, Boston College (MA), 0, 9, 0, 0.00000, 17, 180, -163, 
1911, Chadron St. (NE), 1, 1, 0, 0.50000, 19, 10, 9, 
1930, Adams St. (CO), 0, 1, 2, 0.33333, 6, 25, -19, 
1931, Adams St. (CO), 2, 1, 1, 0.62500, 39, 13, 26, 
1932, Adams St. (CO), 0, 2, 0, 0.00000, 25, 39, -14, 
1933, Adams St. (CO), 2, 1, 0, 0.66667, 19, 24, -5, 
1934, Adams St. (CO), 2, 4, 0, 0.33333, 31, 58, -27, 
1935, Adams St. (CO), 1, 5, 1, 0.21429, 10, 162, -152, 
1936, Adams St. (CO), 3, 4, 0, 0.42857, 37, 101, -64, 
1937, Adams St. (CO), 2, 2, 1, 0.50000, 39, 69, -30, 
1973, Rensselaer Tech (NY), 1, 9, 0, 0.10000, 89, 266, -177, 
1974, Rensselaer Tech (NY), 4, 6, 0, 0.40000, 108, 182, -74, 
1975, Rensselaer Tech (NY), 3, 5, 0, 0.37500, 104, 171, -67, 
1976, Rensselaer Tech (NY), 5, 4, 0, 0.55556, 125, 126, -1, 
1977, Rensselaer Tech (NY), 4, 5, 0, 0.44444, 129, 184, -55, 
1978, Rensselaer Tech (NY), 1, 8, 0, 0.11111, 60, 243, -183, 
1979, Rensselaer Tech (NY), 3, 4, 1, 0.43750, 124, 118, 6, 
1980, Rensselaer Tech (NY), 6, 2, 1, 0.72222, 183, 132, 51, 
1981, Rensselaer Tech (NY), 3, 6, 0, 0.33333, 161, 170, -9, 
1964, Louisiana-Monroe, 0, 8, 0, 0.00000, 58, 148, -90, 
1965, Louisiana-Monroe, 1, 8, 0, 0.11111, 58, 194, -136, 
1966, Louisiana-Monroe, 7, 3, 0, 0.70000, 181, 101, 80, 
1967, Louisiana-Monroe, 7, 3, 0, 0.70000, 196, 111, 85, 
1968, Louisiana-Monroe, 6, 4, 0, 0.60000, 170, 101, 69, 
1969, Louisiana-Monroe, 1, 9, 0, 0.10000, 132, 216, -84, 
1970, Louisiana-Monroe, 5, 4, 0, 0.55556, 151, 146, 5, 
1971, Louisiana-Monroe, 4, 6, 1, 0.40909, 122, 208, -86, 
1998, Virginia Military Institute, 0, 1, 0, 0.00000, 10, 36, -26, 
1908, Temple (PA), 3, 3, 1, 0.50000, 55, 109, -54, 
1899, Missouri, 9, 2, 0, 0.81818, 242, 56, 186, 
1900, Kirksville Osteopath (MO), 0, 1, 0, 0.00000, 0, 13, -13, 
1929, Stephen F. Austin (TX), 1, 7, 2, 0.20000, 64, 342, -278, 
1930, Stephen F. Austin (TX), 1, 7, 1, 0.16667, 64, 167, -103, 
1931, Stephen F. Austin (TX), 2, 6, 0, 0.25000, 22, 137, -115, 
1932, Stephen F. Austin (TX), 2, 7, 0, 0.22222, 38, 155, -117, 
1933, Stephen F. Austin (TX), 0, 6, 1, 0.07143, 18, 136, -118, 
1934, Stephen F. Austin (TX), 3, 3, 2, 0.50000, 62, 118, -56, 
1935, Stephen F. Austin (TX), 4, 5, 0, 0.44444, 93, 105, -12, 
1936, Stephen F. Austin (TX), 4, 3, 1, 0.56250, 67, 92, -25, 
1926, Amherst (MA), 6, 1, 1, 0.81250, 147, 34, 113, 
1927, Amherst (MA), 5, 2, 0, 0.71429, 114, 40, 74, 
1928, Amherst (MA), 5, 2, 1, 0.68750, 140, 93, 47, 
1929, Amherst (MA), 5, 2, 1, 0.68750, 94, 70, 24, 
1898, West Virginia Wesleyan, 0, 0, 1, 0.50000, 0, 0, 0, 
1967, Eastern New Mexico, 3, 6, 0, 0.33333, 169, 196, -27, 
1968, Eastern New Mexico, 4, 5, 1, 0.45000, 183, 180, 3, 
1969, Eastern New Mexico, 1, 9, 0, 0.10000, 208, 328, -120, 
1920, Wake Forest (NC), 2, 7, 0, 0.22222, 98, 190, -92, 
1921, Wake Forest (NC), 2, 8, 0, 0.20000, 66, 222, -156, 
2000, Albany St. (GA), 4, 6, 0, 0.40000, 159, 181, -22, 
2001, Albany St. (GA), 4, 6, 0, 0.40000, 170, 226, -56, 
2002, Albany St. (GA), 7, 4, 0, 0.63636, 320, 164, 156, 
2003, Albany St. (GA), 10, 2, 0, 0.83333, 434, 155, 279, 
2004, Albany St. (GA), 11, 1, 0, 0.91667, 449, 199, 250, 
2005, Albany St. (GA), 8, 2, 0, 0.80000, 304, 203, 101, 
2006, Albany St. (GA), 7, 4, 0, 0.63636, 174, 130, 44, 
2007, Albany St. (GA), 8, 3, 0, 0.72727, 277, 287, -10, 
2008, Albany St. (GA), 7, 4, 0, 0.63636, 309, 182, 127, 
2009, Albany St. (GA), 8, 3, 0, 0.72727, 320, 163, 157, 
2010, Albany St. (GA), 11, 1, 0, 0.91667, 342, 155, 187, 
2011, Albany St. (GA), 8, 4, 0, 0.66667, 378, 329, 49, 
2012, Albany St. (GA), 6, 4, 0, 0.60000, 200, 204, -4, 
2013, Albany St. (GA), 6, 4, 0, 0.60000, 255, 174, 81, 
1972, California, 3, 8, 0, 0.27273, 228, 314, -86, 
1973, California, 4, 7, 0, 0.36364, 245, 380, -135, 
1974, California, 7, 3, 1, 0.68182, 276, 213, 63, 
1975, California, 8, 3, 0, 0.72727, 330, 233, 97, 
1976, California, 5, 6, 0, 0.45455, 230, 226, 4, 
1977, California, 8, 3, 0, 0.72727, 300, 211, 89, 
1980, Illinois, 3, 7, 1, 0.31818, 241, 326, -85, 
1981, Illinois, 7, 4, 0, 0.63636, 287, 288, -1, 
1982, Illinois, 7, 5, 0, 0.58333, 338, 229, 109, 
1983, Illinois, 10, 2, 0, 0.83333, 347, 213, 134, 
1984, Illinois, 7, 4, 0, 0.63636, 323, 209, 114, 
1985, Illinois, 6, 5, 1, 0.54167, 304, 334, -30, 
1986, Illinois, 4, 7, 0, 0.36364, 189, 299, -110, 
1987, Illinois, 3, 7, 1, 0.31818, 153, 208, -55, 
1944, Central Missouri St., 4, 4, 0, 0.50000, 103, 99, 4, 
1945, Central Missouri St., 1, 6, 0, 0.14286, 12, 120, -108, 
1946, Kentucky St., 5, 4, 0, 0.55556, 111, 77, 34, 
1950, Delaware St., 2, 7, 1, 0.25000, 139, 163, -24, 
1951, Delaware St., 2, 7, 0, 0.22222, 41, 158, -117, 
1953, Elizabeth City St. (NC), 5, 1, 2, 0.75000, 148, 43, 105, 
1954, Elizabeth City St. (NC), 8, 1, 0, 0.88889, 284, 65, 219, 
1955, Elizabeth City St. (NC), 7, 2, 0, 0.77778, 145, 84, 61, 
1956, Elizabeth City St. (NC), 3, 6, 0, 0.33333, 51, 100, -49, 
1957, Howard (DC), 3, 6, 0, 0.33333, 59, 136, -77, 
1958, Howard (DC), 6, 2, 1, 0.72222, 168, 100, 68, 
1959, Howard (DC), 3, 5, 0, 0.37500, 62, 116, -54, 
1960, Howard (DC), 4, 4, 0, 0.50000, 133, 181, -48, 
1961, Howard (DC), 1, 8, 0, 0.11111, 58, 191, -133, 
1908, Montana, 1, 2, 1, 0.37500, 12, 15, -3, 
1909, Montana, 6, 0, 1, 0.92857, 169, 5, 164, 
2003, Saint Mary's (CA), 1, 11, 0, 0.08333, 162, 471, -309, 
1940, Samford (AL), 4, 5, 0, 0.44444, 127, 187, -60, 
1941, Samford (AL), 4, 5, 1, 0.45000, 110, 188, -78, 
1946, Sewanee (TN), 4, 3, 0, 0.57143, 134, 52, 82, 
1947, Sewanee (TN), 6, 1, 1, 0.81250, 134, 60, 74, 
1948, Sewanee (TN), 6, 1, 1, 0.81250, 153, 92, 61, 
1949, Sewanee (TN), 4, 2, 1, 0.64286, 94, 53, 41, 
1950, Sewanee (TN), 3, 6, 0, 0.33333, 101, 132, -31, 
1951, Sewanee (TN), 5, 3, 0, 0.62500, 171, 93, 78, 
1952, Sewanee (TN), 7, 2, 0, 0.77778, 192, 90, 102, 
1953, Sewanee (TN), 3, 5, 0, 0.37500, 139, 170, -31, 
1954, Samford (AL), 2, 7, 0, 0.22222, 100, 190, -90, 
1976, Lehigh (PA), 6, 5, 0, 0.54545, 235, 159, 76, 
1977, Lehigh (PA), 12, 2, 0, 0.85714, 466, 191, 275, 
1978, Lehigh (PA), 8, 3, 0, 0.72727, 230, 167, 63, 
1979, Lehigh (PA), 10, 3, 0, 0.76923, 232, 118, 114, 
1980, Lehigh (PA), 9, 1, 2, 0.83333, 350, 153, 197, 
1981, Lehigh (PA), 8, 3, 0, 0.72727, 306, 132, 174, 
1982, Lehigh (PA), 4, 6, 0, 0.40000, 160, 175, -15, 
1983, Lehigh (PA), 8, 3, 0, 0.72727, 244, 229, 15, 
1984, Lehigh (PA), 5, 6, 0, 0.45455, 215, 237, -22, 
1985, Lehigh (PA), 5, 6, 0, 0.45455, 281, 274, 7, 
1907, North Carolina St., 6, 0, 1, 0.92857, 81, 13, 68, 
1908, North Carolina St., 6, 1, 0, 0.85714, 157, 11, 146, 
1930, Northern Iowa, 2, 5, 1, 0.31250, 21, 76, -55, 
1931, Northern Iowa, 3, 5, 0, 0.37500, 52, 85, -33, 
1932, Northern Iowa, 5, 3, 1, 0.61111, 73, 65, 8, 
1901, Indiana St., 2, 4, 1, 0.35714, 39, 53, -14, 
1942, Louisiana-Lafayette, 3, 4, 0, 0.42857, 115, 98, 17, 
1943, Louisiana-Lafayette, 5, 0, 1, 0.91667, 172, 40, 132, 
1944, Louisiana-Lafayette, 5, 4, 0, 0.55556, 124, 70, 54, 
1945, Louisiana-Lafayette, 1, 6, 1, 0.18750, 32, 183, -151, 
1903, Sewanee (TN), 7, 1, 0, 0.87500, 179, 10, 169, 
1904, Sewanee (TN), 7, 1, 0, 0.87500, 180, 37, 143, 
1905, North Carolina St., 4, 1, 1, 0.75000, 65, 10, 55, 
1906, Georgia, 2, 4, 1, 0.35714, 59, 50, 9, 
1907, Georgia, 4, 3, 1, 0.56250, 103, 47, 56, 
1941, Bowling Green (OH), 7, 1, 1, 0.83333, 173, 40, 133, 
1942, Bowling Green (OH), 6, 2, 1, 0.72222, 135, 55, 80, 
1943, Bowling Green (OH), 5, 3, 1, 0.61111, 194, 104, 90, 
1944, Bowling Green (OH), 5, 3, 0, 0.62500, 133, 117, 16, 
1945, Bowling Green (OH), 4, 3, 0, 0.57143, 79, 81, -2, 
1946, Bowling Green (OH), 5, 3, 0, 0.62500, 95, 39, 56, 
1947, Bowling Green (OH), 5, 5, 0, 0.50000, 134, 149, -15, 
1948, Bowling Green (OH), 8, 0, 1, 0.94444, 230, 100, 130, 
1949, Bowling Green (OH), 4, 5, 0, 0.44444, 206, 161, 45, 
1950, Bowling Green (OH), 3, 4, 2, 0.44444, 134, 188, -54, 
1951, Bowling Green (OH), 4, 4, 1, 0.50000, 150, 178, -28, 
1952, Bowling Green (OH), 7, 2, 0, 0.77778, 257, 155, 102, 
1953, Bowling Green (OH), 1, 8, 0, 0.11111, 119, 252, -133, 
1954, Bowling Green (OH), 2, 7, 0, 0.22222, 125, 196, -71, 
1902, South Dakota, 10, 0, 0, 1.00000, 238, 0, 238, 
1903, South Dakota, 2, 5, 0, 0.28571, 28, 84, -56, 
1904, South Dakota, 4, 2, 2, 0.62500, 103, 106, -3, 
1905, South Dakota, 4, 1, 1, 0.75000, 90, 47, 43, 
1906, South Dakota, 3, 2, 0, 0.60000, 68, 34, 34, 
1907, South Dakota, 2, 2, 1, 0.50000, 56, 99, -43, 
1908, South Dakota, 5, 1, 0, 0.83333, 58, 30, 28, 
1909, South Dakota, 2, 1, 1, 0.62500, 51, 16, 35, 
1920, South Dakota, 4, 2, 1, 0.64286, 121, 43, 78, 
1921, South Dakota, 2, 5, 0, 0.28571, 35, 115, -80, 
2005, Sam Houston St. (TX), 3, 7, 0, 0.30000, 270, 288, -18, 
2006, Sam Houston St. (TX), 6, 5, 0, 0.54545, 263, 285, -22, 
2007, Sam Houston St. (TX), 7, 4, 0, 0.63636, 293, 263, 30, 
2008, Sam Houston St. (TX), 4, 6, 0, 0.40000, 353, 331, 22, 
2009, Sam Houston St. (TX), 5, 6, 0, 0.45455, 301, 371, -70, 
2005, Utah, 7, 5, 0, 0.58333, 360, 289, 71, 
2006, Utah, 8, 5, 0, 0.61538, 363, 258, 105, 
2007, Utah, 9, 4, 0, 0.69231, 341, 219, 122, 
2008, Utah, 13, 0, 0, 1.00000, 480, 224, 256, 
2009, Utah, 10, 3, 0, 0.76923, 388, 263, 125, 
2010, Utah, 10, 3, 0, 0.76923, 430, 264, 166, 
2011, Utah, 8, 5, 0, 0.61538, 325, 263, 62, 
2012, Utah, 5, 7, 0, 0.41667, 320, 301, 19, 
2013, Utah, 5, 7, 0, 0.41667, 350, 336, 14, 
2003, Prairie View A&M; (TX), 1, 10, 0, 0.09091, 109, 543, -434, 
1969, Holy Cross (MA), 0, 2, 0, 0.00000, 6, 51, -45, 
1970, Holy Cross (MA), 0, 10, 1, 0.04545, 117, 343, -226, 
1950, Oklahoma St., 4, 6, 1, 0.40909, 159, 259, -100, 
1951, Oklahoma St., 3, 7, 0, 0.30000, 168, 251, -83, 
1952, Oklahoma St., 3, 7, 0, 0.30000, 146, 178, -32, 
1953, Oklahoma St., 7, 3, 0, 0.70000, 178, 149, 29, 
1954, Oklahoma St., 5, 4, 1, 0.55000, 161, 119, 42, 
1955, Alabama, 0, 10, 0, 0.00000, 48, 256, -208, 
1956, Alabama, 2, 7, 1, 0.25000, 85, 208, -123, 
1957, Alabama, 2, 7, 1, 0.25000, 69, 173, -104, 
1920, Glenville St. (WV), 0, 5, 0, 0.00000, 0, 115, -115, 
1921, Glenville St. (WV), 0, 2, 0, 0.00000, 7, 77, -70, 
1946, California, 2, 7, 0, 0.22222, 112, 169, -57, 
1935, Idaho St., 7, 0, 1, 0.93750, 202, 26, 176, 
1936, Idaho St., 4, 4, 0, 0.50000, 138, 111, 27, 
1937, Idaho St., 6, 3, 0, 0.66667, 213, 66, 147, 
1938, Idaho St., 4, 3, 0, 0.57143, 131, 40, 91, 
1939, Idaho St., 5, 2, 0, 0.71429, 67, 48, 19, 
1940, Idaho St., 3, 5, 0, 0.37500, 96, 185, -89, 
1944, Ohio St., 9, 0, 0, 1.00000, 287, 79, 208, 
1945, Ohio St., 7, 2, 0, 0.77778, 194, 71, 123, 
1949, Ohio, 4, 4, 1, 0.50000, 114, 120, -6, 
1950, Ohio, 6, 4, 0, 0.60000, 165, 161, 4, 
1951, Ohio, 5, 4, 1, 0.55000, 167, 141, 26, 
1952, Ohio, 6, 2, 1, 0.72222, 180, 160, 20, 
1953, Ohio, 6, 2, 1, 0.72222, 245, 86, 159, 
1954, Ohio, 6, 3, 0, 0.66667, 175, 158, 17, 
1955, Ohio, 5, 4, 0, 0.55556, 160, 134, 26, 
1956, Ohio, 2, 7, 0, 0.22222, 136, 211, -75, 
1957, Ohio, 2, 6, 1, 0.27778, 134, 156, -22, 
1985, Missouri, 1, 10, 0, 0.09091, 206, 342, -136, 
1986, Missouri, 3, 8, 0, 0.27273, 196, 314, -118, 
1987, Missouri, 5, 6, 0, 0.45455, 226, 209, 17, 
1988, Missouri, 3, 7, 1, 0.31818, 234, 330, -96, 
1997, Vanderbilt (TN), 3, 8, 0, 0.27273, 138, 204, -66, 
1998, Vanderbilt (TN), 2, 9, 0, 0.18182, 142, 369, -227, 
1999, Vanderbilt (TN), 5, 6, 0, 0.45455, 252, 256, -4, 
2000, Vanderbilt (TN), 3, 8, 0, 0.27273, 193, 273, -80, 
2001, Vanderbilt (TN), 2, 9, 0, 0.18182, 226, 402, -176, 
1927, Michigan, 6, 2, 0, 0.75000, 137, 39, 98, 
1928, Michigan, 3, 4, 1, 0.43750, 36, 62, -26, 
1938, Princeton (NJ), 3, 4, 1, 0.43750, 117, 107, 10, 
1939, Princeton (NJ), 7, 1, 0, 0.87500, 132, 65, 67, 
1940, Princeton (NJ), 5, 2, 1, 0.68750, 119, 112, 7, 
1941, Princeton (NJ), 2, 6, 0, 0.25000, 64, 152, -88, 
1942, Princeton (NJ), 3, 5, 1, 0.38889, 109, 135, -26, 
2001, Emporia St. (KS), 5, 6, 0, 0.45455, 263, 286, -23, 
2002, Emporia St. (KS), 9, 3, 0, 0.75000, 304, 222, 82, 
2003, Emporia St. (KS), 9, 3, 0, 0.75000, 327, 217, 110, 
2004, Emporia St. (KS), 5, 6, 0, 0.45455, 297, 372, -75, 
2005, Emporia St. (KS), 4, 6, 0, 0.40000, 240, 264, -24, 
2006, Emporia St. (KS), 3, 8, 0, 0.27273, 329, 333, -4, 
1928, Dickinson St. (ND), 2, 4, 0, 0.33333, 62, 97, -35, 
1929, Dickinson St. (ND), 0, 6, 0, 0.00000, 18, 165, -147, 
1930, Dickinson St. (ND), 3, 3, 0, 0.50000, 84, 119, -35, 
1931, Dickinson St. (ND), 1, 4, 2, 0.28571, 24, 128, -104, 
1932, Dickinson St. (ND), 2, 2, 2, 0.50000, 50, 39, 11, 
1933, Dickinson St. (ND), 5, 1, 0, 0.83333, 127, 19, 108, 
1934, Dickinson St. (ND), 3, 3, 1, 0.50000, 47, 95, -48, 
1935, Dickinson St. (ND), 4, 1, 1, 0.75000, 71, 25, 46, 
1936, Dickinson St. (ND), 2, 3, 1, 0.41667, 20, 51, -31, 
1937, Dickinson St. (ND), 2, 5, 0, 0.28571, 22, 82, -60, 
1938, Dickinson St. (ND), 1, 3, 2, 0.33333, 19, 61, -42, 
1939, Dickinson St. (ND), 1, 4, 1, 0.25000, 25, 66, -41, 
1940, Dickinson St. (ND), 3, 3, 1, 0.50000, 59, 52, 7, 
1941, Dickinson St. (ND), 2, 3, 0, 0.40000, 67, 66, 1, 
1943, Dickinson St. (ND), 1, 2, 0, 0.33333, 26, 41, -15, 
1946, Dickinson St. (ND), 2, 4, 0, 0.33333, 45, 69, -24, 
1947, Dickinson St. (ND), 0, 5, 2, 0.14286, 62, 140, -78, 
1948, Dickinson St. (ND), 3, 5, 0, 0.37500, 118, 114, 4, 
1949, Dickinson St. (ND), 5, 3, 0, 0.62500, 168, 100, 68, 
1951, Dickinson St. (ND), 4, 3, 0, 0.57143, 68, 50, 18, 
1952, Dickinson St. (ND), 5, 3, 0, 0.62500, 142, 94, 48, 
2013, Minnesota-Duluth, 11, 2, 0, 0.84615, 540, 223, 317, 
1980, Stanford (CA), 6, 5, 0, 0.54545, 312, 275, 37, 
1981, Stanford (CA), 4, 7, 0, 0.36364, 314, 281, 33, 
1982, Stanford (CA), 5, 6, 0, 0.45455, 328, 297, 31, 
1983, Stanford (CA), 1, 10, 0, 0.09091, 159, 293, -134, 
1944, Fresno St. (CA), 0, 6, 0, 0.00000, 18, 95, -77, 
1974, Carson-Newman (TN), 4, 6, 0, 0.40000, 157, 233, -76, 
1975, Carson-Newman (TN), 6, 5, 0, 0.54545, 208, 184, 24, 
1976, Carson-Newman (TN), 3, 7, 0, 0.30000, 221, 268, -47, 
1977, Carson-Newman (TN), 3, 7, 0, 0.30000, 238, 278, -40, 
1931, Louisiana-Lafayette, 1, 6, 1, 0.18750, 22, 210, -188, 
1932, Louisiana-Lafayette, 3, 4, 0, 0.42857, 46, 53, -7, 
1933, Louisiana-Lafayette, 6, 3, 0, 0.66667, 128, 35, 93, 
1934, Louisiana-Lafayette, 5, 4, 0, 0.55556, 121, 70, 51, 
1935, Louisiana-Lafayette, 2, 8, 0, 0.20000, 48, 172, -124, 
1936, Louisiana-Lafayette, 2, 7, 1, 0.25000, 54, 225, -171, 
1913, Ohio St., 4, 2, 1, 0.64286, 154, 27, 127, 
1914, Ohio St., 5, 2, 0, 0.71429, 108, 55, 53, 
1915, Ohio St., 5, 1, 1, 0.78571, 105, 39, 66, 
1916, Ohio St., 7, 0, 0, 1.00000, 258, 29, 229, 
1917, Ohio St., 8, 0, 1, 0.94444, 292, 6, 286, 
1918, Ohio St., 3, 3, 0, 0.50000, 134, 41, 93, 
1919, Ohio St., 6, 1, 0, 0.85714, 176, 12, 164, 
1920, Ohio St., 7, 1, 0, 0.87500, 150, 48, 102, 
1921, Ohio St., 5, 2, 0, 0.71429, 110, 14, 96, 
1922, Ohio St., 3, 4, 0, 0.42857, 43, 57, -14, 
1923, Ohio St., 3, 4, 1, 0.43750, 124, 99, 25, 
1924, Ohio St., 2, 3, 3, 0.43750, 40, 45, -5, 
1925, Ohio St., 4, 3, 1, 0.56250, 55, 45, 10, 
1926, Ohio St., 7, 1, 0, 0.87500, 196, 43, 153, 
1927, Ohio St., 4, 4, 0, 0.50000, 131, 92, 39, 
1928, Ohio St., 5, 2, 1, 0.68750, 135, 35, 100, 
2013, Benedictine (KS), 10, 2, 0, 0.83333, 461, 299, 162, 
2009, Old Dominion (VA), 9, 2, 0, 0.81818, 385, 253, 132, 
2010, Old Dominion (VA), 8, 3, 0, 0.72727, 369, 239, 130, 
2011, Old Dominion (VA), 10, 3, 0, 0.76923, 477, 361, 116, 
2012, Old Dominion (VA), 11, 2, 0, 0.84615, 587, 396, 191, 
2013, Old Dominion (VA), 8, 4, 0, 0.66667, 508, 408, 100, 
2013, Chicago (IL), 6, 4, 0, 0.60000, 171, 144, 27, 
1968, Tennessee-Chattanooga, 9, 1, 0, 0.90000, 290, 136, 154, 
1969, Tennessee-Chattanooga, 4, 6, 0, 0.40000, 94, 184, -90, 
1970, Tennessee-Chattanooga, 3, 8, 0, 0.27273, 147, 283, -136, 
1971, Tennessee-Chattanooga, 2, 9, 0, 0.18182, 205, 333, -128, 
1972, Tennessee-Chattanooga, 2, 9, 0, 0.18182, 94, 207, -113, 
1945, Brevard College (NC), 0, 9, 0, 0.00000, 8, 238, -230, 
1994, American International (MA), 3, 7, 0, 0.30000, 196, 370, -174, 
1995, American International (MA), 2, 8, 0, 0.20000, 188, 320, -132, 
1996, American International (MA), 6, 4, 0, 0.60000, 214, 217, -3, 
1997, American International (MA), 8, 3, 0, 0.72727, 271, 193, 78, 
1998, American International (MA), 7, 4, 0, 0.63636, 410, 221, 189, 
1999, American International (MA), 10, 2, 0, 0.83333, 501, 245, 256, 
2000, American International (MA), 9, 3, 0, 0.75000, 358, 261, 97, 
2001, American International (MA), 8, 2, 0, 0.80000, 313, 178, 135, 
2002, American International (MA), 5, 6, 0, 0.45455, 244, 262, -18, 
2003, American International (MA), 5, 4, 0, 0.55556, 216, 162, 54, 
2004, American International (MA), 5, 4, 0, 0.55556, 166, 222, -56, 
2005, American International (MA), 5, 4, 0, 0.55556, 181, 202, -21, 
2006, American International (MA), 6, 4, 0, 0.60000, 179, 148, 31, 
2007, American International (MA), 7, 3, 0, 0.70000, 252, 212, 40, 
2008, American International (MA), 9, 2, 0, 0.81818, 346, 188, 158, 
2009, American International (MA), 5, 5, 0, 0.50000, 242, 213, 29, 
2010, American International (MA), 6, 4, 0, 0.60000, 253, 185, 68, 
2011, American International (MA), 6, 4, 0, 0.60000, 307, 266, 41, 
2012, American International (MA), 7, 3, 0, 0.70000, 269, 246, 23, 
2013, American International (MA), 9, 3, 0, 0.75000, 392, 272, 120, 
1947, Oklahoma, 7, 2, 1, 0.75000, 194, 161, 33, 
1948, Oklahoma, 10, 1, 0, 0.90909, 350, 121, 229, 
1949, Oklahoma, 11, 0, 0, 1.00000, 399, 88, 311, 
1950, Oklahoma, 10, 1, 0, 0.90909, 352, 148, 204, 
1951, Oklahoma, 8, 2, 0, 0.80000, 321, 97, 224, 
1952, Oklahoma, 8, 1, 1, 0.85000, 407, 141, 266, 
1953, Oklahoma, 9, 1, 1, 0.86364, 293, 90, 203, 
1954, Oklahoma, 10, 0, 0, 1.00000, 304, 62, 242, 
1955, Oklahoma, 11, 0, 0, 1.00000, 385, 60, 325, 
1956, Oklahoma, 10, 0, 0, 1.00000, 466, 51, 415, 
1957, Oklahoma, 10, 1, 0, 0.90909, 333, 89, 244, 
1958, Oklahoma, 10, 1, 0, 0.90909, 300, 55, 245, 
1959, Oklahoma, 7, 3, 0, 0.70000, 234, 146, 88, 
1960, Oklahoma, 3, 6, 1, 0.35000, 136, 158, -22, 
1961, Oklahoma, 5, 5, 0, 0.50000, 122, 141, -19, 
1962, Oklahoma, 8, 3, 0, 0.72727, 267, 61, 206, 
1963, Oklahoma, 8, 2, 0, 0.80000, 236, 137, 99, 
1999, Savannah St. (GA), 5, 6, 0, 0.45455, 319, 280, 39, 
1922, Iowa St., 2, 6, 0, 0.25000, 51, 124, -73, 
1923, Iowa St., 4, 3, 1, 0.56250, 121, 93, 28, 
1924, Iowa St., 4, 3, 1, 0.56250, 87, 68, 19, 
1925, Iowa St., 4, 3, 1, 0.56250, 107, 93, 14, 
1929, Ohio St., 4, 3, 1, 0.56250, 95, 69, 26, 
1930, Ohio St., 5, 2, 1, 0.68750, 139, 48, 91, 
1931, Ohio St., 6, 3, 0, 0.66667, 194, 74, 120, 
1932, Ohio St., 4, 1, 3, 0.68750, 90, 41, 49, 
1933, Ohio St., 7, 1, 0, 0.87500, 161, 26, 135, 
1975, Northwestern St. (LA), 1, 10, 0, 0.09091, 108, 316, -208, 
1976, Northwestern St. (LA), 5, 5, 0, 0.50000, 190, 181, 9, 
1977, Northwestern St. (LA), 6, 5, 0, 0.54545, 196, 183, 13, 
1978, Northwestern St. (LA), 5, 6, 0, 0.45455, 158, 282, -124, 
1979, Northwestern St. (LA), 3, 6, 0, 0.33333, 143, 253, -110, 
1980, Northwestern St. (LA), 8, 3, 0, 0.72727, 266, 191, 75, 
1981, Northwestern St. (LA), 4, 6, 0, 0.40000, 322, 266, 56, 
1982, Northwestern St. (LA), 6, 5, 0, 0.54545, 259, 212, 47, 
1983, Louisiana Tech, 4, 7, 0, 0.36364, 152, 195, -43, 
1984, Louisiana Tech, 10, 5, 0, 0.66667, 310, 204, 106, 
1985, Louisiana Tech, 8, 3, 0, 0.72727, 259, 176, 83, 
1986, Louisiana Tech, 6, 4, 1, 0.59091, 206, 223, -17, 
1956, Howard Payne (TX), 6, 4, 0, 0.60000, 130, 76, 54, 
1957, Howard Payne (TX), 3, 6, 0, 0.33333, 111, 150, -39, 
1958, Howard Payne (TX), 2, 7, 0, 0.22222, 119, 214, -95, 
1959, Howard Payne (TX), 3, 7, 0, 0.30000, 117, 121, -4, 
1960, Howard Payne (TX), 6, 4, 0, 0.60000, 132, 90, 42, 
1961, Howard Payne (TX), 4, 5, 0, 0.44444, 124, 128, -4, 
1976, San Diego (CA), 1, 7, 1, 0.16667, 101, 250, -149, 
1977, San Diego (CA), 3, 7, 0, 0.30000, 137, 177, -40, 
1978, San Diego (CA), 6, 4, 0, 0.60000, 219, 176, 43, 
1979, San Diego (CA), 5, 6, 0, 0.45455, 193, 241, -48, 
1980, San Diego (CA), 6, 5, 0, 0.54545, 208, 193, 15, 
1981, San Diego (CA), 9, 1, 0, 0.90000, 290, 164, 126, 
1982, San Diego (CA), 4, 6, 0, 0.40000, 211, 158, 53, 
1952, West Alabama, 4, 6, 0, 0.40000, 202, 175, 27, 
1999, Michigan St., 1, 0, 0, 1.00000, 37, 34, 3, 
2000, Michigan St., 5, 6, 0, 0.45455, 197, 233, -36, 
2001, Michigan St., 7, 5, 0, 0.58333, 374, 311, 63, 
2002, Michigan St., 3, 6, 0, 0.33333, 211, 271, -60, 
1914, Hampton (VA), 3, 1, 0, 0.75000, 82, 6, 76, 
1915, Hampton (VA), 4, 0, 0, 1.00000, 208, 0, 208, 
1916, Hampton (VA), 4, 0, 0, 1.00000, 135, 16, 119, 
1917, Hampton (VA), 4, 1, 0, 0.80000, 126, 9, 117, 
1919, Hampton (VA), 3, 3, 1, 0.50000, 100, 49, 51, 
1920, Hampton (VA), 4, 3, 1, 0.56250, 84, 50, 34, 
1908, Kansas Wesleyan, 7, 3, 0, 0.70000, 158, 119, 39, 
1909, Kansas Wesleyan, 3, 2, 0, 0.60000, 26, 52, -26, 
1902, Pennsylvania, 9, 4, 0, 0.69231, 157, 68, 89, 
1903, Pennsylvania, 9, 3, 0, 0.75000, 370, 57, 313, 
1904, Pennsylvania, 12, 0, 0, 1.00000, 222, 4, 218, 
1905, Pennsylvania, 12, 0, 1, 0.96154, 259, 33, 226, 
1906, Pennsylvania, 7, 2, 3, 0.70833, 186, 58, 128, 
1907, Pennsylvania, 11, 1, 0, 0.91667, 256, 40, 216, 
1894, Temple (PA), 4, 1, 0, 0.80000, 70, 32, 38, 
1895, Temple (PA), 1, 4, 1, 0.25000, 30, 89, -59, 
1896, Temple (PA), 3, 2, 0, 0.60000, 50, 32, 18, 
1897, Temple (PA), 3, 3, 0, 0.50000, 100, 85, 15, 
1898, Temple (PA), 2, 5, 0, 0.28571, 32, 133, -101, 
1902, South Carolina, 6, 1, 0, 0.85714, 198, 16, 182, 
1903, South Carolina, 8, 2, 0, 0.80000, 239, 35, 204, 
1904, Davidson (NC), 6, 1, 1, 0.81250, 115, 8, 107, 
1905, Davidson (NC), 3, 3, 0, 0.50000, 93, 28, 65, 
1906, Clemson (SC), 4, 0, 3, 0.78571, 38, 4, 34, 
1907, Virginia Tech, 7, 2, 0, 0.77778, 157, 30, 127, 
1909, Clemson (SC), 6, 3, 0, 0.66667, 93, 43, 50, 
1913, Clemson (SC), 4, 4, 0, 0.50000, 112, 98, 14, 
1914, Clemson (SC), 6, 3, 1, 0.65000, 197, 123, 74, 
1915, Clemson (SC), 2, 4, 2, 0.37500, 113, 48, 65, 
1995, Canisius (NY), 4, 6, 0, 0.40000, 130, 176, -46, 
1996, Canisius (NY), 5, 4, 0, 0.55556, 158, 108, 50, 
1997, Canisius (NY), 3, 7, 0, 0.30000, 131, 205, -74, 
1998, Canisius (NY), 3, 7, 0, 0.30000, 120, 284, -164, 
1999, Canisius (NY), 1, 10, 0, 0.09091, 133, 431, -298, 
1907, Iowa St., 6, 2, 0, 0.75000, 138, 40, 98, 
1908, Iowa St., 6, 3, 0, 0.66667, 186, 50, 136, 
1909, Iowa St., 4, 3, 1, 0.56250, 82, 62, 20, 
1910, Iowa St., 4, 4, 0, 0.50000, 37, 85, -48, 
1911, Iowa St., 6, 1, 1, 0.81250, 88, 20, 68, 
1912, Iowa St., 6, 2, 0, 0.75000, 151, 45, 106, 
1910, Lenoir-Rhyne (NC), 1, 5, 0, 0.16667, 6, 211, -205, 
1911, Lenoir-Rhyne (NC), 3, 3, 0, 0.50000, 77, 114, -37, 
1973, Lenoir-Rhyne (NC), 5, 5, 1, 0.50000, 221, 240, -19, 
2013, Livingstone (NC), 3, 7, 0, 0.30000, 224, 288, -64, 
1997, Morehouse (GA), 3, 8, 0, 0.27273, 154, 234, -80, 
1998, Grambling St. (LA), 5, 6, 0, 0.45455, 287, 318, -31, 
1999, Grambling St. (LA), 7, 4, 0, 0.63636, 315, 265, 50, 
2000, Grambling St. (LA), 10, 2, 0, 0.83333, 300, 207, 93, 
2001, Grambling St. (LA), 11, 0, 0, 1.00000, 413, 214, 199, 
2002, Grambling St. (LA), 11, 2, 0, 0.84615, 506, 355, 151, 
2003, Grambling St. (LA), 9, 3, 0, 0.75000, 439, 258, 181, 
2011, Grambling St. (LA), 8, 4, 0, 0.66667, 290, 250, 40, 
2012, Grambling St. (LA), 1, 10, 0, 0.09091, 200, 356, -156, 
2013, Grambling St. (LA), 0, 2, 0, 0.00000, 19, 71, -52, 
1932, Drake (IA), 2, 6, 1, 0.27778, 57, 196, -139, 
1900, Northern Iowa, 3, 4, 1, 0.43750, 71, 178, -107, 
1901, Emporia St. (KS), 3, 4, 1, 0.43750, 51, 77, -26, 
1916, Kansas Wesleyan, 0, 8, 0, 0.00000, 3, 327, -324, 
1968, Louisiana College, 1, 9, 0, 0.10000, 97, 301, -204, 
1898, Texas A&M;, 4, 2, 0, 0.66667, 117, 60, 57, 
1891, Army (NY), 4, 1, 1, 0.75000, 80, 73, 7, 
1900, Minnesota, 10, 0, 2, 0.91667, 299, 23, 276, 
1901, Minnesota, 9, 1, 1, 0.86364, 183, 18, 165, 
1902, Minnesota, 9, 2, 1, 0.79167, 335, 34, 301, 
1903, Minnesota, 14, 0, 1, 0.96667, 656, 12, 644, 
1904, Minnesota, 13, 0, 0, 1.00000, 725, 12, 713, 
1905, Minnesota, 11, 1, 0, 0.91667, 542, 22, 520, 
1906, Minnesota, 4, 1, 0, 0.80000, 47, 29, 18, 
1907, Minnesota, 2, 2, 1, 0.50000, 55, 52, 3, 
1908, Minnesota, 3, 2, 1, 0.58333, 32, 50, -18, 
1909, Minnesota, 6, 1, 0, 0.85714, 158, 27, 131, 
1910, Minnesota, 6, 1, 0, 0.85714, 179, 6, 173, 
1911, Minnesota, 6, 0, 1, 0.92857, 102, 15, 87, 
1912, Minnesota, 4, 3, 0, 0.57143, 87, 38, 49, 
1913, Minnesota, 5, 2, 0, 0.71429, 116, 32, 84, 
1914, Minnesota, 6, 1, 0, 0.85714, 123, 44, 79, 
1915, Minnesota, 6, 0, 1, 0.92857, 191, 35, 156, 
1916, Minnesota, 6, 1, 0, 0.85714, 348, 28, 320, 
1917, Minnesota, 4, 1, 0, 0.80000, 164, 25, 139, 
1918, Minnesota, 5, 2, 1, 0.68750, 133, 39, 94, 
1919, Minnesota, 4, 2, 1, 0.64286, 130, 45, 85, 
1920, Minnesota, 1, 6, 0, 0.14286, 62, 92, -30, 
1921, Minnesota, 3, 4, 0, 0.42857, 60, 141, -81, 
1895, Drake (IA), 1, 4, 0, 0.20000, 22, 48, -26, 
1931, Virginia-Lynchburg, 0, 5, 1, 0.08333, 19, 102, -83, 
1892, Nebraska, 1, 0, 0, 1.00000, 6, 0, 6, 
1928, Kentucky St., 0, 3, 0, 0.00000, 0, 99, -99, 
1929, Kentucky St., 4, 4, 0, 0.50000, 113, 80, 33, 
1930, Kentucky St., 5, 2, 3, 0.65000, 69, 77, -8, 
1972, Florida A&M;, 5, 6, 0, 0.45455, 233, 226, 7, 
1973, Florida A&M;, 5, 6, 0, 0.45455, 194, 194, 0, 
1947, Elizabeth City St. (NC), 5, 2, 0, 0.71429, 93, 76, 17, 
1948, Elizabeth City St. (NC), 5, 1, 1, 0.78571, 151, 28, 123, 
1949, Elizabeth City St. (NC), 3, 3, 1, 0.50000, 170, 74, 96, 
1950, Elizabeth City St. (NC), 4, 2, 2, 0.62500, 78, 52, 26, 
1951, Elizabeth City St. (NC), 3, 4, 0, 0.42857, 80, 89, -9, 
1952, Elizabeth City St. (NC), 6, 2, 0, 0.75000, 130, 38, 92, 
1955, Montana, 3, 7, 0, 0.30000, 109, 281, -172, 
1956, Montana, 1, 9, 0, 0.10000, 125, 272, -147, 
1957, Montana, 2, 7, 0, 0.22222, 122, 201, -79, 
1972, Maranatha Baptist Bible (WI), 2, 5, 1, 0.31250, 81, 263, -182, 
1973, Maranatha Baptist Bible (WI), 2, 5, 1, 0.31250, 93, 200, -107, 
1913, Southern Mississippi, 1, 5, 1, 0.21429, 24, 82, -58, 
1997, Jacksonville St. (AL), 1, 10, 0, 0.09091, 199, 356, -157, 
1998, Jacksonville St. (AL), 7, 4, 0, 0.63636, 246, 267, -21, 
1999, Jacksonville St. (AL), 1, 3, 0, 0.25000, 148, 129, 19, 
1924, Ball St. (IN), 1, 3, 0, 0.25000, 11, 87, -76, 
1925, Ball St. (IN), 2, 5, 0, 0.28571, 58, 132, -74, 
2011, Concordia-Saint Paul (MN), 6, 5, 0, 0.54545, 306, 382, -76, 
2012, Concordia-Saint Paul (MN), 2, 9, 0, 0.18182, 282, 384, -102, 
2013, Concordia-Saint Paul (MN), 5, 6, 0, 0.45455, 205, 300, -95, 
1890, Illinois, 1, 2, 0, 0.33333, 12, 84, -72, 
1919, Tennessee-Chattanooga, 3, 5, 1, 0.38889, 36, 185, -149, 
1920, Tennessee-Chattanooga, 3, 4, 1, 0.43750, 145, 142, 3, 
1921, Tennessee-Chattanooga, 4, 6, 0, 0.40000, 137, 144, -7, 
2009, Yale (CT), 4, 6, 0, 0.40000, 173, 166, 7, 
2010, Yale (CT), 7, 3, 0, 0.70000, 224, 211, 13, 
2011, Yale (CT), 5, 5, 0, 0.50000, 239, 262, -23, 
1994, Morehouse (GA), 3, 7, 0, 0.30000, 190, 228, -38, 
1897, Clemson (SC), 2, 2, 0, 0.50000, 30, 58, -28, 
1947, Florida St., 0, 5, 0, 0.00000, 18, 90, -72, 
1985, Virginia Military Institute, 3, 7, 1, 0.31818, 189, 333, -144, 
1986, Virginia Military Institute, 1, 10, 0, 0.09091, 138, 370, -232, 
1987, Virginia Military Institute, 4, 7, 0, 0.36364, 118, 235, -117, 
1988, Virginia Military Institute, 2, 9, 0, 0.18182, 152, 298, -146, 
1954, Sewanee (TN), 0, 8, 0, 0.00000, 58, 148, -90, 
1955, Sewanee (TN), 1, 8, 0, 0.11111, 52, 214, -162, 
1956, Sewanee (TN), 1, 6, 1, 0.18750, 73, 117, -44, 
1947, Lafayette (PA), 6, 3, 0, 0.66667, 89, 156, -67, 
1948, Lafayette (PA), 7, 2, 0, 0.77778, 277, 171, 106, 
1949, Wisconsin, 5, 3, 1, 0.61111, 207, 129, 78, 
1950, Wisconsin, 6, 3, 0, 0.66667, 137, 97, 40, 
1951, Wisconsin, 7, 1, 1, 0.83333, 196, 53, 143, 
1952, Wisconsin, 6, 3, 1, 0.65000, 228, 150, 78, 
1953, Wisconsin, 6, 2, 1, 0.72222, 179, 110, 69, 
1954, Wisconsin, 7, 2, 0, 0.77778, 200, 98, 102, 
1955, Wisconsin, 4, 5, 0, 0.44444, 172, 166, 6, 
2011, Robert Morris (IL), 4, 6, 0, 0.40000, 205, 193, 12, 
2012, Robert Morris (IL), 8, 3, 0, 0.72727, 399, 159, 240, 
2013, Robert Morris (IL), 7, 4, 0, 0.63636, 312, 242, 70, 
1975, Memphis (TN), 7, 4, 0, 0.63636, 180, 168, 12, 
1976, Memphis (TN), 8, 3, 0, 0.72727, 241, 182, 59, 
1977, Memphis (TN), 6, 5, 0, 0.54545, 228, 194, 34, 
1978, Memphis (TN), 4, 7, 0, 0.36364, 200, 297, -97, 
1979, Memphis (TN), 5, 6, 0, 0.45455, 166, 223, -57, 
1980, Memphis (TN), 2, 9, 0, 0.18182, 115, 255, -140, 
1898, Butler (IN), 1, 1, 1, 0.50000, 11, 10, 1, 
1898, Kansas St., 1, 1, 2, 0.50000, 32, 16, 16, 
1968, Parsons (IA), 5, 4, 0, 0.55556, 213, 161, 52, 
1969, Parsons (IA), 2, 8, 0, 0.20000, 140, 269, -129, 
1984, Kentucky St., 2, 9, 0, 0.18182, 74, 380, -306, 
1995, Stanford (CA), 7, 4, 1, 0.62500, 344, 307, 37, 
1996, Stanford (CA), 7, 5, 0, 0.58333, 247, 229, 18, 
1997, Stanford (CA), 5, 6, 0, 0.45455, 276, 317, -41, 
1998, Stanford (CA), 3, 8, 0, 0.27273, 261, 365, -104, 
1999, Stanford (CA), 8, 4, 0, 0.66667, 418, 364, 54, 
2000, Stanford (CA), 5, 6, 0, 0.45455, 261, 294, -33, 
2001, Stanford (CA), 9, 3, 0, 0.75000, 422, 339, 83, 
2002, Notre Dame (IN), 10, 3, 0, 0.76923, 290, 217, 73, 
2003, Notre Dame (IN), 5, 7, 0, 0.41667, 243, 315, -72, 
2004, Notre Dame (IN), 6, 5, 0, 0.54545, 268, 251, 17, 
2005, Washington, 2, 9, 0, 0.18182, 237, 337, -100, 
2006, Washington, 5, 7, 0, 0.41667, 262, 311, -49, 
2007, Washington, 4, 9, 0, 0.30769, 380, 411, -31, 
2008, Washington, 0, 12, 0, 0.00000, 159, 463, -304, 
1930, Prairie View A&M; (TX), 8, 3, 0, 0.72727, 271, 48, 223, 
1937, Stephen F. Austin (TX), 1, 6, 1, 0.18750, 32, 123, -91, 
1938, Stephen F. Austin (TX), 3, 5, 1, 0.38889, 76, 67, 9, 
1939, Stephen F. Austin (TX), 3, 4, 2, 0.44444, 38, 67, -29, 
1940, Stephen F. Austin (TX), 4, 5, 0, 0.44444, 101, 125, -24, 
2013, Wartburg (IA), 9, 3, 0, 0.75000, 372, 218, 154, 
1945, Kentucky St., 4, 3, 2, 0.55556, 133, 85, 48, 
2000, Pikeville (KY), 7, 1, 0, 0.87500, 283, 64, 219, 
2001, Pikeville (KY), 3, 7, 0, 0.30000, 273, 323, -50, 
2002, Pikeville (KY), 5, 5, 0, 0.50000, 229, 238, -9, 
1922, Arizona St., 0, 3, 1, 0.12500, 31, 74, -43, 
1924, Chadron St. (NE), 8, 1, 0, 0.88889, 205, 18, 187, 
1964, California, 3, 7, 0, 0.30000, 152, 187, -35, 
1965, California, 5, 5, 0, 0.50000, 125, 194, -69, 
1966, California, 3, 7, 0, 0.30000, 131, 197, -66, 
1967, California, 5, 5, 0, 0.50000, 155, 195, -40, 
1968, California, 7, 3, 1, 0.68182, 243, 114, 129, 
1969, California, 5, 5, 0, 0.50000, 180, 182, -2, 
1970, California, 6, 5, 0, 0.54545, 272, 249, 23, 
1971, California, 6, 5, 0, 0.54545, 186, 262, -76, 
1919, West Texas A&M;, 5, 1, 0, 0.83333, 160, 26, 134, 
2013, Savannah St. (GA), 1, 11, 0, 0.08333, 174, 517, -343, 
1976, Delaware Valley (PA), 0, 9, 0, 0.00000, 48, 222, -174, 
1977, Delaware Valley (PA), 2, 7, 0, 0.22222, 116, 240, -124, 
1978, Delaware Valley (PA), 1, 8, 0, 0.11111, 111, 190, -79, 
1979, Delaware Valley (PA), 5, 4, 0, 0.55556, 145, 91, 54, 
1980, Delaware Valley (PA), 7, 3, 0, 0.70000, 196, 69, 127, 
1981, Delaware Valley (PA), 8, 2, 0, 0.80000, 208, 81, 127, 
1982, Delaware Valley (PA), 8, 2, 0, 0.80000, 214, 87, 127, 
1983, Delaware Valley (PA), 6, 4, 0, 0.60000, 212, 152, 60, 
1984, Delaware Valley (PA), 5, 5, 0, 0.50000, 178, 187, -9, 
1985, Delaware Valley (PA), 6, 4, 0, 0.60000, 175, 153, 22, 
1986, Delaware Valley (PA), 3, 6, 1, 0.35000, 104, 157, -53, 
1897, Arkansas, 2, 0, 1, 0.83333, 42, 6, 36, 
1898, Arkansas, 2, 1, 0, 0.66667, 37, 42, -5, 
1990, Duke (NC), 4, 7, 0, 0.36364, 240, 295, -55, 
1991, Duke (NC), 4, 6, 1, 0.40909, 231, 280, -49, 
1992, Duke (NC), 2, 9, 0, 0.18182, 265, 343, -78, 
1993, Duke (NC), 3, 8, 0, 0.27273, 214, 349, -135, 
1969, Wichita St. (KS), 2, 8, 0, 0.20000, 121, 273, -152, 
1970, Wichita St. (KS), 0, 3, 0, 0.00000, 28, 137, -109, 
1910, Eastern Kentucky, 1, 4, 0, 0.20000, 21, 63, -42, 
1911, Eastern Kentucky, 1, 3, 1, 0.30000, 26, 23, 3, 
1912, Memphis (TN), 1, 2, 1, 0.37500, 13, 15, -2, 
1913, Memphis (TN), 1, 3, 0, 0.25000, 26, 107, -81, 
1914, Memphis (TN), 3, 5, 0, 0.37500, 65, 102, -37, 
1915, Memphis (TN), 4, 3, 0, 0.57143, 186, 138, 48, 
2009, Bowie St. (MD), 6, 5, 0, 0.54545, 292, 211, 81, 
2010, Bowie St. (MD), 6, 4, 0, 0.60000, 245, 169, 76, 
2011, Bowie St. (MD), 4, 6, 0, 0.40000, 256, 253, 3, 
2012, Bowie St. (MD), 5, 5, 0, 0.50000, 227, 241, -14, 
2013, Bowie St. (MD), 5, 5, 0, 0.50000, 332, 306, 26, 
1911, Eastern Michigan, 3, 4, 0, 0.42857, 46, 71, -25, 
1902, Wabash (IN), 2, 4, 2, 0.37500, 83, 105, -22, 
1903, Wabash (IN), 9, 3, 0, 0.75000, 274, 74, 200, 
1904, Alma (MI), 6, 3, 0, 0.66667, 143, 84, 59, 
1905, Alma (MI), 5, 4, 0, 0.55556, 161, 76, 85, 
1896, Akron (OH), 0, 1, 0, 0.00000, 0, 36, -36, 
1942, Winston-Salem St. (NC), 5, 3, 0, 0.62500, 137, 104, 33, 
1943, Winston-Salem St. (NC), 4, 4, 1, 0.50000, 100, 96, 4, 
1944, Winston-Salem St. (NC), 2, 1, 1, 0.62500, 18, 76, -58, 
1945, Winston-Salem St. (NC), 0, 7, 1, 0.06250, 31, 219, -188, 
1926, Louisiana Tech, 5, 2, 2, 0.66667, 134, 60, 74, 
1927, Louisiana Tech, 3, 5, 0, 0.37500, 83, 118, -35, 
1932, Buffalo (NY), 1, 5, 1, 0.21429, 19, 208, -189, 
1933, Buffalo (NY), 2, 3, 2, 0.42857, 38, 95, -57, 
1939, Canisius (NY), 4, 1, 1, 0.75000, 66, 21, 45, 
1940, Canisius (NY), 5, 3, 0, 0.62500, 86, 79, 7, 
1941, Canisius (NY), 3, 4, 1, 0.43750, 98, 137, -39, 
1942, Canisius (NY), 4, 3, 1, 0.56250, 117, 66, 51, 
1948, Canisius (NY), 7, 2, 1, 0.75000, 242, 109, 133, 
1949, Canisius (NY), 5, 2, 0, 0.71429, 132, 110, 22, 
1950, Buffalo (NY), 5, 3, 0, 0.62500, 191, 129, 62, 
1951, Buffalo (NY), 4, 4, 0, 0.50000, 144, 189, -45, 
2011, Indiana, 1, 11, 0, 0.08333, 257, 448, -191, 
2012, Indiana, 4, 8, 0, 0.33333, 369, 423, -54, 
2013, Indiana, 5, 7, 0, 0.41667, 461, 466, -5, 
1898, Utah, 3, 1, 0, 0.75000, 31, 6, 25, 
2006, Columbia (NY), 5, 5, 0, 0.50000, 150, 163, -13, 
2007, Columbia (NY), 1, 9, 0, 0.10000, 184, 320, -136, 
2008, Columbia (NY), 2, 8, 0, 0.20000, 171, 245, -74, 
2009, Columbia (NY), 4, 6, 0, 0.40000, 225, 220, 5, 
2010, Columbia (NY), 4, 6, 0, 0.40000, 222, 228, -6, 
2011, Columbia (NY), 1, 9, 0, 0.10000, 211, 328, -117, 
1935, Lane (TN), 4, 4, 1, 0.50000, 90, 127, -37, 
1936, Lane (TN), 6, 1, 2, 0.77778, 125, 63, 62, 
1937, Lane (TN), 5, 2, 1, 0.68750, 172, 51, 121, 
1958, Parsons (IA), 4, 6, 0, 0.40000, 167, 192, -25, 
1903, New York (NY), 2, 5, 0, 0.28571, 97, 54, 43, 
1921, Memphis (TN), 4, 5, 1, 0.45000, 86, 205, -119, 
1917, Saint Mary's (CA), 8, 1, 1, 0.85000, 199, 46, 153, 
1918, Saint Mary's (CA), 0, 7, 0, 0.00000, 41, 177, -136, 
1919, Saint Mary's (CA), 3, 3, 1, 0.50000, 109, 80, 29, 
1967, Elon (NC), 5, 3, 1, 0.61111, 210, 180, 30, 
1968, Elon (NC), 4, 5, 0, 0.44444, 236, 248, -12, 
1969, Elon (NC), 7, 3, 0, 0.70000, 307, 154, 153, 
1970, Elon (NC), 3, 7, 0, 0.30000, 81, 173, -92, 
1971, Elon (NC), 8, 3, 0, 0.72727, 241, 166, 75, 
1972, Elon (NC), 7, 3, 1, 0.68182, 261, 131, 130, 
1973, Elon (NC), 12, 1, 0, 0.92308, 400, 155, 245, 
1974, Elon (NC), 10, 2, 0, 0.83333, 295, 98, 197, 
1975, Elon (NC), 5, 6, 0, 0.45455, 211, 145, 66, 
1976, Elon (NC), 11, 1, 0, 0.91667, 363, 103, 260, 
1979, Duke (NC), 2, 8, 1, 0.22727, 152, 264, -112, 
1980, Duke (NC), 2, 9, 0, 0.18182, 214, 296, -82, 
1981, Duke (NC), 6, 5, 0, 0.54545, 210, 230, -20, 
1982, Duke (NC), 6, 5, 0, 0.54545, 307, 290, 17, 
1989, Howard (DC), 8, 3, 0, 0.72727, 205, 116, 89, 
1990, Howard (DC), 6, 5, 0, 0.54545, 261, 205, 56, 
1991, Howard (DC), 2, 9, 0, 0.18182, 208, 319, -111, 
1992, Howard (DC), 7, 4, 0, 0.63636, 366, 178, 188, 
1993, Howard (DC), 11, 1, 0, 0.91667, 438, 270, 168, 
1994, Howard (DC), 4, 7, 0, 0.36364, 224, 280, -56, 
1995, Howard (DC), 6, 5, 0, 0.54545, 246, 225, 21, 
1996, Howard (DC), 10, 2, 0, 0.83333, 441, 178, 263, 
1997, Howard (DC), 7, 4, 0, 0.63636, 308, 248, 60, 
1998, Howard (DC), 7, 4, 0, 0.63636, 373, 304, 69, 
1999, Howard (DC), 5, 6, 0, 0.45455, 323, 395, -72, 
2000, Howard (DC), 3, 8, 0, 0.27273, 190, 355, -165, 
2001, Howard (DC), 2, 9, 0, 0.18182, 232, 374, -142, 
2004, Texas Southern, 0, 11, 0, 0.00000, 82, 355, -273, 
2005, Texas Southern, 1, 10, 0, 0.09091, 222, 385, -163, 
2006, Texas Southern, 3, 8, 0, 0.27273, 203, 328, -125, 
2007, Texas Southern, 0, 11, 0, 0.00000, 154, 434, -280, 
1938, Sam Houston St. (TX), 8, 2, 0, 0.80000, 144, 74, 70, 
1939, Sam Houston St. (TX), 6, 2, 2, 0.70000, 122, 64, 58, 
1940, Sam Houston St. (TX), 8, 2, 0, 0.80000, 192, 88, 104, 
1941, Sam Houston St. (TX), 2, 7, 1, 0.25000, 98, 248, -150, 
1942, Sam Houston St. (TX), 5, 3, 0, 0.62500, 104, 144, -40, 
1946, Sam Houston St. (TX), 6, 2, 1, 0.72222, 130, 53, 77, 
1947, Sam Houston St. (TX), 3, 6, 0, 0.33333, 74, 130, -56, 
1948, Sam Houston St. (TX), 0, 9, 1, 0.05000, 78, 252, -174, 
1949, Sam Houston St. (TX), 3, 7, 0, 0.30000, 215, 199, 16, 
1950, Sam Houston St. (TX), 5, 5, 0, 0.50000, 180, 116, 64, 
1951, Sam Houston St. (TX), 4, 4, 1, 0.50000, 176, 220, -44, 
1978, Texas A&M;, 4, 2, 0, 0.66667, 115, 105, 10, 
1979, Texas A&M;, 6, 5, 0, 0.54545, 243, 159, 84, 
1980, Texas A&M;, 4, 7, 0, 0.36364, 160, 259, -99, 
1981, Texas A&M;, 7, 5, 0, 0.58333, 280, 203, 77, 
1909, Central Arkansas, 1, 4, 1, 0.25000, 15, 64, -49, 
1910, Central Arkansas, 1, 3, 0, 0.25000, 82, 116, -34, 
1932, Miami (OH), 7, 1, 0, 0.87500, 182, 56, 126, 
1933, Miami (OH), 7, 2, 0, 0.77778, 223, 36, 187, 
1934, Miami (OH), 5, 4, 0, 0.55556, 118, 70, 48, 
1935, Miami (OH), 5, 3, 1, 0.61111, 174, 80, 94, 
1936, Miami (OH), 7, 1, 1, 0.83333, 84, 40, 44, 
1937, Miami (OH), 4, 4, 1, 0.50000, 175, 85, 90, 
1938, Miami (OH), 6, 3, 0, 0.66667, 228, 100, 128, 
1939, Miami (OH), 1, 7, 1, 0.16667, 21, 104, -83, 
1940, Miami (OH), 0, 7, 1, 0.06250, 32, 200, -168, 
1941, Miami (OH), 2, 7, 0, 0.22222, 98, 176, -78, 
1958, Indianapolis (IN), 3, 6, 0, 0.33333, 81, 232, -151, 
1959, Indianapolis (IN), 3, 5, 1, 0.38889, 149, 222, -73, 
1960, Indianapolis (IN), 6, 3, 0, 0.66667, 187, 146, 41, 
1961, Indianapolis (IN), 5, 4, 0, 0.55556, 104, 128, -24, 
1920, East Tennessee St., 3, 2, 0, 0.60000, 18, 85, -67, 
1921, East Tennessee St., 4, 5, 0, 0.44444, 95, 202, -107, 
1996, Sewanee (TN), 4, 4, 0, 0.50000, 154, 153, 1, 
1997, Sewanee (TN), 5, 4, 0, 0.55556, 248, 212, 36, 
1998, Sewanee (TN), 2, 7, 0, 0.22222, 165, 230, -65, 
1999, Sewanee (TN), 6, 4, 0, 0.60000, 245, 192, 53, 
2000, Sewanee (TN), 6, 4, 0, 0.60000, 259, 180, 79, 
2001, Sewanee (TN), 5, 5, 0, 0.50000, 184, 185, -1, 
2002, Sewanee (TN), 5, 5, 0, 0.50000, 219, 294, -75, 
2003, Sewanee (TN), 3, 7, 0, 0.30000, 190, 244, -54, 
2004, Sewanee (TN), 2, 8, 0, 0.20000, 120, 234, -114, 
2005, Sewanee (TN), 5, 5, 0, 0.50000, 151, 223, -72, 
2006, Sewanee (TN), 2, 8, 0, 0.20000, 165, 267, -102, 
1904, Butler (IN), 8, 1, 0, 0.88889, 223, 70, 153, 
1905, Butler (IN), 7, 3, 0, 0.70000, 300, 66, 234, 
1906, Pittsburgh (PA), 6, 4, 0, 0.60000, 229, 55, 174, 
1907, Louisiana St., 7, 3, 0, 0.70000, 266, 52, 214, 
1908, Louisiana St., 10, 0, 0, 1.00000, 442, 11, 431, 
1910, Maine, 5, 1, 2, 0.75000, 71, 18, 53, 
1911, Maine, 6, 2, 0, 0.75000, 89, 8, 81, 
1916, Susquehanna (PA), 4, 5, 0, 0.44444, 131, 172, -41, 
1917, Susquehanna (PA), 1, 0, 0, 1.00000, 1, 0, 1, 
1918, Bucknell (PA), 6, 0, 0, 1.00000, 236, 7, 229, 
1919, Susquehanna (PA), 5, 4, 1, 0.55000, 311, 76, 235, 
1924, Susquehanna (PA), 3, 5, 0, 0.37500, 81, 202, -121, 
1925, Susquehanna (PA), 1, 6, 2, 0.22222, 37, 207, -170, 
1913, Denver (CO), 2, 5, 0, 0.28571, 47, 140, -93, 
1899, Franklin & Marshall (PA), 3, 5, 1, 0.38889, 158, 146, 12, 
1901, Temple (PA), 3, 2, 0, 0.60000, 37, 65, -28, 
1902, Temple (PA), 1, 4, 1, 0.25000, 29, 62, -33, 
1903, Temple (PA), 4, 1, 0, 0.80000, 56, 18, 38, 
1904, Temple (PA), 3, 2, 0, 0.60000, 65, 23, 42, 
1905, Temple (PA), 2, 0, 1, 0.83333, 48, 12, 36, 
1942, Western Kentucky, 3, 4, 1, 0.43750, 70, 167, -97, 
1928, Kentucky Wesleyan, 6, 3, 0, 0.66667, 176, 60, 116, 
1929, Kentucky Wesleyan, 5, 4, 0, 0.55556, 109, 91, 18, 
1930, Kentucky Wesleyan, 2, 4, 3, 0.38889, 108, 137, -29, 
1940, San Jose St. (CA), 11, 1, 0, 0.91667, 263, 62, 201, 
1941, San Jose St. (CA), 5, 3, 3, 0.59091, 149, 96, 53, 
1923, Kentucky, 4, 3, 2, 0.55556, 135, 53, 82, 
1949, Arizona, 2, 7, 1, 0.25000, 118, 298, -180, 
1950, Arizona, 4, 6, 0, 0.40000, 214, 257, -43, 
1951, Arizona, 6, 5, 0, 0.54545, 246, 270, -24, 
2013, Grambling St. (LA), 1, 3, 0, 0.25000, 123, 148, -25, 
1896, Mercer (GA), 0, 2, 1, 0.16667, 8, 56, -48, 
1890, Syracuse (NY), 8, 3, 0, 0.72727, 140, 84, 56, 
1894, Georgia, 5, 1, 0, 0.83333, 156, 20, 136, 
2013, Concordia (NE), 7, 4, 0, 0.63636, 290, 190, 100, 
1893, Minnesota, 7, 0, 0, 1.00000, 158, 38, 120, 
1927, Hamilton (NY), 3, 4, 1, 0.43750, 50, 103, -53, 
1928, Hamilton (NY), 5, 2, 1, 0.68750, 108, 46, 62, 
1929, Hamilton (NY), 4, 3, 1, 0.56250, 95, 93, 2, 
1930, Hamilton (NY), 3, 3, 2, 0.50000, 32, 45, -13, 
1931, Hamilton (NY), 3, 4, 1, 0.43750, 50, 92, -42, 
1932, Hamilton (NY), 2, 3, 2, 0.42857, 27, 57, -30, 
1933, Hamilton (NY), 6, 1, 0, 0.85714, 93, 44, 49, 
1934, Hamilton (NY), 3, 3, 1, 0.50000, 39, 46, -7, 
1935, Hamilton (NY), 4, 3, 0, 0.57143, 80, 54, 26, 
1936, Hamilton (NY), 2, 5, 0, 0.28571, 21, 109, -88, 
1937, Hamilton (NY), 3, 3, 1, 0.50000, 64, 83, -19, 
1938, Hamilton (NY), 0, 6, 1, 0.07143, 38, 122, -84, 
1939, Hamilton (NY), 1, 5, 1, 0.21429, 20, 69, -49, 
1940, Hamilton (NY), 2, 5, 0, 0.28571, 77, 102, -25, 
1910, Central Missouri St., 6, 1, 1, 0.81250, 79, 16, 63, 
1911, Central Missouri St., 2, 2, 1, 0.50000, 44, 27, 17, 
2013, Wayne St. (MI), 3, 8, 0, 0.27273, 246, 341, -95, 
1910, Northern Illinois, 4, 2, 1, 0.64286, 68, 39, 29, 
1911, Northern Illinois, 8, 1, 2, 0.81818, 196, 84, 112, 
1912, Northern Illinois, 3, 5, 0, 0.37500, 214, 167, 47, 
1913, Northern Illinois, 3, 3, 3, 0.50000, 56, 236, -180, 
1914, Northern Illinois, 7, 0, 1, 0.93750, 140, 13, 127, 
1915, Northern Illinois, 2, 5, 1, 0.31250, 81, 210, -129, 
1916, Northern Illinois, 6, 1, 1, 0.81250, 105, 19, 86, 
1947, Ohio, 3, 5, 1, 0.38889, 80, 116, -36, 
1948, Ohio, 3, 6, 0, 0.33333, 98, 179, -81, 
1906, Purdue (IN), 0, 5, 0, 0.00000, 5, 86, -81, 
1920, Colorado, 4, 1, 2, 0.71429, 99, 28, 71, 
1921, Colorado, 4, 1, 1, 0.75000, 65, 63, 2, 
1922, Colorado, 4, 4, 0, 0.50000, 56, 79, -23, 
1923, Colorado, 9, 0, 0, 1.00000, 280, 27, 253, 
1924, Colorado, 8, 1, 1, 0.85000, 237, 13, 224, 
1925, Colorado, 6, 3, 0, 0.66667, 156, 45, 111, 
1926, Colorado, 3, 5, 1, 0.38889, 77, 103, -26, 
1927, Colorado, 4, 5, 0, 0.44444, 136, 195, -59, 
1928, Colorado, 5, 1, 0, 0.83333, 110, 57, 53, 
1929, Colorado, 5, 1, 1, 0.78571, 78, 69, 9, 
1930, Colorado, 6, 1, 1, 0.81250, 120, 68, 52, 
1931, Colorado, 5, 3, 0, 0.62500, 111, 94, 17, 
2011, North Carolina, 7, 6, 0, 0.53846, 364, 323, 41, 
1906, William & Mary (VA), 2, 6, 0, 0.25000, 24, 116, -92, 
1916, Wisconsin, 4, 2, 1, 0.64286, 104, 78, 26, 
1924, Columbia (NY), 1, 2, 1, 0.37500, 60, 37, 23, 
1914, Davis & Elkins (WV), 3, 2, 0, 0.60000, 116, 61, 55, 
1933, Wyoming, 2, 6, 1, 0.27778, 54, 114, -60, 
1934, Wyoming, 3, 5, 0, 0.37500, 78, 109, -31, 
1935, Wyoming, 4, 4, 0, 0.50000, 76, 59, 17, 
1936, Wyoming, 2, 5, 1, 0.31250, 74, 159, -85, 
1937, Wyoming, 3, 5, 0, 0.37500, 86, 92, -6, 
1938, Wyoming, 2, 5, 1, 0.31250, 66, 147, -81, 
1931, Princeton (NJ), 1, 7, 0, 0.12500, 55, 164, -109, 
1953, Tulsa (OK), 3, 7, 0, 0.30000, 117, 258, -141, 
1954, Tulsa (OK), 0, 11, 0, 0.00000, 118, 338, -220, 
2009, Bacone (OK), 1, 8, 0, 0.11111, 183, 436, -253, 
2010, Bacone (OK), 3, 8, 0, 0.27273, 270, 293, -23, 
1936, North Carolina, 8, 2, 0, 0.80000, 190, 100, 90, 
1937, North Carolina, 7, 1, 1, 0.83333, 173, 39, 134, 
1938, North Carolina, 6, 2, 1, 0.72222, 117, 37, 80, 
1939, North Carolina, 8, 1, 1, 0.85000, 228, 52, 176, 
1940, North Carolina, 6, 4, 0, 0.60000, 159, 98, 61, 
1941, North Carolina, 3, 7, 0, 0.30000, 130, 172, -42, 
1946, Florida, 0, 9, 0, 0.00000, 104, 264, -160, 
1947, Florida, 4, 5, 1, 0.45000, 125, 156, -31, 
1948, Florida, 5, 5, 0, 0.50000, 213, 206, 7, 
1949, Florida, 4, 5, 1, 0.45000, 180, 218, -38, 
1952, Tulane (LA), 5, 5, 0, 0.50000, 188, 146, 42, 
1953, Tulane (LA), 1, 8, 1, 0.15000, 129, 228, -99, 
1897, Duquesne (PA), 2, 3, 1, 0.41667, 57, 86, -29, 
1984, Allegheny (PA), 3, 7, 0, 0.30000, 132, 239, -107, 
1985, Allegheny (PA), 3, 7, 0, 0.30000, 129, 165, -36, 
1990, Tiffin (OH), 1, 8, 1, 0.15000, 76, 216, -140, 
1991, Tiffin (OH), 4, 5, 0, 0.44444, 201, 172, 29, 
1992, Tiffin (OH), 4, 6, 0, 0.40000, 181, 262, -81, 
1993, Tiffin (OH), 8, 2, 1, 0.77273, 304, 219, 85, 
1994, Tiffin (OH), 8, 4, 0, 0.66667, 320, 284, 36, 
1995, Tiffin (OH), 4, 6, 1, 0.40909, 205, 240, -35, 
1996, Tiffin (OH), 2, 8, 0, 0.20000, 190, 334, -144, 
1997, Tiffin (OH), 4, 7, 0, 0.36364, 196, 334, -138, 
1897, Northern Iowa, 7, 1, 0, 0.87500, 124, 52, 72, 
1923, Lock Haven (PA), 1, 2, 1, 0.37500, 22, 30, -8, 
1934, Lock Haven (PA), 5, 4, 0, 0.55556, 86, 49, 37, 
2010, Youngstown St. (OH), 3, 8, 0, 0.27273, 344, 347, -3, 
2011, Youngstown St. (OH), 6, 5, 0, 0.54545, 398, 283, 115, 
2012, Youngstown St. (OH), 7, 4, 0, 0.63636, 318, 261, 57, 
2013, Youngstown St. (OH), 8, 4, 0, 0.66667, 405, 314, 91, 
1943, Lafayette (PA), 4, 1, 0, 0.80000, 118, 22, 96, 
1944, Lafayette (PA), 6, 1, 0, 0.85714, 246, 59, 187, 
1945, Lafayette (PA), 1, 7, 1, 0.16667, 58, 210, -152, 
1940, Monmouth (IL), 0, 7, 2, 0.11111, 40, 130, -90, 
1995, James Madison (VA), 8, 4, 0, 0.66667, 361, 290, 71, 
1996, James Madison (VA), 7, 4, 0, 0.63636, 259, 215, 44, 
1997, James Madison (VA), 5, 6, 0, 0.45455, 252, 337, -85, 
1998, James Madison (VA), 3, 8, 0, 0.27273, 233, 287, -54, 
1916, Doane (NE), 2, 6, 0, 0.25000, 74, 103, -29, 
1919, Alma (MI), 3, 5, 0, 0.37500, 112, 175, -63, 
1897, Tuskegee (AL), 0, 1, 0, 0.00000, 0, 10, -10, 
1899, Tuskegee (AL), 0, 1, 0, 0.00000, 0, 16, -16, 
1900, Tuskegee (AL), 0, 1, 0, 0.00000, 12, 17, -5, 
1901, Tuskegee (AL), 1, 0, 0, 1.00000, 37, 0, 37, 
1947, American International (MA), 7, 1, 1, 0.83333, 185, 105, 80, 
1913, North Dakota St., 0, 2, 2, 0.25000, 20, 27, -7, 
1914, North Dakota St., 5, 3, 0, 0.62500, 90, 72, 18, 
1968, New Mexico St., 5, 5, 0, 0.50000, 228, 244, -16, 
1969, New Mexico St., 5, 5, 0, 0.50000, 199, 235, -36, 
1970, New Mexico St., 4, 6, 0, 0.40000, 282, 277, 5, 
1971, New Mexico St., 5, 5, 1, 0.50000, 220, 208, 12, 
1972, New Mexico St., 2, 9, 0, 0.18182, 193, 400, -207, 
1914, Virginia, 8, 1, 0, 0.88889, 353, 38, 315, 
1993, Bowie St. (MD), 3, 6, 1, 0.35000, 116, 223, -107, 
1994, Bowie St. (MD), 2, 8, 0, 0.20000, 88, 228, -140, 
1995, Bowie St. (MD), 3, 8, 0, 0.27273, 133, 246, -113, 
1996, Bowie St. (MD), 3, 7, 0, 0.30000, 94, 199, -105, 
1997, Bowie St. (MD), 4, 6, 0, 0.40000, 154, 216, -62, 
1998, Bowie St. (MD), 6, 3, 0, 0.66667, 165, 126, 39, 
1999, Salisbury (MD), 2, 7, 0, 0.22222, 126, 238, -112, 
2000, Salisbury (MD), 5, 5, 0, 0.50000, 250, 182, 68, 
2001, Salisbury (MD), 4, 6, 0, 0.40000, 228, 247, -19, 
2002, Salisbury (MD), 9, 2, 0, 0.81818, 309, 191, 118, 
2003, Salisbury (MD), 7, 2, 0, 0.77778, 285, 116, 169, 
2004, Salisbury (MD), 10, 1, 0, 0.90909, 403, 144, 259, 
2005, Salisbury (MD), 8, 3, 0, 0.72727, 442, 303, 139, 
2006, Salisbury (MD), 7, 4, 0, 0.63636, 252, 169, 83, 
2007, Salisbury (MD), 9, 2, 0, 0.81818, 439, 189, 250, 
2008, Salisbury (MD), 9, 2, 0, 0.81818, 448, 247, 201, 
2009, Salisbury (MD), 5, 6, 0, 0.45455, 294, 281, 13, 
2010, Salisbury (MD), 7, 3, 0, 0.70000, 374, 151, 223, 
2011, Salisbury (MD), 11, 2, 0, 0.84615, 584, 271, 313, 
2012, Salisbury (MD), 9, 3, 0, 0.75000, 374, 174, 200, 
2013, Salisbury (MD), 7, 4, 0, 0.63636, 327, 186, 141, 
1950, Tennessee Tech, 4, 7, 0, 0.36364, 179, 206, -27, 
1951, Tennessee Tech, 5, 5, 1, 0.50000, 205, 249, -44, 
1952, East Tennessee St., 5, 2, 2, 0.66667, 188, 125, 63, 
1953, East Tennessee St., 5, 4, 0, 0.55556, 220, 164, 56, 
1955, East Tennessee St., 6, 3, 1, 0.65000, 145, 111, 34, 
1956, East Tennessee St., 4, 5, 0, 0.44444, 108, 143, -35, 
1957, East Tennessee St., 5, 6, 0, 0.45455, 160, 151, 9, 
1958, East Tennessee St., 5, 4, 0, 0.55556, 133, 120, 13, 
1959, East Tennessee St., 6, 3, 0, 0.66667, 135, 119, 16, 
1960, East Tennessee St., 3, 4, 2, 0.44444, 126, 120, 6, 
1961, East Tennessee St., 3, 7, 0, 0.30000, 136, 214, -78, 
1962, East Tennessee St., 7, 3, 0, 0.70000, 182, 102, 80, 
1963, East Tennessee St., 7, 2, 0, 0.77778, 167, 121, 46, 
1964, East Tennessee St., 5, 5, 0, 0.50000, 135, 139, -4, 
1965, East Tennessee St., 2, 6, 1, 0.27778, 129, 208, -79, 
1938, Army (NY), 8, 2, 0, 0.80000, 243, 95, 148, 
1939, Army (NY), 3, 4, 2, 0.44444, 106, 105, 1, 
1940, Army (NY), 1, 7, 1, 0.16667, 54, 197, -143, 
1933, Florida Southern, 2, 4, 0, 0.33333, 50, 142, -92, 
1953, Southern Methodist (TX), 5, 5, 0, 0.50000, 128, 129, -1, 
1954, Southern Methodist (TX), 6, 3, 1, 0.65000, 184, 135, 49, 
1955, Southern Methodist (TX), 4, 6, 0, 0.40000, 118, 115, 3, 
1956, Southern Methodist (TX), 4, 6, 0, 0.40000, 125, 202, -77, 
1957, Wichita St. (KS), 1, 9, 0, 0.10000, 66, 250, -184, 
1958, Wichita St. (KS), 4, 5, 1, 0.45000, 148, 200, -52, 
1959, Wichita St. (KS), 5, 4, 1, 0.55000, 181, 161, 20, 
2010, Lamar (TX), 5, 6, 0, 0.45455, 195, 287, -92, 
2011, Lamar (TX), 4, 7, 0, 0.36364, 282, 430, -148, 
2012, Lamar (TX), 4, 8, 0, 0.33333, 241, 355, -114, 
2013, Lamar (TX), 5, 7, 0, 0.41667, 401, 356, 45, 
1887, Indiana, 0, 1, 0, 0.00000, 8, 10, -2, 
1888, Indiana, 0, 0, 1, 0.50000, 6, 6, 0, 
1927, Georgia Southern, 6, 1, 1, 0.81250, 90, 42, 48, 
1928, Georgia Southern, 5, 5, 0, 0.50000, 61, 60, 1, 
2008, Grand View College (IA), 2, 8, 0, 0.20000, 256, 332, -76, 
2009, Grand View College (IA), 8, 3, 0, 0.72727, 271, 218, 53, 
2010, Grand View College (IA), 6, 4, 0, 0.60000, 294, 147, 147, 
2011, Grand View College (IA), 8, 4, 0, 0.66667, 303, 194, 109, 
2012, Grand View College (IA), 8, 3, 0, 0.72727, 298, 177, 121, 
2013, Grand View College (IA), 14, 0, 0, 1.00000, 523, 215, 308, 
2013, Fairmont St. (WV), 3, 7, 0, 0.30000, 241, 321, -80, 
1896, Alma (MI), 2, 0, 1, 0.83333, 36, 32, 4, 
1900, Iowa St., 2, 5, 1, 0.31250, 38, 100, -62, 
1900, Montana St., 2, 1, 0, 0.66667, 18, 16, 2, 
1923, Georgia, 5, 3, 1, 0.61111, 74, 120, -46, 
1924, Georgia, 7, 3, 0, 0.70000, 129, 61, 68, 
1925, Georgia, 4, 5, 0, 0.44444, 133, 91, 42, 
1926, Georgia, 5, 4, 0, 0.55556, 135, 115, 20, 
1927, Georgia, 9, 1, 0, 0.90000, 248, 38, 210, 
1947, Baylor (TX), 5, 5, 0, 0.50000, 127, 138, -11, 
1948, Baylor (TX), 6, 3, 2, 0.63636, 167, 125, 42, 
1949, Baylor (TX), 8, 2, 0, 0.80000, 232, 126, 106, 
1950, Florida, 5, 5, 0, 0.50000, 157, 181, -24, 
1951, Florida, 5, 5, 0, 0.50000, 174, 131, 43, 
1952, Florida, 8, 3, 0, 0.72727, 304, 122, 182, 
1953, Florida, 3, 5, 2, 0.40000, 200, 113, 87, 
1954, Florida, 5, 5, 0, 0.50000, 115, 128, -13, 
1955, Florida, 4, 6, 0, 0.40000, 111, 126, -15, 
1956, Florida, 6, 3, 1, 0.65000, 158, 98, 60, 
1957, Florida, 6, 2, 1, 0.72222, 133, 70, 63, 
1958, Florida, 6, 4, 1, 0.59091, 174, 100, 74, 
1959, Florida, 5, 4, 1, 0.55000, 169, 107, 62, 
1892, Pennsylvania, 15, 1, 0, 0.93750, 405, 52, 353, 
1893, Pennsylvania, 12, 3, 0, 0.80000, 484, 62, 422, 
1894, Pennsylvania, 12, 0, 0, 1.00000, 366, 20, 346, 
1895, Pennsylvania, 14, 0, 0, 1.00000, 480, 24, 456, 
1896, Pennsylvania, 14, 1, 0, 0.93333, 326, 24, 302, 
1897, Pennsylvania, 15, 0, 0, 1.00000, 463, 20, 443, 
1898, Pennsylvania, 12, 1, 0, 0.92308, 398, 32, 366, 
1899, Pennsylvania, 8, 3, 2, 0.69231, 268, 81, 187, 
1900, Pennsylvania, 12, 1, 0, 0.92308, 335, 45, 290, 
1901, Pennsylvania, 10, 5, 0, 0.66667, 203, 121, 82, 
1903, Illinois, 8, 6, 0, 0.57143, 352, 117, 235, 
1905, Carlisle Indian School (PA), 7, 2, 0, 0.77778, 229, 34, 195, 
2000, Eastern Michigan, 3, 8, 0, 0.27273, 209, 350, -141, 
2001, Eastern Michigan, 2, 9, 0, 0.18182, 197, 356, -159, 
2002, Eastern Michigan, 3, 9, 0, 0.25000, 286, 566, -280, 
2003, Eastern Michigan, 1, 8, 0, 0.11111, 124, 306, -182, 
1892, Susquehanna (PA), 0, 1, 0, 0.00000, 0, 16, -16, 
1893, Susquehanna (PA), 2, 1, 1, 0.62500, 70, 18, 52, 
1921, Wheaton (IL), 6, 2, 0, 0.75000, 100, 103, -3, 
1897, Kansas, 8, 2, 0, 0.80000, 252, 20, 232, 
1898, Kansas, 10, 1, 0, 0.90909, 174, 29, 145, 
2004, Stonehill (MA), 2, 7, 0, 0.22222, 95, 255, -160, 
2005, Stonehill (MA), 4, 6, 0, 0.40000, 187, 289, -102, 
2006, Stonehill (MA), 1, 9, 0, 0.10000, 84, 186, -102, 
1899, San Jose St. (CA), 6, 3, 1, 0.65000, 120, 69, 51, 
1909, Ohio, 2, 4, 2, 0.37500, 26, 106, -80, 
1910, Ohio, 0, 6, 1, 0.07143, 0, 125, -125, 
1984, Appalachian St. (NC), 4, 7, 0, 0.36364, 151, 218, -67, 
1985, Appalachian St. (NC), 8, 3, 0, 0.72727, 260, 109, 151, 
1986, Appalachian St. (NC), 9, 2, 1, 0.79167, 351, 176, 175, 
1987, Appalachian St. (NC), 11, 3, 0, 0.78571, 270, 153, 117, 
1988, Appalachian St. (NC), 6, 4, 1, 0.59091, 324, 233, 91, 
1989, South Carolina, 6, 4, 1, 0.59091, 228, 250, -22, 
1990, South Carolina, 6, 5, 0, 0.54545, 282, 237, 45, 
1991, South Carolina, 3, 6, 2, 0.36364, 250, 268, -18, 
1992, South Carolina, 5, 6, 0, 0.45455, 160, 240, -80, 
1993, South Carolina, 5, 6, 0, 0.45455, 188, 214, -26, 
2008, Virginia Military Institute, 4, 7, 0, 0.36364, 378, 369, 9, 
2009, Virginia Military Institute, 2, 9, 0, 0.18182, 225, 338, -113, 
2010, Virginia Military Institute, 3, 8, 0, 0.27273, 174, 311, -137, 
2011, Virginia Military Institute, 2, 9, 0, 0.18182, 187, 351, -164, 
2012, Virginia Military Institute, 2, 9, 0, 0.18182, 133, 338, -205, 
2013, Virginia Military Institute, 2, 10, 0, 0.16667, 235, 416, -181, 
1935, Central Arkansas, 4, 3, 0, 0.57143, 106, 84, 22, 
1936, Central Arkansas, 8, 0, 0, 1.00000, 227, 40, 187, 
1937, Central Arkansas, 8, 1, 0, 0.88889, 353, 62, 291, 
1938, Central Arkansas, 7, 1, 0, 0.87500, 166, 47, 119, 
1939, Central Arkansas, 5, 2, 2, 0.66667, 78, 19, 59, 
1940, Central Arkansas, 8, 1, 1, 0.85000, 157, 52, 105, 
1941, Hardin-Simmons (TX), 7, 3, 1, 0.68182, 178, 88, 90, 
1942, Hardin-Simmons (TX), 8, 0, 1, 0.94444, 226, 58, 168, 
1946, Hardin-Simmons (TX), 11, 0, 0, 1.00000, 322, 48, 274, 
1947, Hardin-Simmons (TX), 8, 3, 0, 0.72727, 305, 87, 218, 
1948, Hardin-Simmons (TX), 6, 2, 3, 0.68182, 345, 212, 133, 
1949, Hardin-Simmons (TX), 6, 4, 1, 0.59091, 318, 189, 129, 
1950, Hardin-Simmons (TX), 5, 5, 0, 0.50000, 278, 180, 98, 
1951, Hardin-Simmons (TX), 6, 6, 0, 0.50000, 272, 216, 56, 
1952, Arizona, 6, 4, 0, 0.60000, 285, 155, 130, 
1953, Arizona, 4, 5, 1, 0.45000, 234, 181, 53, 
1954, Arizona, 7, 3, 0, 0.70000, 385, 215, 170, 
1955, Arizona, 5, 4, 1, 0.55000, 184, 169, 15, 
1956, Arizona, 4, 6, 0, 0.40000, 180, 182, -2, 
1958, New Mexico St., 4, 6, 0, 0.40000, 172, 228, -56, 
1959, New Mexico St., 8, 3, 0, 0.72727, 360, 158, 202, 
1960, New Mexico St., 11, 0, 0, 1.00000, 394, 113, 281, 
1961, New Mexico St., 5, 4, 1, 0.55000, 341, 195, 146, 
1962, New Mexico St., 4, 6, 0, 0.40000, 191, 259, -68, 
1963, New Mexico St., 3, 6, 1, 0.35000, 158, 209, -51, 
1964, New Mexico St., 6, 4, 0, 0.60000, 131, 171, -40, 
1965, New Mexico St., 8, 2, 0, 0.80000, 236, 153, 83, 
1966, New Mexico St., 7, 3, 0, 0.70000, 321, 159, 162, 
1967, New Mexico St., 7, 2, 1, 0.75000, 339, 145, 194, 
1927, Eastern Washington, 3, 5, 0, 0.37500, 89, 164, -75, 
1928, Eastern Washington, 4, 3, 0, 0.57143, 59, 63, -4, 
1921, Fort Hays St. (KS), 6, 1, 0, 0.85714, 99, 55, 44, 
1922, Fort Hays St. (KS), 2, 4, 1, 0.35714, 38, 67, -29, 
1920, Fort Hays St. (KS), 2, 5, 1, 0.31250, 108, 108, 0, 
1980, Simon Fraser (BC), 5, 4, 0, 0.55556, 175, 202, -27, 
1981, Simon Fraser (BC), 3, 7, 0, 0.30000, 149, 322, -173, 
1982, Simon Fraser (BC), 2, 8, 0, 0.20000, 153, 301, -148, 
1937, Cincinnati (OH), 0, 5, 0, 0.00000, 12, 106, -94, 
1920, Hendrix (AR), 2, 2, 4, 0.50000, 69, 80, -11, 
2011, Benedict (SC), 1, 5, 0, 0.16667, 81, 164, -83, 
2012, Benedict (SC), 1, 9, 0, 0.10000, 160, 295, -135, 
2013, Benedict (SC), 4, 6, 0, 0.40000, 214, 284, -70, 
1934, Florida Southern, 1, 7, 1, 0.16667, 62, 123, -61, 
1886, Wabash (IN), 2, 0, 1, 0.83333, 34, 12, 22, 
1889, Indiana, 0, 2, 0, 0.00000, 7, 50, -43, 
1921, San Jose St. (CA), 1, 5, 0, 0.16667, 35, 141, -106, 
1922, San Jose St. (CA), 2, 5, 1, 0.31250, 34, 127, -93, 
1968, Eastern Washington, 3, 7, 0, 0.30000, 179, 163, 16, 
1969, Eastern Washington, 4, 5, 0, 0.44444, 167, 259, -92, 
1970, Eastern Washington, 4, 6, 0, 0.40000, 94, 224, -130, 
1913, Delaware Valley (PA), 7, 2, 0, 0.77778, 202, 25, 177, 
1917, Delaware Valley (PA), 3, 4, 0, 0.42857, 139, 93, 46, 
1918, Delaware Valley (PA), 2, 3, 0, 0.40000, 102, 71, 31, 
1919, Delaware Valley (PA), 5, 2, 1, 0.68750, 108, 28, 80, 
1920, Delaware Valley (PA), 1, 7, 1, 0.16667, 16, 67, -51, 
1921, Delaware Valley (PA), 6, 2, 1, 0.72222, 96, 30, 66, 
1980, Appalachian St. (NC), 6, 4, 1, 0.59091, 273, 186, 87, 
1981, Appalachian St. (NC), 3, 7, 1, 0.31818, 236, 201, 35, 
1982, Appalachian St. (NC), 4, 7, 0, 0.36364, 270, 286, -16, 
1926, Iowa St., 4, 3, 1, 0.56250, 51, 60, -9, 
1927, Iowa St., 4, 3, 1, 0.56250, 77, 78, -1, 
1928, Iowa St., 2, 5, 1, 0.31250, 39, 67, -28, 
1929, Iowa St., 1, 7, 0, 0.12500, 54, 135, -81, 
1930, Iowa St., 0, 9, 0, 0.00000, 64, 134, -70, 
1917, New Mexico, 1, 2, 0, 0.33333, 47, 129, -82, 
1930, Pennsylvania, 5, 4, 0, 0.55556, 225, 145, 80, 
1925, Jacksonville St. (AL), 1, 7, 0, 0.12500, 12, 201, -189, 
2007, Texas St., 4, 7, 0, 0.36364, 309, 414, -105, 
2008, Texas St., 8, 5, 0, 0.61538, 473, 407, 66, 
2009, Texas St., 7, 4, 0, 0.63636, 351, 317, 34, 
2010, Texas St., 4, 7, 0, 0.36364, 273, 377, -104, 
2013, Florida Atlantic, 4, 0, 0, 1.00000, 151, 40, 111, 
1901, Washington, 4, 3, 0, 0.57143, 59, 48, 11, 
1903, Kentucky, 7, 1, 0, 0.87500, 204, 22, 182, 
1948, Howard Payne (TX), 5, 5, 0, 0.50000, 171, 131, 40, 
1949, Howard Payne (TX), 6, 5, 0, 0.54545, 153, 169, -16, 
1950, Howard Payne (TX), 4, 5, 1, 0.45000, 208, 179, 29, 
1958, Merchant Marine (NY), 5, 4, 0, 0.55556, 145, 143, 2, 
1959, Merchant Marine (NY), 5, 4, 0, 0.55556, 169, 144, 25, 
1960, Merchant Marine (NY), 5, 4, 0, 0.55556, 207, 117, 90, 
1961, Merchant Marine (NY), 6, 4, 0, 0.60000, 176, 150, 26, 
1962, Merchant Marine (NY), 6, 4, 0, 0.60000, 85, 86, -1, 
1963, Merchant Marine (NY), 5, 3, 1, 0.61111, 168, 176, -8, 
1966, Prairie View A&M; (TX), 5, 3, 1, 0.61111, 156, 120, 36, 
1967, Prairie View A&M; (TX), 5, 5, 0, 0.50000, 153, 214, -61, 
1968, Prairie View A&M; (TX), 4, 6, 0, 0.40000, 112, 141, -29, 
1973, Prairie View A&M; (TX), 2, 6, 1, 0.27778, 88, 193, -105, 
1974, Prairie View A&M; (TX), 0, 10, 0, 0.00000, 88, 393, -305, 
1975, Prairie View A&M; (TX), 3, 7, 0, 0.30000, 108, 232, -124, 
1976, Prairie View A&M; (TX), 6, 5, 0, 0.54545, 194, 196, -2, 
1977, Prairie View A&M; (TX), 3, 8, 0, 0.27273, 160, 307, -147, 
1978, Prairie View A&M; (TX), 3, 7, 0, 0.30000, 156, 281, -125, 
1979, Prairie View A&M; (TX), 0, 11, 0, 0.00000, 70, 416, -346, 
1974, Wichita St. (KS), 1, 9, 1, 0.13636, 94, 304, -210, 
1975, Wichita St. (KS), 3, 8, 0, 0.27273, 140, 286, -146, 
1976, Wichita St. (KS), 4, 7, 0, 0.36364, 180, 227, -47, 
1977, Wichita St. (KS), 5, 6, 0, 0.45455, 262, 269, -7, 
1978, Wichita St. (KS), 4, 7, 0, 0.36364, 240, 288, -48, 
1986, Kentucky St., 1, 8, 1, 0.15000, 127, 261, -134, 
1991, Johnson C. Smith (NC), 2, 7, 1, 0.25000, 140, 291, -151, 
2000, Elizabeth City St. (NC), 1, 9, 0, 0.10000, 149, 322, -173, 
2001, Elizabeth City St. (NC), 2, 7, 0, 0.22222, 149, 247, -98, 
2002, Elizabeth City St. (NC), 2, 8, 0, 0.20000, 80, 216, -136, 
1894, William & Mary (VA), 0, 1, 0, 0.00000, 0, 28, -28, 
1933, Florida A&M;, 5, 3, 0, 0.62500, 97, 98, -1, 
1947, Savannah St. (GA), 1, 5, 1, 0.21429, 22, 146, -124, 
1948, Savannah St. (GA), 5, 3, 0, 0.62500, 89, 86, 3, 
1949, Savannah St. (GA), 3, 5, 0, 0.37500, 84, 179, -95, 
1904, Harvard (MA), 7, 2, 1, 0.75000, 119, 28, 91, 
2008, Colorado St.-Pueblo, 4, 6, 0, 0.40000, 151, 211, -60, 
2009, Colorado St.-Pueblo, 7, 4, 0, 0.63636, 316, 214, 102, 
2010, Colorado St.-Pueblo, 9, 2, 0, 0.81818, 404, 172, 232, 
2011, Colorado St.-Pueblo, 11, 1, 0, 0.91667, 396, 124, 272, 
2012, Colorado St.-Pueblo, 12, 1, 0, 0.92308, 466, 249, 217, 
2013, Colorado St.-Pueblo, 11, 1, 0, 0.91667, 512, 238, 274, 
2000, Eastern Washington, 6, 5, 0, 0.54545, 288, 243, 45, 
2001, Eastern Washington, 7, 4, 0, 0.63636, 461, 349, 112, 
2002, Eastern Washington, 6, 5, 0, 0.54545, 365, 276, 89, 
2003, Eastern Washington, 6, 5, 0, 0.54545, 344, 321, 23, 
2004, Eastern Washington, 9, 4, 0, 0.69231, 488, 323, 165, 
2005, Eastern Washington, 7, 5, 0, 0.58333, 420, 281, 139, 
2006, Eastern Washington, 3, 8, 0, 0.27273, 214, 296, -82, 
2007, Eastern Washington, 9, 4, 0, 0.69231, 437, 288, 149, 
2008, Washington St., 2, 11, 0, 0.15385, 165, 570, -405, 
2009, Washington St., 1, 11, 0, 0.08333, 144, 462, -318, 
2010, Washington St., 2, 10, 0, 0.16667, 235, 430, -195, 
2011, Washington St., 4, 8, 0, 0.33333, 358, 381, -23, 
1894, Navy (MD), 4, 1, 2, 0.71429, 72, 30, 42, 
1895, Dartmouth (NH), 7, 5, 1, 0.57692, 184, 99, 85, 
1896, Dartmouth (NH), 5, 2, 1, 0.68750, 120, 84, 36, 
1897, Dartmouth (NH), 4, 3, 0, 0.57143, 164, 77, 87, 
1898, Dartmouth (NH), 5, 6, 0, 0.45455, 205, 137, 68, 
1899, Dartmouth (NH), 2, 7, 0, 0.22222, 70, 95, -25, 
1998, Bethune-Cookman (FL), 8, 3, 0, 0.72727, 328, 297, 31, 
1999, Bethune-Cookman (FL), 7, 4, 0, 0.63636, 277, 277, 0, 
2000, Bethune-Cookman (FL), 9, 2, 0, 0.81818, 330, 168, 162, 
2001, Bethune-Cookman (FL), 6, 4, 0, 0.60000, 303, 205, 98, 
2002, Bethune-Cookman (FL), 11, 2, 0, 0.84615, 407, 200, 207, 
2003, Bethune-Cookman (FL), 9, 3, 0, 0.75000, 376, 252, 124, 
2004, Bethune-Cookman (FL), 6, 4, 0, 0.60000, 330, 209, 121, 
2005, Bethune-Cookman (FL), 7, 4, 0, 0.63636, 384, 251, 133, 
2006, Bethune-Cookman (FL), 5, 6, 0, 0.45455, 314, 249, 65, 
2007, Bethune-Cookman (FL), 5, 6, 0, 0.45455, 267, 247, 20, 
2008, Bethune-Cookman (FL), 8, 3, 0, 0.72727, 282, 210, 72, 
2009, Bethune-Cookman (FL), 5, 6, 0, 0.45455, 174, 244, -70, 
1947, Wyoming, 4, 5, 0, 0.44444, 175, 168, 7, 
1948, Wyoming, 4, 5, 0, 0.44444, 270, 145, 125, 
1949, Wyoming, 9, 1, 0, 0.90000, 381, 65, 316, 
1950, Wyoming, 10, 0, 0, 1.00000, 363, 59, 304, 
1951, Wyoming, 7, 2, 1, 0.75000, 220, 82, 138, 
1952, Wyoming, 5, 4, 0, 0.55556, 114, 102, 12, 
1953, Arkansas, 3, 7, 0, 0.30000, 116, 161, -45, 
1954, Arkansas, 8, 3, 0, 0.72727, 195, 104, 91, 
1955, Tennessee, 6, 3, 1, 0.65000, 188, 92, 96, 
1956, Tennessee, 10, 1, 0, 0.90909, 275, 88, 187, 
1957, Tennessee, 8, 3, 0, 0.72727, 164, 75, 89, 
1958, Tennessee, 4, 6, 0, 0.40000, 77, 122, -45, 
1959, Tennessee, 5, 4, 1, 0.55000, 112, 118, -6, 
1960, Tennessee, 6, 2, 2, 0.70000, 209, 79, 130, 
1961, Tennessee, 6, 4, 0, 0.60000, 221, 149, 72, 
1962, Tennessee, 4, 6, 0, 0.40000, 179, 134, 45, 
1946, Delta St. (MS), 3, 3, 1, 0.50000, 71, 67, 4, 
1947, Delta St. (MS), 5, 4, 0, 0.55556, 166, 111, 55, 
1973, Howard (DC), 8, 2, 0, 0.80000, 297, 120, 177, 
1975, Delaware St., 5, 5, 0, 0.50000, 156, 143, 13, 
1976, Delaware St., 3, 7, 1, 0.31818, 91, 225, -134, 
1977, Delaware St., 7, 4, 0, 0.63636, 146, 120, 26, 
1978, Delaware St., 3, 7, 0, 0.30000, 80, 216, -136, 
1981, Hampton (VA), 8, 2, 0, 0.80000, 246, 136, 110, 
1982, Hampton (VA), 8, 2, 0, 0.80000, 205, 114, 91, 
1983, Hampton (VA), 5, 5, 0, 0.50000, 160, 127, 33, 
1984, Alabama A&M;, 5, 4, 2, 0.54545, 217, 184, 33, 
1985, Alabama A&M;, 3, 7, 1, 0.31818, 157, 222, -65, 
1988, Morgan St. (MD), 0, 11, 0, 0.00000, 137, 317, -180, 
1989, Morgan St. (MD), 4, 6, 1, 0.40909, 183, 269, -86, 
1990, Morgan St. (MD), 1, 10, 0, 0.09091, 80, 412, -332, 
1983, Indiana, 3, 8, 0, 0.27273, 201, 360, -159, 
1970, Maranatha Baptist Bible (WI), 0, 4, 0, 0.00000, 37, 88, -51, 
1971, Maranatha Baptist Bible (WI), 0, 8, 0, 0.00000, 0, 374, -374, 
1914, Fordham (NY), 6, 3, 1, 0.65000, 124, 46, 78, 
1923, Creighton (NE), 5, 5, 0, 0.50000, 127, 80, 47, 
1924, Creighton (NE), 6, 1, 2, 0.77778, 182, 57, 125, 
1925, Creighton (NE), 6, 3, 1, 0.65000, 169, 102, 67, 
1926, Creighton (NE), 4, 4, 1, 0.50000, 107, 107, 0, 
1927, Creighton (NE), 6, 1, 1, 0.81250, 103, 46, 57, 
1928, Creighton (NE), 3, 5, 1, 0.38889, 86, 119, -33, 
1929, Creighton (NE), 2, 6, 0, 0.25000, 68, 183, -115, 
1930, Auburn (AL), 3, 7, 0, 0.30000, 101, 135, -34, 
1931, Auburn (AL), 5, 3, 1, 0.61111, 114, 78, 36, 
1932, Auburn (AL), 9, 0, 1, 0.95000, 275, 54, 221, 
1933, Auburn (AL), 5, 5, 0, 0.50000, 133, 104, 29, 
1934, Kentucky, 5, 5, 0, 0.50000, 123, 86, 37, 
1935, Kentucky, 5, 4, 0, 0.55556, 167, 94, 73, 
1936, Kentucky, 6, 4, 0, 0.60000, 179, 84, 95, 
1937, Kentucky, 4, 6, 0, 0.40000, 93, 130, -37, 
1925, Chadron St. (NE), 9, 0, 0, 1.00000, 192, 13, 179, 
1926, Chadron St. (NE), 6, 4, 0, 0.60000, 106, 66, 40, 
1981, Brooklyn (NY), 4, 6, 0, 0.40000, 130, 259, -129, 
1982, Brooklyn (NY), 3, 7, 0, 0.30000, 157, 270, -113, 
1911, Virginia, 8, 2, 0, 0.80000, 262, 30, 232, 
1938, Norfolk St. (VA), 1, 4, 0, 0.20000, 13, 133, -120, 
1939, Norfolk St. (VA), 4, 3, 0, 0.57143, 132, 49, 83, 
1942, Cameron (OK), 6, 2, 0, 0.75000, 112, 56, 56, 
1935, Fort Hays St. (KS), 8, 2, 0, 0.80000, 171, 62, 109, 
1937, Iowa St., 3, 6, 0, 0.33333, 50, 161, -111, 
1938, Iowa St., 7, 1, 1, 0.83333, 125, 64, 61, 
1939, Iowa St., 2, 7, 0, 0.22222, 50, 117, -67, 
1940, Iowa St., 4, 5, 0, 0.44444, 118, 132, -14, 
1941, Colorado, 3, 4, 1, 0.43750, 97, 161, -64, 
1942, Colorado, 7, 2, 0, 0.77778, 251, 73, 178, 
1943, Colorado, 5, 2, 0, 0.71429, 134, 47, 87, 
1946, Colorado, 5, 4, 1, 0.55000, 91, 147, -56, 
1947, Colorado, 4, 5, 0, 0.44444, 90, 162, -72, 
1899, West Virginia, 2, 3, 0, 0.40000, 28, 78, -50, 
1901, West Virginia, 3, 2, 0, 0.60000, 73, 34, 39, 
1902, West Virginia, 7, 4, 0, 0.63636, 217, 87, 130, 
2012, Carthage (WI), 0, 3, 0, 0.00000, 50, 134, -84, 
2013, Carthage (WI), 1, 9, 0, 0.10000, 156, 280, -124, 
1979, Salisbury (MD), 6, 3, 0, 0.66667, 140, 153, -13, 
1980, Salisbury (MD), 7, 3, 1, 0.68182, 228, 184, 44, 
1981, Salisbury (MD), 2, 7, 0, 0.22222, 115, 193, -78, 
1962, Houston (TX), 7, 4, 0, 0.63636, 198, 171, 27, 
1963, Houston (TX), 2, 8, 0, 0.20000, 149, 208, -59, 
1964, Houston (TX), 2, 6, 1, 0.27778, 115, 174, -59, 
1965, Houston (TX), 4, 5, 1, 0.45000, 159, 174, -15, 
1966, Houston (TX), 8, 2, 0, 0.80000, 335, 125, 210, 
1967, Houston (TX), 7, 3, 0, 0.70000, 322, 122, 200, 
1968, Houston (TX), 6, 2, 2, 0.70000, 425, 154, 271, 
1969, Houston (TX), 9, 2, 0, 0.81818, 422, 208, 214, 
1970, Houston (TX), 8, 3, 0, 0.72727, 307, 160, 147, 
1971, Houston (TX), 9, 3, 0, 0.75000, 339, 199, 140, 
1972, Houston (TX), 6, 4, 1, 0.59091, 325, 202, 123, 
1973, Houston (TX), 11, 1, 0, 0.91667, 363, 142, 221, 
1974, Houston (TX), 8, 3, 1, 0.70833, 280, 185, 95, 
1975, Houston (TX), 2, 8, 0, 0.20000, 185, 245, -60, 
1976, Houston (TX), 10, 2, 0, 0.83333, 343, 188, 155, 
1977, Houston (TX), 6, 5, 0, 0.54545, 282, 259, 23, 
1978, Houston (TX), 9, 3, 0, 0.75000, 364, 213, 151, 
1979, Houston (TX), 11, 1, 0, 0.91667, 295, 135, 160, 
1980, Houston (TX), 7, 5, 0, 0.58333, 236, 190, 46, 
1981, Houston (TX), 7, 4, 1, 0.62500, 238, 174, 64, 
1982, Houston (TX), 5, 5, 1, 0.50000, 215, 262, -47, 
1983, Houston (TX), 4, 7, 0, 0.36364, 225, 294, -69, 
1984, Houston (TX), 7, 5, 0, 0.58333, 266, 267, -1, 
1985, Houston (TX), 4, 7, 0, 0.36364, 253, 339, -86, 
1986, Houston (TX), 1, 10, 0, 0.09091, 125, 267, -142, 
1979, Bentley (MA), 6, 3, 0, 0.66667, 163, 123, 40, 
1980, Bentley (MA), 7, 4, 0, 0.63636, 238, 125, 113, 
1981, Bentley (MA), 7, 3, 0, 0.70000, 151, 132, 19, 
1982, Bentley (MA), 10, 0, 1, 0.95455, 292, 98, 194, 
1983, Bentley (MA), 9, 2, 0, 0.81818, 275, 81, 194, 
1984, Bentley (MA), 7, 3, 0, 0.70000, 214, 160, 54, 
1985, Bentley (MA), 6, 4, 0, 0.60000, 191, 134, 57, 
1986, Bentley (MA), 9, 1, 0, 0.90000, 293, 122, 171, 
1987, Bentley (MA), 10, 1, 0, 0.90909, 347, 114, 233, 
1988, Bentley (MA), 5, 2, 1, 0.68750, 234, 160, 74, 
1989, Bentley (MA), 5, 4, 0, 0.55556, 162, 149, 13, 
1990, Bentley (MA), 7, 1, 0, 0.87500, 145, 36, 109, 
1991, Bentley (MA), 5, 4, 0, 0.55556, 168, 134, 34, 
1992, Bentley (MA), 9, 2, 0, 0.81818, 387, 139, 248, 
1993, Bentley (MA), 10, 0, 0, 1.00000, 320, 109, 211, 
1994, Bentley (MA), 11, 0, 0, 1.00000, 462, 73, 389, 
1995, Bentley (MA), 10, 1, 0, 0.90909, 397, 122, 275, 
1996, Bentley (MA), 7, 4, 0, 0.63636, 309, 191, 118, 
1997, Bentley (MA), 6, 3, 0, 0.66667, 255, 127, 128, 
1998, Bentley (MA), 8, 2, 0, 0.80000, 265, 168, 97, 
1999, Bentley (MA), 4, 7, 0, 0.36364, 293, 288, 5, 
2000, Bentley (MA), 5, 6, 0, 0.45455, 209, 226, -17, 
2001, Bentley (MA), 9, 3, 0, 0.75000, 394, 302, 92, 
2002, Bentley (MA), 10, 1, 0, 0.90909, 346, 145, 201, 
2003, Bentley (MA), 10, 1, 0, 0.90909, 510, 219, 291, 
2004, Bentley (MA), 8, 2, 0, 0.80000, 418, 169, 249, 
2005, Bentley (MA), 7, 3, 0, 0.70000, 341, 248, 93, 
2006, Bentley (MA), 6, 5, 0, 0.54545, 158, 161, -3, 
2007, Bentley (MA), 7, 3, 0, 0.70000, 273, 191, 82, 
2008, Bentley (MA), 5, 6, 0, 0.45455, 208, 325, -117, 
1957, Central Missouri St., 1, 7, 1, 0.16667, 107, 217, -110, 
1958, Central Missouri St., 2, 6, 1, 0.27778, 120, 223, -103, 
1959, Central Missouri St., 3, 7, 0, 0.30000, 132, 264, -132, 
1960, Central Missouri St., 4, 5, 0, 0.44444, 196, 213, -17, 
1972, Salisbury (MD), 4, 2, 0, 0.66667, 182, 50, 132, 
1973, Salisbury (MD), 7, 2, 0, 0.77778, 292, 117, 175, 
1974, Salisbury (MD), 4, 4, 1, 0.50000, 179, 147, 32, 
1975, Salisbury (MD), 7, 3, 0, 0.70000, 278, 186, 92, 
1976, Salisbury (MD), 7, 4, 0, 0.63636, 307, 183, 124, 
1977, Salisbury (MD), 5, 5, 0, 0.50000, 195, 203, -8, 
1978, Salisbury (MD), 5, 5, 0, 0.50000, 192, 150, 42, 
1972, Cal St.-Fullerton, 7, 4, 0, 0.63636, 247, 244, 3, 
1973, Cal St.-Fullerton, 7, 4, 0, 0.63636, 203, 158, 45, 
1974, Cal St.-Fullerton, 4, 7, 0, 0.36364, 167, 272, -105, 
2013, Shenandoah (VA), 4, 6, 0, 0.40000, 218, 335, -117, 
1952, Bloomsburg (PA), 5, 2, 1, 0.68750, 118, 95, 23, 
1953, Bloomsburg (PA), 6, 2, 0, 0.75000, 195, 96, 99, 
1954, Bloomsburg (PA), 6, 2, 0, 0.75000, 221, 106, 115, 
1955, Bloomsburg (PA), 5, 2, 1, 0.68750, 110, 77, 33, 
1956, Bloomsburg (PA), 3, 4, 0, 0.42857, 95, 97, -2, 
1902, Susquehanna (PA), 1, 7, 0, 0.12500, 121, 226, -105, 
1898, Nebraska, 8, 3, 0, 0.72727, 270, 78, 192, 
1899, Kansas, 10, 0, 0, 1.00000, 280, 37, 243, 
1900, Stanford (CA), 7, 2, 1, 0.75000, 154, 20, 134, 
1901, Michigan, 11, 0, 0, 1.00000, 550, 0, 550, 
1902, Michigan, 11, 0, 0, 1.00000, 644, 12, 632, 
1903, Michigan, 11, 0, 1, 0.95833, 565, 6, 559, 
1904, Michigan, 10, 0, 0, 1.00000, 567, 22, 545, 
1905, Michigan, 12, 1, 0, 0.92308, 495, 2, 493, 
1906, Michigan, 4, 1, 1, 0.75000, 72, 30, 42, 
1907, Michigan, 5, 1, 0, 0.83333, 107, 6, 101, 
1908, Michigan, 5, 2, 1, 0.68750, 128, 81, 47, 
1909, Michigan, 6, 1, 0, 0.85714, 115, 34, 81, 
1910, Michigan, 3, 0, 3, 0.75000, 29, 9, 20, 
1911, Michigan, 5, 1, 2, 0.75000, 90, 38, 52, 
1912, Michigan, 5, 2, 0, 0.71429, 158, 65, 93, 
1913, Michigan, 6, 1, 0, 0.85714, 175, 21, 154, 
1914, Michigan, 6, 3, 0, 0.66667, 233, 68, 165, 
1915, Michigan, 4, 3, 1, 0.56250, 130, 81, 49, 
1916, Michigan, 7, 2, 0, 0.77778, 253, 56, 197, 
1917, Michigan, 8, 2, 0, 0.80000, 304, 53, 251, 
1918, Michigan, 5, 0, 0, 1.00000, 96, 6, 90, 
1919, Michigan, 3, 4, 0, 0.42857, 93, 102, -9, 
1920, Michigan, 5, 2, 0, 0.71429, 121, 21, 100, 
1921, Michigan, 5, 1, 1, 0.78571, 187, 21, 166, 
1922, Michigan, 6, 0, 1, 0.92857, 183, 13, 170, 
1923, Michigan, 8, 0, 0, 1.00000, 150, 12, 138, 
1925, Michigan, 7, 1, 0, 0.87500, 227, 3, 224, 
1926, Michigan, 7, 1, 0, 0.87500, 191, 38, 153, 
1895, Bucknell (PA), 5, 2, 0, 0.71429, 144, 60, 84, 
1896, Bucknell (PA), 5, 2, 1, 0.68750, 54, 100, -46, 
2012, Greensboro (NC), 5, 5, 0, 0.50000, 181, 278, -97, 
2013, Greensboro (NC), 2, 8, 0, 0.20000, 279, 386, -107, 
2005, Avila (MO), 0, 10, 0, 0.00000, 72, 328, -256, 
2006, Avila (MO), 3, 8, 0, 0.27273, 120, 224, -104, 
2007, Avila (MO), 2, 9, 0, 0.18182, 240, 390, -150, 
2008, Avila (MO), 3, 8, 0, 0.27273, 115, 292, -177, 
2009, Avila (MO), 4, 7, 0, 0.36364, 135, 350, -215, 
1893, Oregon, 1, 0, 0, 1.00000, 44, 2, 42, 
1897, Missouri, 5, 6, 0, 0.45455, 112, 143, -31, 
1913, Arkansas St., 5, 2, 1, 0.68750, 254, 39, 215, 
1895, Lawrence (WI), 4, 2, 0, 0.66667, 140, 40, 100, 
1973, Arkansas-Pine Bluff, 3, 5, 1, 0.38889, 148, 171, -23, 
1974, Arkansas-Pine Bluff, 2, 6, 0, 0.25000, 61, 153, -92, 
1975, Arkansas-Pine Bluff, 0, 11, 0, 0.00000, 78, 243, -165, 
1984, Arkansas-Pine Bluff, 1, 7, 1, 0.16667, 94, 194, -100, 
1985, Arkansas-Pine Bluff, 2, 8, 0, 0.20000, 132, 241, -109, 
1986, Arkansas-Pine Bluff, 1, 9, 0, 0.10000, 94, 208, -114, 
2013, New Mexico Highlands, 2, 9, 0, 0.18182, 268, 378, -110, 
1962, Louisiana College, 4, 4, 1, 0.50000, 110, 104, 6, 
1891, Furman (SC), 0, 1, 0, 0.00000, 0, 96, -96, 
1892, Furman (SC), 1, 0, 0, 1.00000, 44, 0, 44, 
1893, Furman (SC), 1, 1, 0, 0.50000, 26, 26, 0, 
1895, Furman (SC), 0, 2, 0, 0.00000, 10, 58, -48, 
1917, William & Mary (VA), 3, 5, 0, 0.37500, 41, 159, -118, 
1973, Arizona, 8, 3, 0, 0.72727, 286, 213, 73, 
1974, Arizona, 9, 2, 0, 0.81818, 263, 174, 89, 
1975, Arizona, 9, 2, 0, 0.81818, 330, 169, 161, 
1976, Arizona, 5, 6, 0, 0.45455, 283, 273, 10, 
1977, Purdue (IN), 5, 6, 0, 0.45455, 231, 247, -16, 
1978, Purdue (IN), 9, 2, 1, 0.79167, 261, 130, 131, 
1979, Purdue (IN), 10, 2, 0, 0.83333, 287, 226, 61, 
1980, Purdue (IN), 9, 3, 0, 0.75000, 328, 233, 95, 
1981, Purdue (IN), 5, 6, 0, 0.45455, 242, 241, 1, 
1983, Army (NY), 2, 9, 0, 0.18182, 140, 304, -164, 
1984, Army (NY), 8, 3, 1, 0.70833, 320, 218, 102, 
1985, Army (NY), 9, 3, 0, 0.75000, 396, 232, 164, 
1986, Army (NY), 6, 5, 0, 0.54545, 276, 292, -16, 
1987, Army (NY), 5, 6, 0, 0.45455, 277, 223, 54, 
1988, Army (NY), 9, 3, 0, 0.75000, 336, 226, 110, 
1989, Army (NY), 6, 5, 0, 0.54545, 316, 212, 104, 
1990, Army (NY), 6, 5, 0, 0.54545, 295, 264, 31, 
1937, Jackson St. (MS), 1, 1, 0, 0.50000, 19, 28, -9, 
1938, Jackson St. (MS), 1, 2, 0, 0.33333, 6, 60, -54, 
1939, Jackson St. (MS), 0, 2, 1, 0.16667, 14, 37, -23, 
1923, Pennsylvania, 5, 4, 0, 0.55556, 95, 63, 32, 
1924, Pennsylvania, 9, 1, 1, 0.86364, 203, 31, 172, 
1925, Pennsylvania, 7, 2, 0, 0.77778, 165, 64, 101, 
1926, Pennsylvania, 7, 1, 1, 0.83333, 204, 20, 184, 
1927, Pennsylvania, 6, 4, 0, 0.60000, 167, 78, 89, 
1928, Pennsylvania, 8, 1, 0, 0.88889, 271, 26, 245, 
1929, Pennsylvania, 7, 2, 0, 0.77778, 116, 68, 48, 
1950, Dickinson St. (ND), 5, 2, 1, 0.68750, 140, 64, 76, 
1946, Parsons (IA), 4, 4, 0, 0.50000, 116, 104, 12, 
1947, Parsons (IA), 2, 6, 0, 0.25000, 72, 98, -26, 
1948, Parsons (IA), 3, 5, 0, 0.37500, 159, 128, 31, 
1971, Southwest St. (MN), 0, 10, 0, 0.00000, 72, 319, -247, 
1972, Southwest St. (MN), 3, 7, 0, 0.30000, 116, 245, -129, 
1915, DePauw (IN), 5, 3, 0, 0.62500, 159, 79, 80, 
1916, Kalamazoo (MI), 7, 0, 0, 1.00000, 291, 40, 251, 
1917, Kalamazoo (MI), 5, 5, 0, 0.50000, 184, 225, -41, 
1919, Kalamazoo (MI), 5, 2, 0, 0.71429, 187, 70, 117, 
1920, Kalamazoo (MI), 5, 3, 1, 0.61111, 200, 143, 57, 
1921, Kalamazoo (MI), 7, 2, 0, 0.77778, 234, 104, 130, 
1922, Kalamazoo (MI), 4, 4, 1, 0.50000, 96, 92, 4, 
1923, Michigan St., 3, 5, 0, 0.37500, 56, 144, -88, 
1924, Michigan St., 5, 3, 0, 0.62500, 210, 48, 162, 
1925, Michigan St., 3, 5, 0, 0.37500, 105, 106, -1, 
1926, Michigan St., 3, 4, 1, 0.43750, 97, 171, -74, 
1927, Michigan St., 4, 5, 0, 0.44444, 111, 128, -17, 
1978, Bluffton (OH), 2, 7, 0, 0.22222, 84, 199, -115, 
1963, Wisconsin-Oshkosh, 0, 5, 2, 0.14286, 51, 160, -109, 
1964, Wisconsin-Oshkosh, 5, 4, 0, 0.55556, 159, 126, 33, 
1965, Wisconsin-Oshkosh, 5, 4, 0, 0.55556, 135, 110, 25, 
1966, Wisconsin-Oshkosh, 3, 6, 0, 0.33333, 140, 170, -30, 
1967, Wisconsin-Oshkosh, 6, 3, 0, 0.66667, 199, 82, 117, 
1968, Wisconsin-Oshkosh, 8, 2, 0, 0.80000, 243, 171, 72, 
1969, Wisconsin-Oshkosh, 5, 5, 0, 0.50000, 235, 207, 28, 
1970, Wisconsin-Oshkosh, 5, 5, 0, 0.50000, 158, 216, -58, 
1971, Wisconsin-Oshkosh, 4, 6, 0, 0.40000, 100, 172, -72, 
1972, Wisconsin-Oshkosh, 8, 2, 0, 0.80000, 183, 107, 76, 
1973, Wisconsin-Oshkosh, 4, 6, 0, 0.40000, 158, 153, 5, 
1974, Wisconsin-Oshkosh, 3, 7, 0, 0.30000, 147, 264, -117, 
1975, Wisconsin-Oshkosh, 3, 7, 0, 0.30000, 122, 176, -54, 
1976, Wisconsin-Oshkosh, 8, 2, 0, 0.80000, 184, 92, 92, 
1943, North Carolina, 6, 3, 0, 0.66667, 173, 93, 80, 
1946, Western Carolina (NC), 6, 3, 1, 0.65000, 135, 87, 48, 
1947, Western Carolina (NC), 3, 5, 1, 0.38889, 93, 123, -30, 
1948, Western Carolina (NC), 7, 3, 0, 0.70000, 198, 79, 119, 
1949, Western Carolina (NC), 8, 3, 0, 0.72727, 186, 99, 87, 
1950, Western Carolina (NC), 3, 6, 0, 0.33333, 102, 174, -72, 
1951, Western Carolina (NC), 3, 6, 0, 0.33333, 102, 183, -81, 
1952, Western Carolina (NC), 2, 8, 0, 0.20000, 76, 215, -139, 
1953, Western Carolina (NC), 1, 9, 0, 0.10000, 84, 152, -68, 
1954, Western Carolina (NC), 4, 5, 1, 0.45000, 217, 164, 53, 
1955, Western Carolina (NC), 1, 8, 1, 0.15000, 60, 196, -136, 
1950, Furman (SC), 2, 8, 1, 0.22727, 112, 285, -173, 
1951, Furman (SC), 3, 6, 1, 0.35000, 192, 179, 13, 
1952, Furman (SC), 6, 3, 1, 0.65000, 176, 147, 29, 
1953, Furman (SC), 7, 2, 0, 0.77778, 168, 91, 77, 
1954, Furman (SC), 5, 5, 0, 0.50000, 143, 196, -53, 
1911, William & Mary (VA), 1, 5, 2, 0.25000, 14, 186, -172, 
1912, William & Mary (VA), 0, 7, 0, 0.00000, 0, 226, -226, 
1906, Louisiana Tech, 2, 1, 3, 0.58333, 36, 22, 14, 
2007, Waldorf College (IA), 2, 9, 0, 0.18182, 121, 347, -226, 
2008, Waldorf College (IA), 1, 10, 0, 0.09091, 82, 419, -337, 
2009, Waldorf College (IA), 1, 9, 0, 0.10000, 99, 392, -293, 
2010, Waldorf College (IA), 3, 8, 0, 0.27273, 190, 411, -221, 
2011, Waldorf College (IA), 2, 9, 0, 0.18182, 113, 442, -329, 
2012, Dordt College (IA), 1, 10, 0, 0.09091, 137, 404, -267, 
2013, Dordt College (IA), 2, 9, 0, 0.18182, 160, 451, -291, 
1923, Davidson (NC), 3, 7, 0, 0.30000, 44, 99, -55, 
1924, Davidson (NC), 7, 2, 1, 0.75000, 125, 38, 87, 
1925, Davidson (NC), 6, 2, 2, 0.70000, 137, 33, 104, 
1926, Davidson (NC), 7, 2, 1, 0.75000, 122, 33, 89, 
1927, Davidson (NC), 4, 4, 1, 0.50000, 82, 135, -53, 
1928, Davidson (NC), 2, 8, 0, 0.20000, 112, 154, -42, 
1929, Davidson (NC), 5, 5, 0, 0.50000, 94, 123, -29, 
1930, Davidson (NC), 6, 4, 0, 0.60000, 118, 57, 61, 
1931, Davidson (NC), 4, 4, 2, 0.50000, 54, 72, -18, 
1917, Parsons (IA), 6, 1, 0, 0.85714, 200, 19, 181, 
1918, Parsons (IA), 1, 1, 1, 0.50000, 18, 19, -1, 
1919, Parsons (IA), 2, 4, 0, 0.33333, 26, 54, -28, 
1920, Parsons (IA), 3, 3, 0, 0.50000, 54, 41, 13, 
1957, Harvard (MA), 3, 5, 0, 0.37500, 78, 180, -102, 
1958, Harvard (MA), 4, 5, 0, 0.44444, 149, 99, 50, 
1959, Harvard (MA), 6, 3, 0, 0.66667, 177, 101, 76, 
1960, Harvard (MA), 5, 4, 0, 0.55556, 90, 119, -29, 
1961, Harvard (MA), 6, 3, 0, 0.66667, 160, 97, 63, 
1962, Harvard (MA), 6, 3, 0, 0.66667, 202, 118, 84, 
1963, Harvard (MA), 5, 2, 2, 0.66667, 122, 76, 46, 
1964, Harvard (MA), 6, 3, 0, 0.66667, 131, 123, 8, 
1965, Harvard (MA), 5, 2, 2, 0.66667, 120, 62, 58, 
1966, Harvard (MA), 8, 1, 0, 0.88889, 231, 60, 171, 
1967, Harvard (MA), 6, 3, 0, 0.66667, 256, 144, 112, 
1968, Harvard (MA), 8, 0, 1, 0.94444, 236, 90, 146, 
1969, Harvard (MA), 3, 6, 0, 0.33333, 165, 166, -1, 
1970, Harvard (MA), 7, 2, 0, 0.77778, 227, 157, 70, 
1937, High Point (NC), 3, 1, 2, 0.66667, 80, 45, 35, 
1966, New Hampshire, 2, 6, 0, 0.25000, 117, 139, -22, 
1967, New Hampshire, 5, 3, 0, 0.62500, 169, 72, 97, 
1968, Boston College (MA), 6, 3, 0, 0.66667, 253, 196, 57, 
1969, Boston College (MA), 5, 4, 0, 0.55556, 218, 245, -27, 
1970, Boston College (MA), 8, 2, 0, 0.80000, 307, 142, 165, 
1971, Boston College (MA), 9, 2, 0, 0.81818, 259, 117, 142, 
1972, Boston College (MA), 4, 7, 0, 0.36364, 240, 258, -18, 
1973, Boston College (MA), 7, 4, 0, 0.63636, 311, 174, 137, 
1974, Boston College (MA), 8, 3, 0, 0.72727, 375, 154, 221, 
1975, Boston College (MA), 7, 4, 0, 0.63636, 227, 146, 81, 
1976, Boston College (MA), 8, 3, 0, 0.72727, 239, 125, 114, 
1977, Boston College (MA), 6, 5, 0, 0.54545, 242, 269, -27, 
1978, Dartmouth (NH), 6, 3, 0, 0.66667, 187, 159, 28, 
1979, Dartmouth (NH), 4, 4, 1, 0.50000, 98, 86, 12, 
1980, Dartmouth (NH), 4, 6, 0, 0.40000, 207, 170, 37, 
1981, Dartmouth (NH), 6, 4, 0, 0.60000, 208, 137, 71, 
1982, Dartmouth (NH), 5, 5, 0, 0.50000, 219, 235, -16, 
1983, Dartmouth (NH), 4, 5, 1, 0.45000, 185, 208, -23, 
1984, Dartmouth (NH), 2, 7, 0, 0.22222, 174, 226, -52, 
1985, Dartmouth (NH), 2, 7, 1, 0.25000, 144, 199, -55, 
1986, Dartmouth (NH), 3, 6, 1, 0.35000, 188, 272, -84, 
1934, Central Michigan, 5, 3, 0, 0.62500, 81, 82, -1, 
1935, Central Michigan, 1, 6, 0, 0.14286, 32, 101, -69, 
1936, Central Michigan, 3, 4, 1, 0.43750, 89, 135, -46, 
1977, West Texas A&M;, 6, 4, 1, 0.59091, 263, 183, 80, 
1978, West Texas A&M;, 3, 8, 0, 0.27273, 237, 297, -60, 
1979, West Texas A&M;, 5, 5, 1, 0.50000, 239, 195, 44, 
1980, West Texas A&M;, 5, 6, 0, 0.45455, 232, 284, -52, 
1981, West Texas A&M;, 7, 4, 0, 0.63636, 247, 213, 34, 
1982, Texas-El Paso, 2, 10, 0, 0.16667, 177, 417, -240, 
1983, Texas-El Paso, 2, 10, 0, 0.16667, 210, 359, -149, 
1984, Texas-El Paso, 2, 9, 0, 0.18182, 180, 374, -194, 
1985, Texas-El Paso, 1, 10, 0, 0.09091, 196, 375, -179, 
1948, Northeastern (MA), 1, 4, 1, 0.25000, 39, 130, -91, 
1949, Northeastern (MA), 3, 3, 0, 0.50000, 116, 81, 35, 
1950, Northeastern (MA), 3, 3, 1, 0.50000, 95, 81, 14, 
1951, Northeastern (MA), 6, 0, 1, 0.92857, 194, 60, 134, 
1952, Northeastern (MA), 4, 3, 0, 0.57143, 147, 167, -20, 
1953, Northeastern (MA), 6, 1, 0, 0.85714, 206, 51, 155, 
1954, Northeastern (MA), 4, 3, 0, 0.57143, 161, 81, 80, 
1955, Northeastern (MA), 4, 1, 1, 0.75000, 98, 67, 31, 
1956, Northeastern (MA), 3, 5, 0, 0.37500, 95, 123, -28, 
1957, Northeastern (MA), 1, 6, 0, 0.14286, 79, 136, -57, 
1958, Northeastern (MA), 6, 2, 0, 0.75000, 196, 104, 92, 
1959, Northeastern (MA), 1, 6, 1, 0.18750, 77, 178, -101, 
1960, Northeastern (MA), 2, 5, 1, 0.31250, 67, 106, -39, 
1961, Northeastern (MA), 4, 4, 0, 0.50000, 117, 118, -1, 
1962, Northeastern (MA), 5, 3, 0, 0.62500, 93, 54, 39, 
1963, Northeastern (MA), 8, 1, 0, 0.88889, 243, 69, 174, 
1964, Northeastern (MA), 5, 3, 0, 0.62500, 150, 143, 7, 
1965, Northeastern (MA), 6, 2, 0, 0.75000, 187, 106, 81, 
1966, Northeastern (MA), 6, 2, 0, 0.75000, 144, 117, 27, 
1967, Northeastern (MA), 7, 1, 0, 0.87500, 214, 34, 180, 
1968, Northeastern (MA), 6, 3, 0, 0.66667, 204, 185, 19, 
1969, Northeastern (MA), 3, 6, 0, 0.33333, 163, 238, -75, 
1970, Northeastern (MA), 3, 5, 0, 0.37500, 108, 141, -33, 
1971, Northeastern (MA), 4, 5, 0, 0.44444, 174, 157, 17, 
1960, Dayton (OH), 1, 9, 0, 0.10000, 74, 202, -128, 
1961, Dayton (OH), 2, 8, 0, 0.20000, 98, 245, -147, 
1962, Dayton (OH), 2, 8, 0, 0.20000, 100, 210, -110, 
1996, Siena (NY), 2, 7, 0, 0.22222, 156, 256, -100, 
1997, Siena (NY), 6, 3, 0, 0.66667, 211, 205, 6, 
1998, Siena (NY), 4, 6, 0, 0.40000, 146, 261, -115, 
1999, Worcester Tech (MA), 5, 4, 0, 0.55556, 185, 249, -64, 
2000, Worcester Tech (MA), 2, 8, 0, 0.20000, 185, 321, -136, 
2001, Worcester Tech (MA), 4, 6, 0, 0.40000, 242, 323, -81, 
2002, Worcester Tech (MA), 4, 6, 0, 0.40000, 209, 253, -44, 
2003, Worcester Tech (MA), 4, 6, 0, 0.40000, 303, 274, 29, 
2004, Worcester Tech (MA), 5, 5, 0, 0.50000, 311, 223, 88, 
2005, Worcester Tech (MA), 6, 3, 0, 0.66667, 215, 208, 7, 
2006, Worcester Tech (MA), 3, 6, 0, 0.33333, 207, 227, -20, 
2007, Worcester Tech (MA), 4, 6, 0, 0.40000, 284, 220, 64, 
2008, Worcester Tech (MA), 7, 3, 0, 0.70000, 252, 222, 30, 
2009, Worcester Tech (MA), 3, 7, 0, 0.30000, 259, 228, 31, 
2007, Idaho St., 3, 8, 0, 0.27273, 271, 393, -122, 
2008, Idaho St., 1, 11, 0, 0.08333, 256, 494, -238, 
2009, Idaho St., 1, 10, 0, 0.09091, 142, 424, -282, 
2010, Idaho St., 1, 10, 0, 0.09091, 172, 366, -194, 
1994, Louisiana-Monroe, 3, 8, 0, 0.27273, 242, 384, -142, 
1995, Louisiana-Monroe, 2, 9, 0, 0.18182, 233, 413, -180, 
1996, Louisiana-Monroe, 5, 6, 0, 0.45455, 192, 353, -161, 
1997, Louisiana-Monroe, 5, 7, 0, 0.41667, 226, 319, -93, 
1998, Louisiana-Monroe, 5, 6, 0, 0.45455, 227, 322, -95, 
1950, North Dakota, 5, 2, 2, 0.66667, 222, 170, 52, 
1951, North Dakota, 2, 4, 0, 0.33333, 105, 162, -57, 
1952, North Dakota, 3, 6, 0, 0.33333, 131, 224, -93, 
1953, North Dakota, 6, 1, 1, 0.81250, 154, 107, 47, 
1954, North Dakota, 4, 5, 0, 0.44444, 200, 182, 18, 
1955, North Dakota, 6, 3, 0, 0.66667, 183, 86, 97, 
1956, North Dakota, 2, 6, 0, 0.25000, 110, 158, -48, 
1983, New Mexico St., 5, 6, 0, 0.45455, 211, 292, -81, 
1984, New Mexico St., 2, 9, 0, 0.18182, 185, 336, -151, 
1985, New Mexico St., 1, 10, 0, 0.09091, 190, 369, -179, 
1915, Mercer (GA), 5, 4, 0, 0.55556, 98, 164, -66, 
1916, Mercer (GA), 1, 1, 0, 0.50000, 7, 61, -54, 
2004, Citadel (SC), 3, 7, 0, 0.30000, 162, 250, -88, 
1929, Delaware, 0, 7, 1, 0.06250, 24, 142, -118, 
1930, Delaware, 6, 3, 1, 0.65000, 138, 117, 21, 
1963, Rhode Island, 4, 5, 0, 0.44444, 116, 219, -103, 
1964, Rhode Island, 3, 7, 0, 0.30000, 127, 186, -59, 
1965, Rhode Island, 2, 7, 0, 0.22222, 52, 181, -129, 
1966, Rhode Island, 1, 7, 1, 0.16667, 93, 186, -93, 
1967, Rhode Island, 6, 2, 1, 0.72222, 163, 110, 53, 
1968, Rhode Island, 3, 6, 0, 0.33333, 137, 168, -31, 
1969, Rhode Island, 2, 7, 0, 0.22222, 88, 226, -138, 
1894, New Mexico, 1, 1, 1, 0.50000, 26, 8, 18, 
1928, Delta St. (MS), 6, 2, 0, 0.75000, 193, 71, 122, 
1929, Delta St. (MS), 5, 1, 2, 0.75000, 126, 39, 87, 
1930, Delta St. (MS), 4, 5, 1, 0.45000, 146, 120, 26, 
1931, Delta St. (MS), 5, 3, 1, 0.61111, 145, 147, -2, 
1932, Delta St. (MS), 4, 5, 0, 0.44444, 112, 130, -18, 
1934, Delta St. (MS), 2, 6, 1, 0.27778, 53, 126, -73, 
1935, Delta St. (MS), 1, 8, 0, 0.11111, 44, 171, -127, 
1897, Butler (IN), 1, 0, 0, 1.00000, 4, 0, 4, 
1950, Brown (RI), 1, 8, 0, 0.11111, 147, 271, -124, 
2002, Florida, 8, 5, 0, 0.61538, 336, 279, 57, 
2003, Florida, 8, 5, 0, 0.61538, 390, 271, 119, 
2004, Florida, 7, 4, 0, 0.63636, 372, 226, 146, 
2005, Illinois, 2, 9, 0, 0.18182, 187, 435, -248, 
2006, Illinois, 2, 10, 0, 0.16667, 235, 321, -86, 
2007, Illinois, 9, 4, 0, 0.69231, 362, 283, 79, 
2008, Illinois, 5, 7, 0, 0.41667, 344, 319, 25, 
2009, Illinois, 3, 9, 0, 0.25000, 290, 362, -72, 
2010, Illinois, 7, 6, 0, 0.53846, 423, 305, 118, 
2011, Illinois, 6, 6, 0, 0.50000, 274, 241, 33, 
1967, Shenandoah (VA), 2, 4, 1, 0.35714, 112, 303, -191, 
2008, Kalamazoo (MI), 2, 8, 0, 0.20000, 227, 357, -130, 
2009, Kalamazoo (MI), 4, 6, 0, 0.40000, 288, 339, -51, 
2010, Kalamazoo (MI), 3, 7, 0, 0.30000, 234, 356, -122, 
2011, Kalamazoo (MI), 4, 6, 0, 0.40000, 281, 263, 18, 
2012, Kalamazoo (MI), 5, 5, 0, 0.50000, 197, 247, -50, 
2013, Kalamazoo (MI), 6, 4, 0, 0.60000, 249, 242, 7, 
1979, Eastern Washington, 7, 2, 0, 0.77778, 184, 162, 22, 
1980, Eastern Washington, 6, 4, 0, 0.60000, 221, 195, 26, 
1981, Eastern Washington, 7, 3, 0, 0.70000, 245, 97, 148, 
1982, Eastern Washington, 8, 2, 0, 0.80000, 313, 116, 197, 
1983, Eastern Washington, 5, 5, 0, 0.50000, 202, 194, 8, 
1984, Eastern Washington, 7, 2, 1, 0.75000, 306, 200, 106, 
1985, Eastern Washington, 9, 3, 0, 0.75000, 381, 260, 121, 
1986, Eastern Washington, 6, 5, 0, 0.54545, 324, 276, 48, 
1987, Eastern Washington, 4, 7, 0, 0.36364, 220, 303, -83, 
1988, Eastern Washington, 2, 8, 1, 0.22727, 217, 372, -155, 
1989, Eastern Washington, 4, 6, 0, 0.40000, 255, 264, -9, 
1990, Eastern Washington, 5, 6, 0, 0.45455, 300, 360, -60, 
1991, Eastern Washington, 5, 6, 0, 0.45455, 301, 364, -63, 
1992, Eastern Washington, 7, 4, 0, 0.63636, 280, 211, 69, 
1993, Eastern Washington, 7, 3, 0, 0.70000, 285, 225, 60, 
1986, Pennsylvania, 10, 0, 0, 1.00000, 274, 108, 166, 
1987, Pennsylvania, 4, 6, 0, 0.40000, 241, 201, 40, 
1988, Pennsylvania, 9, 1, 0, 0.90000, 268, 169, 99, 
1913, Illinois, 4, 2, 1, 0.64286, 108, 54, 54, 
1914, Illinois, 7, 0, 0, 1.00000, 224, 22, 202, 
1915, Illinois, 5, 0, 2, 0.85714, 183, 25, 158, 
1916, Illinois, 3, 3, 1, 0.50000, 74, 58, 16, 
1917, Illinois, 5, 2, 1, 0.68750, 134, 40, 94, 
1918, Illinois, 5, 2, 0, 0.71429, 86, 14, 72, 
1919, Illinois, 6, 1, 0, 0.85714, 91, 48, 43, 
1920, Illinois, 5, 2, 0, 0.71429, 97, 37, 60, 
1921, Illinois, 3, 4, 0, 0.42857, 88, 51, 37, 
1922, Illinois, 2, 5, 0, 0.28571, 26, 60, -34, 
1923, Illinois, 8, 0, 0, 1.00000, 136, 20, 116, 
1924, Illinois, 6, 1, 1, 0.81250, 204, 71, 133, 
1925, Illinois, 5, 3, 0, 0.62500, 98, 59, 39, 
1926, Illinois, 6, 2, 0, 0.75000, 121, 46, 75, 
1927, Illinois, 7, 0, 1, 0.93750, 152, 24, 128, 
1928, Illinois, 7, 1, 0, 0.87500, 145, 16, 129, 
1929, Illinois, 6, 1, 1, 0.81250, 155, 27, 128, 
1930, Illinois, 3, 5, 0, 0.37500, 78, 97, -19, 
1931, Illinois, 2, 6, 1, 0.27778, 58, 140, -82, 
1932, Illinois, 5, 4, 0, 0.55556, 96, 101, -5, 
1933, Illinois, 5, 3, 0, 0.62500, 77, 32, 45, 
1934, Illinois, 7, 1, 0, 0.87500, 103, 43, 60, 
1935, Illinois, 3, 5, 0, 0.37500, 59, 54, 5, 
1936, Illinois, 4, 3, 1, 0.56250, 57, 76, -19, 
1937, Illinois, 3, 3, 2, 0.50000, 59, 45, 14, 
1938, Illinois, 3, 5, 0, 0.37500, 110, 88, 22, 
1939, Illinois, 3, 4, 1, 0.43750, 75, 74, 1, 
1940, Illinois, 1, 7, 0, 0.12500, 71, 144, -73, 
1941, Illinois, 2, 6, 0, 0.25000, 112, 163, -51, 
2013, West Chester (PA), 13, 2, 0, 0.86667, 564, 325, 239, 
2009, Dubuque (IA), 5, 5, 0, 0.50000, 272, 280, -8, 
2010, Dubuque (IA), 4, 6, 0, 0.40000, 218, 216, 2, 
2011, Dubuque (IA), 9, 2, 0, 0.81818, 457, 275, 182, 
2012, Dubuque (IA), 5, 5, 0, 0.50000, 334, 302, 32, 
2013, Dubuque (IA), 5, 5, 0, 0.50000, 349, 249, 100, 
7, 
1984, Swarthmore (PA), 8, 1, 0, 0.88889, 288, 65, 223, 
1982, Eastern Michigan, 1, 6, 1, 0.18750, 66, 107, -41, 
2013, Moorhead St. (MN), 4, 7, 0, 0.36364, 350, 456, -106, 
1957, Toledo (OH), 5, 4, 0, 0.55556, 136, 147, -11, 
1958, Toledo (OH), 4, 5, 0, 0.44444, 122, 168, -46, 
1959, Toledo (OH), 2, 6, 1, 0.27778, 123, 200, -77, 
1980, Saginaw Valley St. (MI), 5, 6, 0, 0.45455, 176, 253, -77, 
1981, Saginaw Valley St. (MI), 3, 7, 0, 0.30000, 102, 219, -117, 
1982, Saginaw Valley St. (MI), 1, 9, 0, 0.10000, 94, 311, -217, 
1907, Holy Cross (MA), 1, 7, 2, 0.20000, 31, 212, -181, 
1908, Holy Cross (MA), 4, 4, 0, 0.50000, 44, 74, -30, 
1909, Holy Cross (MA), 2, 4, 2, 0.37500, 41, 43, -2, 
1910, Holy Cross (MA), 3, 3, 2, 0.50000, 54, 35, 19, 
1911, Holy Cross (MA), 4, 5, 0, 0.44444, 78, 72, 6, 
1912, Holy Cross (MA), 4, 3, 1, 0.56250, 77, 53, 24, 
1992, Butler (IN), 8, 2, 0, 0.80000, 254, 126, 128, 
1993, Butler (IN), 4, 6, 0, 0.40000, 183, 206, -23, 
1994, Butler (IN), 7, 3, 0, 0.70000, 275, 202, 73, 
1995, Butler (IN), 2, 8, 0, 0.20000, 157, 314, -157, 
1996, Butler (IN), 3, 7, 0, 0.30000, 164, 307, -143, 
1997, Butler (IN), 6, 4, 0, 0.60000, 196, 196, 0, 
1998, Butler (IN), 4, 6, 0, 0.40000, 222, 273, -51, 
1999, Butler (IN), 5, 5, 0, 0.50000, 217, 305, -88, 
2000, Butler (IN), 2, 8, 0, 0.20000, 356, 378, -22, 
2001, Butler (IN), 5, 5, 0, 0.50000, 278, 328, -50, 
1902, Carthage (WI), 2, 1, 1, 0.62500, 41, 23, 18, 
1903, Carthage (WI), 1, 1, 0, 0.50000, 5, 60, -55, 
1904, Carthage (WI), 0, 0, 2, 0.50000, 0, 0, 0, 
1992, Carthage (WI), 0, 9, 0, 0.00000, 73, 398, -325, 
1993, Carthage (WI), 1, 8, 0, 0.11111, 174, 354, -180, 
1994, Carthage (WI), 1, 8, 0, 0.11111, 103, 293, -190, 
1965, Midwestern (IA), 6, 0, 0, 1.00000, 198, 59, 139, 
1966, Midwestern (IA), 3, 4, 0, 0.42857, 164, 179, -15, 
1980, Chicago (IL), 1, 8, 0, 0.11111, 121, 208, -87, 
1981, Chicago (IL), 2, 6, 1, 0.27778, 113, 221, -108, 
1982, Chicago (IL), 0, 9, 0, 0.00000, 94, 262, -168, 
1961, Akron (OH), 6, 2, 0, 0.75000, 185, 57, 128, 
1962, Akron (OH), 7, 2, 0, 0.77778, 261, 65, 196, 
1963, Akron (OH), 6, 3, 0, 0.66667, 201, 102, 99, 
1964, Akron (OH), 6, 3, 0, 0.66667, 116, 109, 7, 
1965, Akron (OH), 5, 3, 1, 0.61111, 110, 93, 17, 
1966, Akron (OH), 6, 3, 0, 0.66667, 137, 116, 21, 
1967, Akron (OH), 4, 4, 1, 0.50000, 162, 155, 7, 
1968, Akron (OH), 7, 3, 1, 0.68182, 327, 172, 155, 
1969, Akron (OH), 9, 1, 0, 0.90000, 316, 103, 213, 
1970, Akron (OH), 7, 3, 0, 0.70000, 259, 92, 167, 
1971, Akron (OH), 8, 2, 0, 0.80000, 193, 119, 74, 
1972, Akron (OH), 3, 4, 2, 0.44444, 193, 148, 45, 
1907, Texas A&M;, 6, 1, 1, 0.81250, 125, 27, 98, 
1912, Louisville (KY), 4, 1, 0, 0.80000, 165, 47, 118, 
1913, Louisville (KY), 5, 1, 0, 0.83333, 251, 20, 231, 
1939, Navy (MD), 3, 5, 1, 0.38889, 88, 107, -19, 
1940, Navy (MD), 6, 2, 1, 0.72222, 106, 46, 60, 
1941, Navy (MD), 7, 1, 1, 0.83333, 192, 34, 158, 
1959, Arizona, 4, 6, 0, 0.40000, 118, 211, -93, 
1960, Arizona, 7, 3, 0, 0.70000, 233, 152, 81, 
1961, Arizona, 8, 1, 1, 0.85000, 288, 131, 157, 
1962, Arizona, 5, 5, 0, 0.50000, 134, 171, -37, 
1963, Arizona, 5, 5, 0, 0.50000, 136, 165, -29, 
1964, Arizona, 6, 3, 1, 0.65000, 147, 76, 71, 
1965, Arizona, 3, 7, 0, 0.30000, 77, 172, -95, 
1966, Arizona, 3, 7, 0, 0.30000, 192, 250, -58, 
1972, Dickinson St. (ND), 2, 7, 0, 0.22222, 66, 163, -97, 
1973, Dickinson St. (ND), 5, 3, 1, 0.61111, 144, 107, 37, 
1974, Dickinson St. (ND), 7, 2, 0, 0.77778, 199, 123, 76, 
1975, Dickinson St. (ND), 7, 2, 0, 0.77778, 219, 85, 134, 
1906, Henderson St. (AR), 2, 0, 1, 0.83333, 37, 10, 27, 
1976, Morgan St. (MD), 6, 4, 0, 0.60000, 240, 189, 51, 
1977, Morgan St. (MD), 4, 6, 1, 0.40909, 191, 283, -92, 
1979, North Carolina Central, 2, 8, 1, 0.22727, 129, 231, -102, 
1980, North Carolina Central, 7, 5, 0, 0.58333, 248, 233, 15, 
1981, North Carolina Central, 7, 4, 0, 0.63636, 278, 185, 93, 
1982, North Carolina Central, 7, 4, 0, 0.63636, 263, 188, 75, 
1983, North Carolina Central, 8, 1, 1, 0.85000, 240, 111, 129, 
1984, North Carolina Central, 7, 3, 0, 0.70000, 269, 172, 97, 
1985, North Carolina Central, 4, 6, 0, 0.40000, 273, 263, 10, 
1986, North Carolina Central, 6, 4, 0, 0.60000, 307, 224, 83, 
1987, North Carolina Central, 6, 5, 0, 0.54545, 223, 206, 17, 
1988, North Carolina Central, 9, 2, 1, 0.79167, 285, 229, 56, 
1989, North Carolina Central, 5, 5, 0, 0.50000, 199, 144, 55, 
1990, North Carolina Central, 3, 7, 0, 0.30000, 200, 257, -57, 
1993, Virginia Union, 2, 8, 1, 0.22727, 199, 286, -87, 
1994, Virginia Union, 1, 9, 0, 0.10000, 163, 403, -240, 
1922, Broaddus College (WV), 3, 3, 0, 0.50000, 113, 55, 58, 
2013, Juniata (PA), 7, 4, 0, 0.63636, 297, 285, 12, 
2011, Sewanee (TN), 5, 5, 0, 0.50000, 235, 195, 40, 
2012, Sewanee (TN), 3, 7, 0, 0.30000, 191, 230, -39, 
2013, Sewanee (TN), 4, 6, 0, 0.40000, 240, 265, -25, 
1963, Toledo (OH), 2, 7, 0, 0.22222, 118, 176, -58, 
1964, Toledo (OH), 2, 8, 0, 0.20000, 127, 218, -91, 
1965, Toledo (OH), 5, 5, 0, 0.50000, 104, 96, 8, 
1966, Toledo (OH), 2, 7, 1, 0.25000, 137, 162, -25, 
1967, Toledo (OH), 9, 1, 0, 0.90000, 266, 83, 183, 
1968, Toledo (OH), 5, 4, 1, 0.55000, 230, 156, 74, 
1969, Toledo (OH), 11, 0, 0, 1.00000, 385, 160, 225, 
1970, Toledo (OH), 12, 0, 0, 1.00000, 384, 88, 296, 
1971, Iowa, 1, 10, 0, 0.09091, 121, 379, -258, 
1972, Iowa, 3, 7, 1, 0.31818, 109, 208, -99, 
1973, Iowa, 0, 11, 0, 0.00000, 140, 401, -261, 
1916, Furman (SC), 4, 5, 0, 0.44444, 164, 180, -16, 
1917, Furman (SC), 3, 5, 0, 0.37500, 59, 147, -88, 
1918, Furman (SC), 3, 5, 1, 0.38889, 92, 244, -152, 
1919, Furman (SC), 6, 2, 1, 0.72222, 148, 141, 7, 
1920, Furman (SC), 9, 1, 0, 0.90000, 286, 16, 270, 
1921, Furman (SC), 7, 2, 1, 0.75000, 288, 103, 185, 
1922, Furman (SC), 8, 3, 0, 0.72727, 242, 65, 177, 
1923, Furman (SC), 9, 2, 0, 0.81818, 274, 47, 227, 
1924, Furman (SC), 5, 5, 0, 0.50000, 40, 94, -54, 
1925, Furman (SC), 7, 3, 0, 0.70000, 116, 75, 41, 
1926, Furman (SC), 8, 1, 1, 0.85000, 169, 46, 123, 
1927, Furman (SC), 10, 1, 0, 0.90909, 285, 59, 226, 
1928, South Carolina, 6, 2, 2, 0.70000, 96, 70, 26, 
1929, South Carolina, 6, 5, 0, 0.54545, 163, 174, -11, 
1930, South Carolina, 6, 4, 0, 0.60000, 108, 123, -15, 
1931, South Carolina, 5, 4, 1, 0.55000, 146, 79, 67, 
1932, South Carolina, 5, 4, 2, 0.54545, 93, 68, 25, 
1933, South Carolina, 6, 3, 1, 0.65000, 111, 91, 20, 
1934, South Carolina, 5, 4, 0, 0.55556, 96, 71, 25, 
2003, Eastern Michigan, 2, 1, 0, 0.66667, 81, 65, 16, 
2004, Delaware St., 4, 7, 0, 0.36364, 204, 352, -148, 
2005, Delaware St., 7, 4, 0, 0.63636, 225, 213, 12, 
2006, Delaware St., 8, 3, 0, 0.72727, 335, 192, 143, 
2007, Delaware St., 10, 2, 0, 0.83333, 254, 221, 33, 
2008, Delaware St., 5, 6, 0, 0.45455, 220, 228, -8, 
2009, Delaware St., 4, 7, 0, 0.36364, 178, 262, -84, 
2010, Delaware St., 3, 8, 0, 0.27273, 272, 334, -62, 
1979, Cameron (OK), 3, 7, 0, 0.30000, 200, 170, 30, 
1980, Cameron (OK), 8, 3, 0, 0.72727, 313, 198, 115, 
1928, Northern Arizona, 7, 1, 0, 0.87500, 275, 37, 238, 
1929, Northern Arizona, 5, 0, 0, 1.00000, 129, 13, 116, 
1930, Northern Arizona, 4, 2, 1, 0.64286, 113, 68, 45, 
1931, Northern Arizona, 3, 5, 0, 0.37500, 83, 126, -43, 
1932, Northern Arizona, 3, 2, 2, 0.57143, 40, 31, 9, 
1933, Arizona St., 3, 5, 0, 0.37500, 73, 125, -52, 
1934, Arizona St., 4, 3, 1, 0.56250, 91, 113, -22, 
1935, Arizona St., 2, 5, 1, 0.31250, 29, 66, -37, 
1936, Arizona St., 4, 5, 0, 0.44444, 83, 109, -26, 
1937, Arizona St., 0, 8, 1, 0.05556, 32, 140, -108, 
1945, Carthage (WI), 2, 3, 0, 0.40000, 59, 46, 13, 
1946, Carthage (WI), 0, 7, 1, 0.06250, 14, 178, -164, 
1949, Eureka (IL), 1, 7, 0, 0.12500, 77, 234, -157, 
1950, Eureka (IL), 2, 4, 1, 0.35714, 69, 98, -29, 
1951, Eureka (IL), 1, 6, 0, 0.14286, 47, 128, -81, 
1952, Eureka (IL), 1, 5, 1, 0.21429, 29, 175, -146, 
1924, Morgan St. (MD), 2, 2, 0, 0.50000, 109, 31, 78, 
1925, Morgan St. (MD), 1, 1, 1, 0.50000, 14, 40, -26, 
1926, Prairie View A&M; (TX), 4, 2, 1, 0.64286, 154, 61, 93, 
1927, Prairie View A&M; (TX), 4, 2, 1, 0.64286, 95, 39, 56, 
1928, Prairie View A&M; (TX), 5, 3, 1, 0.61111, 160, 91, 69, 
1929, Prairie View A&M; (TX), 7, 2, 2, 0.72727, 274, 40, 234, 
1930, Manhattan (NY), 4, 3, 1, 0.56250, 125, 73, 52, 
1931, Manhattan (NY), 4, 2, 1, 0.64286, 126, 59, 67, 
1895, Boston College (MA), 2, 4, 2, 0.37500, 36, 106, -70, 
1952, Nevada, 2, 3, 0, 0.40000, 111, 126, -15, 
1953, Nevada, 2, 3, 0, 0.40000, 87, 116, -29, 
1954, Nevada, 2, 5, 0, 0.28571, 81, 181, -100, 
1904, Eastern Michigan, 6, 2, 0, 0.75000, 121, 159, -38, 
1905, Eastern Michigan, 4, 4, 0, 0.50000, 81, 157, -76, 
1971, Virginia, 3, 8, 0, 0.27273, 134, 272, -138, 
1972, Virginia, 4, 7, 0, 0.36364, 199, 276, -77, 
1973, Virginia, 4, 7, 0, 0.36364, 199, 300, -101, 
1947, Bucknell (PA), 2, 7, 0, 0.22222, 57, 193, -136, 
1948, Bucknell (PA), 1, 8, 0, 0.11111, 76, 209, -133, 
1949, Bucknell (PA), 6, 2, 0, 0.75000, 215, 96, 119, 
1950, Bucknell (PA), 6, 3, 0, 0.66667, 206, 90, 116, 
1951, Bucknell (PA), 9, 0, 0, 1.00000, 339, 126, 213, 
1952, Bucknell (PA), 6, 3, 0, 0.66667, 193, 126, 67, 
1953, Bucknell (PA), 1, 8, 0, 0.11111, 119, 197, -78, 
1954, Bucknell (PA), 6, 3, 0, 0.66667, 192, 119, 73, 
1955, Bucknell (PA), 2, 6, 1, 0.27778, 147, 236, -89, 
1956, Bucknell (PA), 3, 5, 0, 0.37500, 97, 134, -37, 
1957, Bucknell (PA), 3, 6, 0, 0.33333, 74, 188, -114, 
1935, Allegheny (PA), 2, 6, 0, 0.25000, 19, 121, -102, 
1936, Allegheny (PA), 1, 3, 2, 0.33333, 21, 39, -18, 
1937, Allegheny (PA), 5, 2, 0, 0.71429, 81, 70, 11, 
1938, Allegheny (PA), 3, 4, 0, 0.42857, 45, 126, -81, 
1939, Allegheny (PA), 0, 5, 2, 0.14286, 26, 113, -87, 
1940, Allegheny (PA), 0, 7, 0, 0.00000, 12, 201, -189, 
1975, Stonehill (MA), 4, 4, 0, 0.50000, 126, 125, 1, 
1976, Stonehill (MA), 4, 5, 0, 0.44444, 160, 158, 2, 
1977, Stonehill (MA), 3, 6, 0, 0.33333, 134, 140, -6, 
1978, Stonehill (MA), 3, 5, 1, 0.38889, 90, 123, -33, 
1979, Stonehill (MA), 5, 4, 0, 0.55556, 105, 130, -25, 
1980, Stonehill (MA), 7, 3, 0, 0.70000, 157, 104, 53, 
1925, Jackson St. (MS), 0, 1, 0, 0.00000, 0, 19, -19, 
1926, Jackson St. (MS), 0, 1, 0, 0.00000, 0, 14, -14, 
1928, Jackson St. (MS), 0, 1, 0, 0.00000, 0, 21, -21, 
1913, Detroit (MI), 5, 3, 1, 0.61111, 166, 85, 81, 
1914, Detroit (MI), 2, 3, 2, 0.42857, 27, 106, -79, 
1919, Northern Arizona, 1, 1, 0, 0.50000, 32, 6, 26, 
1980, William & Mary (VA), 2, 9, 0, 0.18182, 117, 254, -137, 
1981, William & Mary (VA), 5, 6, 0, 0.45455, 192, 278, -86, 
1982, William & Mary (VA), 3, 8, 0, 0.27273, 204, 333, -129, 
1983, William & Mary (VA), 6, 5, 0, 0.54545, 259, 320, -61, 
1984, William & Mary (VA), 6, 5, 0, 0.54545, 261, 285, -24, 
1985, William & Mary (VA), 7, 4, 0, 0.63636, 276, 287, -11, 
1986, William & Mary (VA), 9, 3, 0, 0.75000, 352, 297, 55, 
1987, William & Mary (VA), 5, 6, 0, 0.45455, 233, 272, -39, 
1988, William & Mary (VA), 7, 4, 1, 0.62500, 333, 233, 100, 
1989, William & Mary (VA), 8, 3, 1, 0.70833, 286, 261, 25, 
1990, William & Mary (VA), 10, 3, 0, 0.76923, 467, 322, 145, 
1991, William & Mary (VA), 5, 6, 0, 0.45455, 343, 320, 23, 
1992, William & Mary (VA), 10, 2, 0, 0.83333, 363, 224, 139, 
1993, William & Mary (VA), 9, 3, 0, 0.75000, 442, 240, 202, 
1994, William & Mary (VA), 8, 3, 0, 0.72727, 274, 210, 64, 
1995, William & Mary (VA), 7, 4, 0, 0.63636, 276, 184, 92, 
1996, William & Mary (VA), 10, 3, 0, 0.76923, 394, 214, 180, 
1997, William & Mary (VA), 7, 4, 0, 0.63636, 254, 203, 51, 
1998, William & Mary (VA), 7, 4, 0, 0.63636, 346, 315, 31, 
1999, William & Mary (VA), 6, 5, 0, 0.54545, 292, 266, 26, 
2000, William & Mary (VA), 5, 6, 0, 0.45455, 268, 314, -46, 
2001, William & Mary (VA), 8, 4, 0, 0.66667, 362, 295, 67, 
2002, William & Mary (VA), 6, 5, 0, 0.54545, 326, 284, 42, 
2003, William & Mary (VA), 5, 5, 0, 0.50000, 287, 299, -12, 
2004, William & Mary (VA), 11, 3, 0, 0.78571, 486, 373, 113, 
2005, William & Mary (VA), 5, 6, 0, 0.45455, 358, 283, 75, 
2006, William & Mary (VA), 3, 8, 0, 0.27273, 209, 283, -74, 
2007, William & Mary (VA), 4, 7, 0, 0.36364, 319, 427, -108, 
2008, William & Mary (VA), 7, 4, 0, 0.63636, 361, 264, 97, 
2009, William & Mary (VA), 11, 3, 0, 0.78571, 366, 169, 197, 
2010, William & Mary (VA), 8, 4, 0, 0.66667, 297, 200, 97, 
2011, William & Mary (VA), 5, 6, 0, 0.45455, 202, 244, -42, 
2012, William & Mary (VA), 2, 9, 0, 0.18182, 233, 267, -34, 
2013, William & Mary (VA), 7, 5, 0, 0.58333, 252, 168, 84, 
1927, Duquesne (PA), 4, 4, 1, 0.50000, 82, 78, 4, 
1928, Duquesne (PA), 8, 1, 0, 0.88889, 118, 32, 86, 
1929, Duquesne (PA), 9, 0, 1, 0.95000, 154, 53, 101, 
1930, Duquesne (PA), 7, 3, 0, 0.70000, 131, 56, 75, 
1931, Duquesne (PA), 3, 5, 3, 0.40909, 56, 85, -29, 
1932, Duquesne (PA), 7, 2, 1, 0.75000, 132, 58, 74, 
1933, Duquesne (PA), 10, 1, 0, 0.90909, 206, 33, 173, 
1934, Notre Dame (IN), 6, 3, 0, 0.66667, 108, 56, 52, 
1935, Notre Dame (IN), 7, 1, 1, 0.83333, 143, 62, 81, 
1936, Notre Dame (IN), 6, 2, 1, 0.72222, 128, 69, 59, 
1937, Notre Dame (IN), 6, 2, 1, 0.72222, 77, 49, 28, 
1938, Notre Dame (IN), 8, 1, 0, 0.88889, 149, 39, 110, 
1939, Notre Dame (IN), 7, 2, 0, 0.77778, 100, 73, 27, 
1940, Notre Dame (IN), 7, 2, 0, 0.77778, 168, 67, 101, 
1950, Chowan (NC), 5, 1, 0, 0.83333, 112, 45, 67, 
1900, Michigan, 7, 2, 1, 0.75000, 117, 55, 62, 
1901, Princeton (NJ), 9, 1, 1, 0.86364, 247, 24, 223, 
1967, Ferris St. (MI), 0, 7, 1, 0.06250, 66, 153, -87, 
1968, Ferris St. (MI), 7, 0, 1, 0.93750, 171, 95, 76, 
1969, Ferris St. (MI), 5, 4, 0, 0.55556, 127, 109, 18, 
1970, Ferris St. (MI), 5, 4, 0, 0.55556, 141, 100, 41, 
2000, Texas Tech, 7, 6, 0, 0.53846, 330, 278, 52, 
2001, Texas Tech, 7, 5, 0, 0.58333, 402, 281, 121, 
2002, Texas Tech, 9, 5, 0, 0.64286, 537, 439, 98, 
2003, Texas Tech, 8, 5, 0, 0.61538, 552, 442, 110, 
2004, Texas Tech, 8, 4, 0, 0.66667, 434, 314, 120, 
2005, Texas Tech, 9, 3, 0, 0.75000, 473, 226, 247, 
2006, Texas Tech, 8, 5, 0, 0.61538, 422, 326, 96, 
2007, Texas Tech, 9, 4, 0, 0.69231, 532, 337, 195, 
2008, Texas Tech, 11, 2, 0, 0.84615, 569, 362, 207, 
2009, Texas Tech, 8, 4, 0, 0.66667, 440, 261, 179, 
2012, Washington St., 3, 9, 0, 0.25000, 245, 404, -159, 
2013, Washington St., 6, 7, 0, 0.46154, 403, 423, -20, 
1939, Boston College (MA), 9, 2, 0, 0.81818, 219, 46, 173, 
1940, Boston College (MA), 11, 0, 0, 1.00000, 339, 65, 274, 
1941, Notre Dame (IN), 8, 0, 1, 0.94444, 189, 64, 125, 
1942, Notre Dame (IN), 7, 2, 2, 0.72727, 184, 99, 85, 
1943, Notre Dame (IN), 9, 1, 0, 0.90000, 340, 69, 271, 
1946, Notre Dame (IN), 8, 0, 1, 0.94444, 271, 24, 247, 
1947, Notre Dame (IN), 9, 0, 0, 1.00000, 291, 52, 239, 
1948, Notre Dame (IN), 9, 0, 1, 0.95000, 320, 93, 227, 
1949, Notre Dame (IN), 10, 0, 0, 1.00000, 360, 86, 274, 
1950, Notre Dame (IN), 4, 4, 1, 0.50000, 139, 140, -1, 
1951, Notre Dame (IN), 7, 2, 1, 0.75000, 241, 122, 119, 
1952, Notre Dame (IN), 7, 2, 1, 0.75000, 183, 108, 75, 
1953, Notre Dame (IN), 9, 0, 1, 0.95000, 317, 139, 178, 
1944, Alma (MI), 0, 6, 0, 0.00000, 57, 163, -106, 
1945, Alma (MI), 1, 6, 0, 0.14286, 39, 144, -105, 
1895, Tulsa (OK), 1, 0, 0, 1.00000, 1, 0, 1, 
1896, Tulsa (OK), 2, 1, 0, 0.66667, 2, 6, -4, 
1897, Tulsa (OK), 2, 1, 0, 0.66667, 2, 1, 1, 
1905, Alabama, 6, 4, 0, 0.60000, 178, 113, 65, 
1997, South Florida, 5, 6, 0, 0.45455, 307, 181, 126, 
1998, South Florida, 8, 3, 0, 0.72727, 402, 178, 224, 
1999, South Florida, 7, 4, 0, 0.63636, 246, 248, -2, 
2000, South Florida, 7, 4, 0, 0.63636, 278, 201, 77, 
2001, South Florida, 8, 3, 0, 0.72727, 387, 231, 156, 
2002, South Florida, 9, 2, 0, 0.81818, 339, 204, 135, 
2003, South Florida, 7, 4, 0, 0.63636, 276, 224, 52, 
2004, South Florida, 4, 7, 0, 0.36364, 271, 351, -80, 
2005, South Florida, 6, 6, 0, 0.50000, 276, 216, 60, 
2006, South Florida, 9, 4, 0, 0.69231, 299, 220, 79, 
2007, South Florida, 9, 4, 0, 0.69231, 451, 304, 147, 
2008, South Florida, 8, 5, 0, 0.61538, 359, 260, 99, 
2009, South Florida, 8, 5, 0, 0.61538, 344, 257, 87, 
1946, Lehigh (PA), 2, 6, 0, 0.25000, 53, 147, -94, 
1947, Lehigh (PA), 5, 4, 0, 0.55556, 111, 122, -11, 
1948, Lehigh (PA), 5, 4, 0, 0.55556, 191, 128, 63, 
1949, Lehigh (PA), 6, 3, 0, 0.66667, 255, 182, 73, 
1950, Lehigh (PA), 9, 0, 0, 1.00000, 301, 77, 224, 
1951, Lehigh (PA), 7, 2, 0, 0.77778, 151, 102, 49, 
1952, Lehigh (PA), 5, 4, 0, 0.55556, 146, 114, 32, 
1953, Lehigh (PA), 4, 5, 0, 0.44444, 138, 166, -28, 
1954, Lehigh (PA), 2, 5, 2, 0.33333, 159, 228, -69, 
1955, Lehigh (PA), 7, 2, 0, 0.77778, 217, 147, 70, 
1956, Lehigh (PA), 7, 2, 0, 0.77778, 206, 127, 79, 
1957, Lehigh (PA), 8, 1, 0, 0.88889, 206, 72, 134, 
1958, Lehigh (PA), 3, 3, 3, 0.50000, 164, 154, 10, 
1959, Lehigh (PA), 4, 5, 0, 0.44444, 131, 97, 34, 
1960, Lehigh (PA), 4, 5, 0, 0.44444, 182, 139, 43, 
1961, Lehigh (PA), 7, 2, 0, 0.77778, 146, 118, 28, 
1920, Ashland (OH), 2, 3, 0, 0.40000, 39, 115, -76, 
1982, Westfield St. (MA), 2, 7, 0, 0.22222, 61, 237, -176, 
1993, American International (MA), 3, 7, 0, 0.30000, 130, 308, -178, 
1945, Indiana St., 2, 4, 0, 0.33333, 84, 104, -20, 
1972, Norfolk St. (VA), 3, 7, 0, 0.30000, 189, 266, -77, 
1973, Norfolk St. (VA), 5, 5, 0, 0.50000, 217, 166, 51, 
1957, Samford (AL), 4, 5, 0, 0.44444, 130, 193, -63, 
1958, Samford (AL), 1, 5, 1, 0.21429, 75, 109, -34, 
2009, North Carolina A&T;, 5, 6, 0, 0.45455, 166, 208, -42, 
2010, North Carolina A&T;, 1, 10, 0, 0.09091, 203, 370, -167, 
1968, Albany St. (GA), 2, 6, 0, 0.25000, 110, 195, -85, 
1969, Albany St. (GA), 3, 6, 0, 0.33333, 97, 197, -100, 
1948, Houston (TX), 5, 6, 0, 0.45455, 149, 182, -33, 
1949, Houston (TX), 5, 4, 1, 0.55000, 229, 169, 60, 
1950, Houston (TX), 4, 6, 0, 0.40000, 233, 190, 43, 
1951, Houston (TX), 6, 5, 0, 0.54545, 247, 228, 19, 
1952, Houston (TX), 8, 2, 0, 0.80000, 180, 80, 100, 
1953, Houston (TX), 4, 4, 1, 0.50000, 189, 185, 4, 
1954, Houston (TX), 5, 5, 0, 0.50000, 125, 203, -78, 
1989, Texas-El Paso, 2, 10, 0, 0.16667, 238, 412, -174, 
1990, Texas-El Paso, 3, 8, 0, 0.27273, 191, 342, -151, 
1991, Texas-El Paso, 4, 7, 1, 0.37500, 254, 252, 2, 
1992, Texas-El Paso, 1, 10, 0, 0.09091, 254, 386, -132, 
1993, Texas-El Paso, 1, 6, 0, 0.14286, 155, 254, -99, 
2006, Belhaven (MS), 6, 5, 0, 0.54545, 333, 326, 7, 
2007, Belhaven (MS), 5, 6, 0, 0.45455, 373, 410, -37, 
2008, Belhaven (MS), 2, 9, 0, 0.18182, 240, 407, -167, 
2012, Concordia College (AL), 3, 3, 0, 0.50000, 146, 124, 22, 
2013, Concordia College (AL), 1, 9, 0, 0.10000, 125, 526, -401, 
1929, Buffalo (NY), 5, 2, 0, 0.71429, 92, 74, 18, 
1930, Buffalo (NY), 3, 5, 0, 0.37500, 79, 210, -131, 
1891, Fordham (NY), 1, 2, 1, 0.37500, 12, 50, -38, 
1893, Fordham (NY), 4, 0, 0, 1.00000, 168, 0, 168, 
1992, Johnson C. Smith (NC), 5, 5, 0, 0.50000, 155, 195, -40, 
1993, Johnson C. Smith (NC), 3, 8, 0, 0.27273, 121, 318, -197, 
1994, Johnson C. Smith (NC), 0, 10, 0, 0.00000, 195, 375, -180, 
1962, Southern (LA), 5, 5, 0, 0.50000, 130, 128, 2, 
1963, Southern (LA), 7, 3, 0, 0.70000, 168, 159, 9, 
1964, Southern (LA), 4, 6, 0, 0.40000, 178, 203, -25, 
1922, Oklahoma Baptist University, 3, 7, 0, 0.30000, 97, 321, -224, 
1998, Chowan (NC), 5, 5, 0, 0.50000, 206, 223, -17, 
1999, Chowan (NC), 5, 4, 0, 0.55556, 206, 212, -6, 
2000, Chowan (NC), 2, 7, 0, 0.22222, 126, 217, -91, 
1974, Willamette (OR), 8, 2, 0, 0.80000, 154, 99, 55, 
1975, Willamette (OR), 5, 5, 0, 0.50000, 163, 164, -1, 
1976, Willamette (OR), 5, 4, 1, 0.55000, 196, 245, -49, 
1977, Willamette (OR), 6, 4, 0, 0.60000, 122, 140, -18, 
1978, Willamette (OR), 2, 7, 0, 0.22222, 100, 155, -55, 
1979, Willamette (OR), 3, 6, 0, 0.33333, 145, 205, -60, 
1980, Willamette (OR), 4, 4, 1, 0.50000, 163, 242, -79, 
1981, Willamette (OR), 4, 5, 0, 0.44444, 189, 200, -11, 
1964, Eastern New Mexico, 4, 5, 0, 0.44444, 233, 154, 79, 
1965, Eastern New Mexico, 3, 6, 1, 0.35000, 215, 264, -49, 
1966, Eastern New Mexico, 2, 7, 0, 0.22222, 121, 165, -44, 
1975, Hofstra (NY), 3, 6, 0, 0.33333, 132, 149, -17, 
1976, Hofstra (NY), 4, 4, 0, 0.50000, 117, 150, -33, 
1977, Hofstra (NY), 6, 3, 0, 0.66667, 157, 133, 24, 
1978, Hofstra (NY), 4, 5, 0, 0.44444, 146, 195, -49, 
1979, Hofstra (NY), 5, 3, 1, 0.61111, 194, 226, -32, 
1980, Hofstra (NY), 8, 2, 0, 0.80000, 288, 227, 61, 
1921, Shepherd (WV), 1, 5, 1, 0.21429, 25, 216, -191, 
1922, Shepherd (WV), 7, 3, 0, 0.70000, 150, 95, 55, 
1923, Shepherd (WV), 4, 4, 1, 0.50000, 93, 236, -143, 
1924, Shepherd (WV), 4, 3, 0, 0.57143, 141, 101, 40, 
1957, Portland St. (OR), 2, 6, 0, 0.25000, 88, 139, -51, 
1958, Portland St. (OR), 4, 5, 0, 0.44444, 134, 193, -59, 
1959, Adrian (MI), 2, 6, 0, 0.25000, 50, 184, -134, 
1960, Adrian (MI), 5, 2, 1, 0.68750, 62, 127, -65, 
1961, Adrian (MI), 2, 6, 0, 0.25000, 71, 136, -65, 
1977, Brooklyn (NY), 7, 2, 0, 0.77778, 163, 80, 83, 
1978, Brooklyn (NY), 5, 4, 0, 0.55556, 194, 163, 31, 
1979, Brooklyn (NY), 1, 8, 0, 0.11111, 58, 261, -203, 
1898, Northern Iowa, 4, 0, 1, 0.90000, 92, 5, 87, 
1998, Fort Hays St. (KS), 6, 5, 0, 0.54545, 286, 267, 19, 
1999, Fort Hays St. (KS), 2, 9, 0, 0.18182, 179, 273, -94, 
2000, Fort Hays St. (KS), 5, 5, 0, 0.50000, 231, 203, 28, 
1913, Western Kentucky, 1, 0, 0, 1.00000, 20, 0, 20, 
2013, Wisconsin-Whitewater, 15, 0, 0, 1.00000, 553, 136, 417, 
1911, Adrian (MI), 7, 1, 0, 0.87500, 115, 15, 100, 
1912, Adrian (MI), 5, 3, 0, 0.62500, 136, 169, -33, 
1901, Denver (CO), 0, 4, 0, 0.00000, 11, 105, -94, 
2001, Lehigh (PA), 11, 1, 0, 0.91667, 427, 216, 211, 
2002, Lehigh (PA), 8, 4, 0, 0.66667, 319, 216, 103, 
2003, Lehigh (PA), 8, 3, 0, 0.72727, 330, 185, 145, 
2004, Lehigh (PA), 9, 3, 0, 0.75000, 345, 193, 152, 
2005, Lehigh (PA), 8, 3, 0, 0.72727, 399, 228, 171, 
2006, Elon (NC), 5, 6, 0, 0.45455, 253, 256, -3, 
2007, Elon (NC), 7, 4, 0, 0.63636, 400, 334, 66, 
2008, Elon (NC), 8, 4, 0, 0.66667, 323, 256, 67, 
2009, Elon (NC), 9, 3, 0, 0.75000, 365, 158, 207, 
2010, Elon (NC), 6, 5, 0, 0.54545, 351, 303, 48, 
2011, Ball St. (IN), 6, 6, 0, 0.50000, 304, 416, -112, 
2012, Ball St. (IN), 9, 4, 0, 0.69231, 437, 416, 21, 
2013, Ball St. (IN), 10, 3, 0, 0.76923, 501, 321, 180, 
1952, Lake Forest (IL), 6, 1, 1, 0.81250, 190, 74, 116, 
1953, Lake Forest (IL), 5, 3, 0, 0.62500, 153, 141, 12, 
1954, Montana St., 4, 5, 0, 0.44444, 229, 105, 124, 
1955, Montana St., 4, 4, 1, 0.50000, 109, 120, -11, 
1957, Lake Forest (IL), 6, 2, 0, 0.75000, 137, 79, 58, 
2005, Central St. (OH), 1, 5, 0, 0.16667, 54, 166, -112, 
2006, Savannah St. (GA), 3, 8, 0, 0.27273, 108, 379, -271, 
2007, Savannah St. (GA), 1, 9, 0, 0.10000, 84, 343, -259, 
1971, Marshall (WV), 2, 8, 0, 0.20000, 57, 299, -242, 
1972, Marshall (WV), 2, 8, 0, 0.20000, 93, 254, -161, 
1973, Marshall (WV), 4, 7, 0, 0.36364, 212, 288, -76, 
1974, Marshall (WV), 1, 10, 0, 0.09091, 111, 291, -180, 
1997, Mary (ND), 4, 6, 0, 0.40000, 246, 219, 27, 
1998, Mary (ND), 8, 3, 0, 0.72727, 343, 202, 141, 
1999, North Dakota, 9, 2, 0, 0.81818, 272, 131, 141, 
2000, North Dakota, 8, 3, 0, 0.72727, 404, 146, 258, 
2001, North Dakota, 14, 1, 0, 0.93333, 475, 183, 292, 
2002, North Dakota, 6, 5, 0, 0.54545, 295, 211, 84, 
2003, North Dakota, 12, 2, 0, 0.85714, 428, 268, 160, 
2004, North Dakota, 11, 3, 0, 0.78571, 384, 171, 213, 
2005, North Dakota, 10, 3, 0, 0.76923, 450, 172, 278, 
2006, North Dakota, 11, 2, 0, 0.84615, 411, 244, 167, 
2007, North Dakota, 10, 2, 0, 0.83333, 465, 220, 245, 
2008, Southern Illinois, 9, 3, 0, 0.75000, 353, 256, 97, 
2009, Southern Illinois, 11, 2, 0, 0.84615, 442, 207, 235, 
2010, Southern Illinois, 5, 6, 0, 0.45455, 331, 285, 46, 
2011, Southern Illinois, 4, 7, 0, 0.36364, 283, 297, -14, 
2012, Southern Illinois, 6, 5, 0, 0.54545, 247, 214, 33, 
2013, Southern Illinois, 7, 5, 0, 0.58333, 342, 302, 40, 
1994, Miles (AL), 2, 6, 1, 0.27778, 134, 287, -153, 
1995, Miles (AL), 4, 6, 0, 0.40000, 200, 274, -74, 
1996, Miles (AL), 6, 4, 0, 0.60000, 245, 227, 18, 
1997, Miles (AL), 4, 6, 0, 0.40000, 260, 242, 18, 
1998, Miles (AL), 4, 6, 0, 0.40000, 195, 255, -60, 
1999, Miles (AL), 3, 7, 0, 0.30000, 138, 216, -78, 
2000, Miles (AL), 4, 6, 0, 0.40000, 186, 186, 0, 
1997, Delaware Valley (PA), 5, 5, 0, 0.50000, 231, 298, -67, 
1998, Delaware Valley (PA), 3, 7, 0, 0.30000, 174, 224, -50, 
1999, Delaware Valley (PA), 2, 8, 0, 0.20000, 134, 327, -193, 
1907, Hendrix (AR), 2, 4, 0, 0.33333, 133, 95, 38, 
1908, Hendrix (AR), 2, 3, 0, 0.40000, 45, 162, -117, 
1938, Saint Francis (PA), 1, 6, 0, 0.14286, 7, 91, -84, 
1939, Saint Francis (PA), 0, 7, 1, 0.06250, 40, 164, -124, 
1940, Saint Francis (PA), 6, 2, 0, 0.75000, 175, 51, 124, 
1941, Saint Francis (PA), 6, 0, 1, 0.92857, 182, 79, 103, 
1947, Saint Francis (PA), 4, 1, 0, 0.80000, 121, 19, 102, 
1949, Villanova (PA), 8, 1, 0, 0.88889, 265, 103, 162, 
1950, Villanova (PA), 4, 5, 0, 0.44444, 141, 166, -25, 
2013, Franklin (IN), 8, 4, 0, 0.66667, 506, 225, 281, 
1954, Arkansas-Monticello, 4, 4, 0, 0.50000, 121, 116, 5, 
1955, Arkansas-Monticello, 7, 2, 0, 0.77778, 205, 90, 115, 
1956, Arkansas-Monticello, 7, 1, 1, 0.83333, 175, 79, 96, 
1957, Arkansas-Monticello, 9, 2, 0, 0.81818, 292, 73, 219, 
1958, Arkansas-Monticello, 7, 2, 0, 0.77778, 176, 93, 83, 
1969, Maryland, 3, 7, 0, 0.30000, 100, 249, -149, 
1970, Maryland, 2, 9, 0, 0.18182, 112, 241, -129, 
1971, Maryland, 2, 9, 0, 0.18182, 224, 283, -59, 
1967, Pittsburg St. (KS), 6, 2, 1, 0.72222, 158, 96, 62, 
1968, Pittsburg St. (KS), 4, 5, 1, 0.45000, 140, 148, -8, 
1969, Pittsburg St. (KS), 5, 5, 0, 0.50000, 293, 238, 55, 
1970, Pittsburg St. (KS), 9, 2, 0, 0.81818, 419, 207, 212, 
1971, Pittsburg St. (KS), 8, 1, 1, 0.85000, 218, 104, 114, 
1972, Pittsburg St. (KS), 5, 5, 0, 0.50000, 156, 177, -21, 
1973, Pittsburg St. (KS), 3, 7, 0, 0.30000, 87, 205, -118, 
1974, Pittsburg St. (KS), 4, 7, 0, 0.36364, 130, 203, -73, 
1975, Pittsburg St. (KS), 4, 4, 2, 0.50000, 154, 141, 13, 
1911, Citadel (SC), 5, 2, 2, 0.66667, 73, 46, 27, 
1912, Citadel (SC), 3, 4, 0, 0.42857, 139, 131, 8, 
1907, Tennessee, 7, 2, 1, 0.75000, 169, 17, 152, 
1908, Tennessee, 7, 2, 0, 0.77778, 124, 41, 83, 
1909, Tennessee, 1, 6, 2, 0.22222, 11, 113, -102, 
1922, Wake Forest (NC), 3, 5, 2, 0.40000, 62, 144, -82, 
1911, Texas Christian, 4, 5, 0, 0.44444, 114, 106, 8, 
1908, Davidson (NC), 5, 3, 1, 0.61111, 120, 39, 81, 
1965, Marist (NY), 3, 3, 0, 0.50000, 77, 94, -17, 
2011, Houston (TX), 1, 0, 0, 1.00000, 30, 14, 16, 
2012, Houston (TX), 5, 7, 0, 0.41667, 389, 432, -43, 
2013, Houston (TX), 8, 5, 0, 0.61538, 431, 283, 148, 
1971, Stephen F. Austin (TX), 2, 8, 0, 0.20000, 207, 275, -68, 
1972, Stephen F. Austin (TX), 2, 7, 0, 0.22222, 187, 209, -22, 
1973, Stephen F. Austin (TX), 9, 3, 0, 0.75000, 319, 243, 76, 
1974, Stephen F. Austin (TX), 9, 2, 0, 0.81818, 244, 190, 54, 
1958, New Mexico, 7, 3, 0, 0.70000, 210, 185, 25, 
1959, New Mexico, 7, 3, 0, 0.70000, 260, 135, 125, 
1960, California, 2, 7, 1, 0.25000, 93, 195, -102, 
1961, California, 1, 8, 1, 0.15000, 118, 268, -150, 
1962, California, 1, 9, 0, 0.10000, 143, 247, -104, 
1963, California, 4, 5, 1, 0.45000, 195, 213, -18, 
1964, William & Mary (VA), 4, 6, 0, 0.40000, 138, 194, -56, 
1965, William & Mary (VA), 6, 4, 0, 0.60000, 197, 163, 34, 
1966, William & Mary (VA), 5, 4, 1, 0.55000, 176, 144, 32, 
1967, William & Mary (VA), 5, 4, 1, 0.55000, 196, 177, 19, 
1968, William & Mary (VA), 3, 7, 0, 0.30000, 97, 195, -98, 
1943, Nebraska, 2, 6, 0, 0.25000, 79, 261, -182, 
1944, Nebraska, 2, 6, 0, 0.25000, 83, 210, -127, 
1943, Indiana St., 0, 5, 1, 0.08333, 13, 119, -106, 
1950, West Virginia, 2, 8, 0, 0.20000, 163, 259, -96, 
1951, West Virginia, 5, 5, 0, 0.50000, 225, 190, 35, 
1952, West Virginia, 7, 2, 0, 0.77778, 234, 116, 118, 
1953, West Virginia, 8, 2, 0, 0.80000, 309, 154, 155, 
1954, West Virginia, 8, 1, 0, 0.88889, 209, 74, 135, 
1955, West Virginia, 8, 2, 0, 0.80000, 285, 104, 181, 
1956, West Virginia, 6, 4, 0, 0.60000, 130, 106, 24, 
1957, West Virginia, 7, 2, 1, 0.75000, 179, 118, 61, 
1958, West Virginia, 4, 5, 1, 0.45000, 268, 200, 68, 
1959, West Virginia, 3, 7, 0, 0.30000, 74, 204, -130, 
1977, Wyoming, 4, 6, 1, 0.40909, 166, 273, -107, 
1978, Wyoming, 5, 7, 0, 0.41667, 253, 245, 8, 
1979, Wyoming, 4, 8, 0, 0.33333, 186, 276, -90, 
1989, East Carolina (NC), 6, 5, 0, 0.54545, 301, 286, 15, 
1990, East Carolina (NC), 5, 6, 0, 0.45455, 254, 267, -13, 
1991, East Carolina (NC), 11, 1, 0, 0.91667, 409, 277, 132, 
1992, Georgia Tech, 5, 6, 0, 0.45455, 237, 286, -49, 
1993, Georgia Tech, 5, 6, 0, 0.45455, 260, 286, -26, 
1994, Georgia Tech, 1, 7, 0, 0.12500, 152, 231, -79, 
1915, Tuskegee (AL), 1, 2, 2, 0.40000, 19, 73, -54, 
1916, Tuskegee (AL), 4, 2, 0, 0.66667, 91, 29, 62, 
1906, Allegheny (PA), 2, 7, 0, 0.22222, 33, 185, -152, 
1947, Central St. (OH), 9, 2, 0, 0.81818, 305, 74, 231, 
1948, Central St. (OH), 8, 1, 1, 0.85000, 196, 61, 135, 
1949, Central St. (OH), 5, 4, 0, 0.55556, 209, 117, 92, 
1950, Central St. (OH), 6, 4, 0, 0.60000, 170, 104, 66, 
1951, Central St. (OH), 7, 2, 0, 0.77778, 210, 81, 129, 
1952, Central St. (OH), 4, 4, 0, 0.50000, 141, 118, 23, 
1953, Central St. (OH), 1, 5, 0, 0.16667, 72, 154, -82, 
1954, Central St. (OH), 4, 4, 0, 0.50000, 142, 125, 17, 
1955, Central St. (OH), 4, 4, 0, 0.50000, 143, 120, 23, 
1956, Central St. (OH), 4, 3, 1, 0.56250, 124, 120, 4, 
1896, Maryland, 8, 1, 2, 0.81818, 132, 34, 98, 
1897, Maryland, 2, 4, 0, 0.33333, 44, 68, -24, 
1928, Alabama St., 5, 4, 1, 0.55000, 117, 79, 38, 
1929, Alabama St., 4, 2, 3, 0.61111, 136, 46, 90, 
1930, Alabama St., 6, 5, 0, 0.54545, 170, 132, 38, 
1931, Alabama St., 8, 3, 0, 0.72727, 239, 116, 123, 
1932, Alabama St., 7, 1, 1, 0.83333, 73, 32, 41, 
1933, Alabama St., 6, 2, 1, 0.72222, 117, 38, 79, 
1910, Texas Christian, 2, 6, 1, 0.27778, 45, 187, -142, 
1999, Idaho St., 4, 7, 0, 0.36364, 345, 429, -84, 
2000, Idaho St., 6, 5, 0, 0.54545, 329, 351, -22, 
2001, Idaho St., 4, 7, 0, 0.36364, 331, 333, -2, 
2002, Idaho St., 8, 3, 0, 0.72727, 331, 188, 143, 
2003, Idaho St., 8, 4, 0, 0.66667, 394, 423, -29, 
2004, Idaho St., 3, 8, 0, 0.27273, 266, 357, -91, 
2005, Idaho St., 5, 6, 0, 0.45455, 298, 304, -6, 
2006, Idaho St., 2, 9, 0, 0.18182, 255, 330, -75, 
1932, San Francisco (CA), 2, 6, 0, 0.25000, 77, 90, -13, 
1933, San Francisco (CA), 1, 6, 1, 0.18750, 42, 74, -32, 
1934, San Francisco (CA), 3, 3, 1, 0.50000, 47, 16, 31, 
1935, San Francisco (CA), 5, 3, 0, 0.62500, 104, 55, 49, 
1993, Southwestern (KS), 4, 5, 0, 0.44444, 238, 247, -9, 
1994, Southwestern (KS), 6, 4, 0, 0.60000, 361, 311, 50, 
1995, Southwestern (KS), 6, 4, 0, 0.60000, 289, 278, 11, 
1996, Southwestern (KS), 7, 3, 0, 0.70000, 350, 204, 146, 
1997, Southwestern (KS), 8, 3, 0, 0.72727, 347, 217, 130, 
1998, Southwestern (KS), 9, 2, 0, 0.81818, 433, 224, 209, 
1999, Southwestern (KS), 8, 3, 0, 0.72727, 276, 231, 45, 
2000, Southwestern (KS), 6, 4, 0, 0.60000, 292, 151, 141, 
2001, Southwestern (KS), 6, 4, 0, 0.60000, 358, 266, 92, 
2013, Friends (KS), 8, 3, 0, 0.72727, 360, 205, 155, 
1934, Alabama St., 4, 4, 2, 0.50000, 101, 72, 29, 
1935, Alabama St., 10, 2, 1, 0.80769, 157, 82, 75, 
1936, Alabama St., 5, 2, 3, 0.65000, 79, 24, 55, 
1937, Alabama St., 3, 7, 0, 0.30000, 76, 160, -84, 
1938, Alabama St., 4, 4, 1, 0.50000, 99, 74, 25, 
1939, Alabama St., 6, 2, 2, 0.70000, 92, 51, 41, 
1940, Alabama St., 7, 4, 0, 0.63636, 176, 94, 82, 
1941, Alabama St., 4, 5, 0, 0.44444, 98, 161, -63, 
1942, Alabama St., 0, 8, 0, 0.00000, 25, 197, -172, 
1921, Abilene Christian (TX), 2, 5, 0, 0.28571, 44, 173, -129, 
1925, South Carolina St., 0, 4, 0, 0.00000, 0, 67, -67, 
1926, South Carolina St., 6, 1, 0, 0.85714, 228, 10, 218, 
2011, Becker College (MA), 1, 9, 0, 0.10000, 186, 352, -166, 
2012, Becker College (MA), 3, 7, 0, 0.30000, 203, 326, -123, 
2013, Becker College (MA), 3, 7, 0, 0.30000, 191, 279, -88, 
1979, Morehead St. (KY), 5, 4, 1, 0.55000, 96, 121, -25, 
1980, Morehead St. (KY), 4, 7, 0, 0.36364, 178, 229, -51, 
1989, Maine, 9, 3, 0, 0.75000, 433, 232, 201, 
1990, Ohio, 1, 9, 1, 0.13636, 162, 342, -180, 
1991, Ohio, 2, 8, 1, 0.22727, 176, 308, -132, 
1992, Ohio, 1, 10, 0, 0.09091, 145, 253, -108, 
1993, Ohio, 4, 7, 0, 0.36364, 134, 282, -148, 
1994, Ohio, 0, 11, 0, 0.00000, 82, 259, -177, 
1930, Loyola Marymount (CA), 2, 3, 1, 0.41667, 21, 62, -41, 
1931, Loyola Marymount (CA), 7, 2, 1, 0.75000, 116, 45, 71, 
1932, Loyola Marymount (CA), 4, 4, 0, 0.50000, 135, 71, 64, 
1933, Loyola Marymount (CA), 7, 2, 1, 0.75000, 178, 71, 107, 
1934, Loyola Marymount (CA), 7, 2, 1, 0.75000, 179, 44, 135, 
1935, Loyola Marymount (CA), 6, 5, 0, 0.54545, 152, 90, 62, 
1936, Loyola Marymount (CA), 6, 3, 0, 0.66667, 128, 81, 47, 
1937, Loyola Marymount (CA), 4, 7, 0, 0.36364, 108, 120, -12, 
1938, Loyola Marymount (CA), 4, 5, 0, 0.44444, 151, 101, 50, 
1940, Florida, 5, 5, 0, 0.50000, 136, 139, -3, 
1941, Florida, 4, 6, 0, 0.40000, 149, 97, 52, 
1942, Florida, 3, 7, 0, 0.30000, 106, 185, -79, 
1944, Florida, 4, 3, 0, 0.57143, 108, 136, -28, 
1945, Florida, 4, 5, 1, 0.45000, 155, 100, 55, 
1906, Eastern Washington, 5, 3, 0, 0.62500, 93, 27, 66, 
1907, Eastern Washington, 3, 2, 0, 0.60000, 22, 55, -33, 
1930, North Carolina St., 2, 8, 0, 0.20000, 54, 125, -71, 
1932, Hanover (IN), 4, 3, 1, 0.56250, 98, 96, 2, 
1933, Hanover (IN), 6, 2, 0, 0.75000, 138, 57, 81, 
1934, Hanover (IN), 7, 2, 0, 0.77778, 130, 79, 51, 
1935, Hanover (IN), 2, 5, 1, 0.31250, 71, 248, -177, 
1936, Hanover (IN), 1, 6, 0, 0.14286, 21, 87, -66, 
1937, Hanover (IN), 5, 3, 0, 0.62500, 65, 87, -22, 
1938, Hanover (IN), 5, 2, 0, 0.71429, 84, 65, 19, 
1939, Hanover (IN), 4, 4, 0, 0.50000, 43, 78, -35, 
1940, Hanover (IN), 1, 8, 0, 0.11111, 59, 230, -171, 
1941, Hanover (IN), 1, 7, 0, 0.12500, 25, 178, -153, 
1942, Hanover (IN), 2, 5, 0, 0.28571, 96, 208, -112, 
1927, South Carolina, 4, 5, 0, 0.44444, 46, 172, -126, 
1995, North Park (IL), 2, 7, 0, 0.22222, 117, 295, -178, 
1996, North Park (IL), 0, 9, 0, 0.00000, 73, 385, -312, 
1997, North Park (IL), 0, 9, 0, 0.00000, 76, 285, -209, 
1998, North Park (IL), 2, 7, 0, 0.22222, 98, 254, -156, 
1999, North Park (IL), 2, 7, 0, 0.22222, 134, 204, -70, 
2000, North Park (IL), 3, 7, 0, 0.30000, 221, 310, -89, 
1909, Dartmouth (NH), 5, 1, 2, 0.75000, 88, 18, 70, 
1889, Ohio St., 1, 0, 0, 1.00000, 20, 14, 6, 
1890, Ohio St., 0, 3, 0, 0.00000, 10, 96, -86, 
1891, Ohio St., 2, 2, 0, 0.50000, 18, 80, -62, 
1947, Willamette (OR), 7, 2, 0, 0.77778, 162, 96, 66, 
1948, Willamette (OR), 6, 5, 0, 0.54545, 170, 132, 38, 
1962, Glenville St. (WV), 3, 4, 0, 0.42857, 100, 106, -6, 
1963, Glenville St. (WV), 4, 3, 0, 0.57143, 121, 78, 43, 
1964, Glenville St. (WV), 2, 6, 0, 0.25000, 64, 132, -68, 
1954, Northern Colorado, 2, 6, 1, 0.27778, 80, 196, -116, 
1955, Northern Colorado, 1, 7, 1, 0.16667, 82, 192, -110, 
1956, Northern Colorado, 5, 4, 0, 0.55556, 109, 85, 24, 
1957, Northern Colorado, 6, 3, 0, 0.66667, 143, 76, 67, 
1958, Northern Colorado, 5, 3, 1, 0.61111, 181, 113, 68, 
1959, Northern Colorado, 7, 2, 0, 0.77778, 261, 92, 169, 
1960, Northern Colorado, 6, 3, 1, 0.65000, 149, 111, 38, 
1961, Northern Colorado, 1, 9, 0, 0.10000, 87, 178, -91, 
1962, Northern Colorado, 3, 6, 0, 0.33333, 154, 230, -76, 
1921, Loyola Marymount (CA), 6, 3, 1, 0.65000, 160, 105, 55, 
1926, Mesa St. (CO), 1, 0, 0, 1.00000, 20, 7, 13, 
1906, Illinois, 1, 3, 1, 0.30000, 20, 107, -87, 
1927, Oklahoma, 3, 3, 2, 0.50000, 117, 101, 16, 
1928, Oklahoma, 5, 3, 0, 0.62500, 120, 88, 32, 
1929, Oklahoma, 3, 3, 2, 0.50000, 81, 81, 0, 
1930, Oklahoma, 4, 3, 1, 0.56250, 100, 57, 43, 
1931, Oklahoma, 4, 7, 1, 0.37500, 88, 108, -20, 
1932, Kansas, 4, 2, 0, 0.66667, 70, 44, 26, 
1933, Kansas, 5, 4, 1, 0.55000, 102, 51, 51, 
1934, Kansas, 3, 4, 3, 0.45000, 74, 48, 26, 
1935, Kansas, 4, 4, 1, 0.50000, 102, 118, -16, 
1936, Kansas, 1, 6, 1, 0.18750, 35, 153, -118, 
1937, Kansas, 3, 4, 2, 0.44444, 72, 74, -2, 
1938, Kansas, 3, 6, 0, 0.33333, 132, 169, -37, 
2013, San Diego (CA), 8, 3, 0, 0.72727, 430, 250, 180, 
2011, Richmond (VA), 3, 8, 0, 0.27273, 246, 295, -49, 
1895, Pittsburgh (PA), 1, 6, 0, 0.14286, 30, 136, -106, 
1974, Cameron (OK), 9, 3, 0, 0.75000, 287, 181, 106, 
1975, Cameron (OK), 8, 2, 1, 0.77273, 269, 182, 87, 
1931, Benedict (SC), 1, 3, 3, 0.35714, 45, 39, 6, 
1897, Montana St., 1, 3, 0, 0.25000, 32, 58, -26, 
1893, Northern Colorado, 0, 2, 0, 0.00000, 4, 66, -62, 
1895, Northern Colorado, 0, 1, 0, 0.00000, 0, 34, -34, 
1896, Northern Colorado, 0, 1, 0, 0.00000, 6, 10, -4, 
1881, Harvard (MA), 5, 1, 2, 0.75000, 13, 2, 11, 
1900, North Dakota, 5, 2, 1, 0.68750, 78, 56, 22, 
1950, Davidson (NC), 3, 6, 0, 0.33333, 178, 205, -27, 
1951, Davidson (NC), 1, 8, 0, 0.11111, 91, 248, -157, 
1914, Cincinnati (OH), 6, 3, 0, 0.66667, 164, 44, 120, 
1915, Cincinnati (OH), 4, 5, 0, 0.44444, 110, 158, -48, 
1916, Miami (OH), 7, 0, 1, 0.93750, 238, 12, 226, 
1919, Miami (OH), 7, 1, 0, 0.87500, 147, 32, 115, 
1920, Miami (OH), 5, 2, 1, 0.68750, 114, 38, 76, 
1921, Miami (OH), 8, 0, 0, 1.00000, 238, 13, 225, 
1924, Michigan, 6, 2, 0, 0.75000, 155, 54, 101, 
1925, Wisconsin, 6, 1, 1, 0.81250, 131, 50, 81, 
1926, Wisconsin, 5, 2, 1, 0.68750, 122, 72, 50, 
1983, Bethune-Cookman (FL), 4, 4, 1, 0.50000, 224, 144, 80, 
1984, Bethune-Cookman (FL), 7, 3, 0, 0.70000, 281, 275, 6, 
1985, Bethune-Cookman (FL), 6, 4, 0, 0.60000, 238, 264, -26, 
1986, Bethune-Cookman (FL), 3, 8, 0, 0.27273, 242, 257, -15, 
1987, Bethune-Cookman (FL), 5, 6, 0, 0.45455, 239, 300, -61, 
1988, Bethune-Cookman (FL), 5, 6, 0, 0.45455, 241, 207, 34, 
1989, Bethune-Cookman (FL), 4, 6, 0, 0.40000, 178, 199, -21, 
1990, Bethune-Cookman (FL), 4, 7, 0, 0.36364, 205, 312, -107, 
1991, Bethune-Cookman (FL), 4, 6, 0, 0.40000, 264, 256, 8, 
1993, North Carolina Central, 6, 5, 0, 0.54545, 312, 258, 54, 
1994, North Carolina Central, 6, 5, 0, 0.54545, 223, 218, 5, 
1995, North Carolina Central, 5, 6, 0, 0.45455, 306, 270, 36, 
1996, North Carolina Central, 8, 3, 0, 0.72727, 307, 141, 166, 
1997, North Carolina Central, 4, 7, 0, 0.36364, 179, 204, -25, 
1998, North Carolina Central, 4, 6, 0, 0.40000, 201, 239, -38, 
1924, Georgetown (DC), 4, 4, 0, 0.50000, 84, 39, 45, 
1925, Georgetown (DC), 9, 1, 0, 0.90000, 281, 19, 262, 
1926, Georgetown (DC), 7, 2, 1, 0.75000, 308, 56, 252, 
1927, Georgetown (DC), 8, 1, 0, 0.88889, 377, 21, 356, 
1928, Georgetown (DC), 8, 2, 0, 0.80000, 306, 62, 244, 
1929, Georgetown (DC), 5, 2, 2, 0.66667, 112, 21, 91, 
1930, Columbia (NY), 5, 4, 0, 0.55556, 141, 138, 3, 
1931, Columbia (NY), 7, 1, 1, 0.83333, 223, 26, 197, 
1932, Columbia (NY), 7, 1, 1, 0.83333, 199, 32, 167, 
1933, Columbia (NY), 8, 1, 0, 0.88889, 179, 45, 134, 
1934, Columbia (NY), 7, 1, 0, 0.87500, 140, 49, 91, 
1935, Columbia (NY), 4, 4, 1, 0.50000, 86, 115, -29, 
1936, Columbia (NY), 5, 3, 0, 0.62500, 145, 73, 72, 
1937, Columbia (NY), 2, 5, 2, 0.33333, 102, 100, 2, 
1938, Columbia (NY), 3, 6, 0, 0.33333, 154, 144, 10, 
1939, Columbia (NY), 2, 4, 2, 0.37500, 72, 88, -16, 
1940, Columbia (NY), 5, 2, 2, 0.66667, 81, 72, 9, 
1941, Columbia (NY), 3, 5, 0, 0.37500, 81, 103, -22, 
1942, Columbia (NY), 3, 6, 0, 0.33333, 174, 193, -19, 
1943, Columbia (NY), 0, 8, 0, 0.00000, 33, 313, -280, 
1944, Columbia (NY), 2, 6, 0, 0.25000, 71, 125, -54, 
1945, Columbia (NY), 8, 1, 0, 0.88889, 251, 105, 146, 
1946, Columbia (NY), 6, 3, 0, 0.66667, 222, 176, 46, 
1947, Columbia (NY), 7, 2, 0, 0.77778, 170, 113, 57, 
1948, Columbia (NY), 4, 5, 0, 0.44444, 194, 177, 17, 
1949, Columbia (NY), 2, 7, 0, 0.22222, 82, 276, -194, 
1950, Columbia (NY), 4, 5, 0, 0.44444, 151, 169, -18, 
1951, Columbia (NY), 5, 3, 0, 0.62500, 149, 103, 46, 
1952, Columbia (NY), 2, 6, 1, 0.27778, 117, 184, -67, 
1953, Columbia (NY), 4, 5, 0, 0.44444, 124, 153, -29, 
1954, Columbia (NY), 1, 8, 0, 0.11111, 71, 306, -235, 
1955, Columbia (NY), 1, 8, 0, 0.11111, 74, 251, -177, 
1956, Columbia (NY), 3, 6, 0, 0.33333, 94, 237, -143, 
1983, Elizabeth City St. (NC), 3, 7, 0, 0.30000, 132, 218, -86, 
1984, Elizabeth City St. (NC), 4, 5, 1, 0.45000, 131, 186, -55, 
1985, Elizabeth City St. (NC), 6, 4, 0, 0.60000, 180, 221, -41, 
1986, Elizabeth City St. (NC), 3, 6, 1, 0.35000, 157, 229, -72, 
1987, Elizabeth City St. (NC), 3, 8, 0, 0.27273, 201, 249, -48, 
1988, Elizabeth City St. (NC), 3, 6, 1, 0.35000, 94, 261, -167, 
1927, Texas, 6, 2, 1, 0.72222, 164, 73, 91, 
1928, Texas, 7, 2, 0, 0.77778, 122, 32, 90, 
1929, Texas, 5, 2, 2, 0.66667, 132, 28, 104, 
1930, Texas, 8, 1, 1, 0.85000, 179, 20, 159, 
1931, Texas, 6, 4, 0, 0.60000, 131, 58, 73, 
1932, Texas, 8, 2, 0, 0.80000, 220, 49, 171, 
1933, Texas, 4, 5, 2, 0.45455, 112, 104, 8, 
1954, East Tennessee St., 5, 4, 1, 0.55000, 165, 160, 5, 
1978, Livingstone (NC), 5, 4, 1, 0.55000, 173, 228, -55, 
1979, Livingstone (NC), 3, 8, 0, 0.27273, 73, 233, -160, 
1980, Livingstone (NC), 0, 10, 0, 0.00000, 37, 380, -343, 
1970, Gardner-Webb (NC), 2, 8, 0, 0.20000, 139, 266, -127, 
1971, Gardner-Webb (NC), 3, 7, 0, 0.30000, 171, 194, -23, 
1972, Gardner-Webb (NC), 2, 9, 0, 0.18182, 123, 221, -98, 
1973, Gardner-Webb (NC), 7, 5, 0, 0.58333, 203, 215, -12, 
1974, Gardner-Webb (NC), 2, 6, 1, 0.27778, 136, 214, -78, 
1917, Beloit (WI), 2, 2, 0, 0.50000, 17, 89, -72, 
1918, Beloit (WI), 3, 1, 0, 0.75000, 121, 27, 94, 
1919, Beloit (WI), 0, 6, 1, 0.07143, 12, 80, -68, 
1888, Fordham (NY), 1, 1, 0, 0.50000, 4, 12, -8, 
1932, Denver (CO), 4, 3, 1, 0.56250, 60, 74, -14, 
1933, Denver (CO), 5, 3, 1, 0.61111, 107, 46, 61, 
1934, Denver (CO), 5, 5, 1, 0.50000, 122, 91, 31, 
1935, Denver (CO), 6, 3, 0, 0.66667, 109, 101, 8, 
2013, Cheyney (PA), 0, 11, 0, 0.00000, 120, 422, -302, 
1946, Arkansas-Monticello, 1, 6, 1, 0.18750, 64, 129, -65, 
1947, Arkansas-Monticello, 2, 7, 1, 0.25000, 72, 209, -137, 
1944, Alabama St., 0, 7, 0, 0.00000, 36, 190, -154, 
2009, New Mexico, 1, 11, 0, 0.08333, 196, 431, -235, 
2010, New Mexico, 1, 11, 0, 0.08333, 190, 532, -342, 
2011, New Mexico, 0, 4, 0, 0.00000, 71, 173, -102, 
1919, Southern Illinois, 2, 2, 0, 0.50000, 49, 18, 31, 
1980, Southeastern Louisiana, 8, 2, 0, 0.80000, 289, 159, 130, 
1981, Southeastern Louisiana, 8, 3, 0, 0.72727, 246, 284, -38, 
1982, Southeastern Louisiana, 4, 7, 0, 0.36364, 163, 241, -78, 
1983, Southeastern Louisiana, 6, 5, 0, 0.54545, 205, 171, 34, 
1984, Southeastern Louisiana, 2, 8, 1, 0.22727, 147, 235, -88, 
1985, Southeastern Louisiana, 2, 9, 0, 0.18182, 168, 302, -134, 
1994, Sewanee (TN), 1, 8, 0, 0.11111, 141, 235, -94, 
1995, Sewanee (TN), 3, 6, 0, 0.33333, 115, 204, -89, 
2013, Muskingum (OH), 2, 8, 0, 0.20000, 160, 301, -141, 
1902, Lock Haven (PA), 4, 4, 0, 0.50000, 60, 49, 11, 
1974, San Diego (CA), 3, 8, 0, 0.27273, 132, 306, -174, 
1975, San Diego (CA), 2, 7, 0, 0.22222, 131, 224, -93, 
1914, Elizabeth City St. (NC), 1, 0, 0, 1.00000, 30, 0, 30, 
1992, East Carolina (NC), 5, 6, 0, 0.45455, 289, 367, -78, 
1993, East Carolina (NC), 2, 9, 0, 0.18182, 175, 329, -154, 
1994, East Carolina (NC), 7, 5, 0, 0.58333, 303, 263, 40, 
1995, East Carolina (NC), 9, 3, 0, 0.75000, 274, 226, 48, 
1996, East Carolina (NC), 8, 3, 0, 0.72727, 316, 214, 102, 
1997, East Carolina (NC), 5, 6, 0, 0.45455, 214, 298, -84, 
1998, East Carolina (NC), 6, 5, 0, 0.54545, 274, 297, -23, 
1999, East Carolina (NC), 9, 3, 0, 0.75000, 333, 225, 108, 
2000, East Carolina (NC), 8, 4, 0, 0.66667, 370, 256, 114, 
2001, East Carolina (NC), 6, 6, 0, 0.50000, 421, 360, 61, 
2002, East Carolina (NC), 4, 8, 0, 0.33333, 335, 399, -64, 
1974, Southeast Missouri St., 7, 4, 0, 0.63636, 274, 186, 88, 
1975, Southeast Missouri St., 7, 4, 0, 0.63636, 244, 159, 85, 
1976, Southeast Missouri St., 7, 3, 1, 0.68182, 183, 168, 15, 
1977, Southeast Missouri St., 7, 3, 1, 0.68182, 208, 158, 50, 
1978, Southeast Missouri St., 6, 5, 0, 0.54545, 228, 189, 39, 
1979, Southeast Missouri St., 5, 5, 1, 0.50000, 259, 188, 71, 
1980, Southeast Missouri St., 4, 7, 0, 0.36364, 249, 230, 19, 
1981, Southeast Missouri St., 2, 9, 0, 0.18182, 202, 263, -61, 
1982, Southeast Missouri St., 5, 5, 1, 0.50000, 266, 291, -25, 
1983, Southeast Missouri St., 1, 9, 0, 0.10000, 128, 316, -188, 
1964, Central Connecticut St., 1, 8, 0, 0.11111, 102, 184, -82, 
1965, Central Connecticut St., 7, 1, 0, 0.87500, 217, 87, 130, 
1966, Central Connecticut St., 7, 2, 0, 0.77778, 186, 128, 58, 
1967, Central Connecticut St., 7, 1, 0, 0.87500, 170, 76, 94, 
1968, Central Connecticut St., 6, 2, 1, 0.72222, 152, 40, 112, 
1969, Central Connecticut St., 5, 4, 0, 0.55556, 163, 111, 52, 
1970, Central Connecticut St., 5, 3, 1, 0.61111, 168, 105, 63, 
1971, Central Connecticut St., 7, 3, 0, 0.70000, 249, 124, 125, 
1972, Central Connecticut St., 5, 5, 0, 0.50000, 260, 155, 105, 
1973, Central Connecticut St., 9, 1, 0, 0.90000, 228, 124, 104, 
1974, Central Connecticut St., 4, 5, 1, 0.45000, 234, 223, 11, 
1975, Central Connecticut St., 4, 5, 0, 0.44444, 130, 168, -38, 
1976, Central Connecticut St., 5, 5, 0, 0.50000, 245, 221, 24, 
1977, Central Connecticut St., 7, 3, 0, 0.70000, 245, 209, 36, 
1978, Central Connecticut St., 3, 7, 0, 0.30000, 218, 268, -50, 
1979, Central Connecticut St., 4, 5, 0, 0.44444, 163, 220, -57, 
1980, Central Connecticut St., 3, 7, 0, 0.30000, 137, 162, -25, 
1981, Central Connecticut St., 5, 5, 0, 0.50000, 126, 185, -59, 
1963, Fort Valley St. (GA), 3, 6, 0, 0.33333, 136, 193, -57, 
1964, Fort Valley St. (GA), 7, 2, 0, 0.77778, 212, 80, 132, 
1965, Fort Valley St. (GA), 5, 2, 1, 0.68750, 243, 92, 151, 
1966, Fort Valley St. (GA), 6, 3, 0, 0.66667, 213, 106, 107, 
1967, Fort Valley St. (GA), 4, 3, 2, 0.55556, 155, 116, 39, 
1968, Fort Valley St. (GA), 7, 2, 0, 0.77778, 327, 136, 191, 
1969, Fort Valley St. (GA), 7, 2, 0, 0.77778, 351, 153, 198, 
1970, Fort Valley St. (GA), 7, 2, 0, 0.77778, 286, 115, 171, 
1971, Fort Valley St. (GA), 6, 2, 1, 0.72222, 260, 123, 137, 
1972, Fort Valley St. (GA), 8, 2, 0, 0.80000, 421, 118, 303, 
1973, Fort Valley St. (GA), 7, 1, 1, 0.83333, 210, 121, 89, 
1974, Fort Valley St. (GA), 5, 3, 0, 0.62500, 192, 139, 53, 
1975, Fort Valley St. (GA), 7, 1, 2, 0.80000, 167, 120, 47, 
1976, Fort Valley St. (GA), 8, 2, 0, 0.80000, 252, 81, 171, 
1898, Tulane (LA), 1, 1, 0, 0.50000, 14, 46, -32, 
1976, Chicago (IL), 4, 4, 0, 0.50000, 160, 211, -51, 
1977, Chicago (IL), 2, 6, 0, 0.25000, 140, 259, -119, 
1978, Chicago (IL), 3, 5, 0, 0.37500, 156, 142, 14, 
1999, Eastern Michigan, 0, 1, 0, 0.00000, 23, 30, -7, 
2008, Richmond (VA), 13, 3, 0, 0.81250, 506, 250, 256, 
2009, Richmond (VA), 11, 2, 0, 0.84615, 389, 212, 177, 
2010, Virginia, 4, 8, 0, 0.33333, 304, 339, -35, 
2011, Virginia, 8, 5, 0, 0.61538, 302, 310, -8, 
2012, Virginia, 4, 8, 0, 0.33333, 273, 347, -74, 
2013, Virginia, 2, 10, 0, 0.16667, 237, 399, -162, 
2013, Nichols (MA), 1, 8, 0, 0.11111, 164, 398, -234, 
1981, Morehead St. (KY), 1, 9, 0, 0.10000, 163, 256, -93, 
1982, Morehead St. (KY), 5, 6, 0, 0.45455, 174, 206, -32, 
1983, Morehead St. (KY), 2, 9, 0, 0.18182, 84, 325, -241, 
2007, Drake (IA), 6, 5, 0, 0.54545, 293, 293, 0, 
2006, San Diego St. (CA), 3, 9, 0, 0.25000, 170, 325, -155, 
2007, San Diego St. (CA), 4, 8, 0, 0.33333, 301, 413, -112, 
2008, San Diego St. (CA), 2, 10, 0, 0.16667, 231, 446, -215, 
1910, Richmond (VA), 1, 6, 1, 0.18750, 32, 141, -109, 
1912, Wichita St. (KS), 4, 5, 0, 0.44444, 129, 186, -57, 
1913, Wichita St. (KS), 2, 6, 0, 0.25000, 133, 136, -3, 
1948, Prairie View A&M; (TX), 6, 4, 1, 0.59091, 128, 90, 38, 
1928, Tennessee St., 0, 4, 1, 0.10000, 6, 47, -41, 
2012, Chadron St. (NE), 0, 3, 0, 0.00000, 406, 285, 121, 
2013, Chadron St. (NE), 8, 3, 0, 0.72727, 376, 243, 133, 
2009, DePauw (IN), 7, 3, 0, 0.70000, 316, 237, 79, 
2010, DePauw (IN), 9, 2, 0, 0.81818, 328, 263, 65, 
2011, DePauw (IN), 4, 5, 0, 0.44444, 133, 183, -50, 
2012, DePauw (IN), 0, 2, 0, 0.00000, 24, 83, -59, 
1998, New Mexico, 3, 9, 0, 0.25000, 274, 397, -123, 
1999, New Mexico, 4, 7, 0, 0.36364, 240, 298, -58, 
2000, New Mexico, 5, 7, 0, 0.41667, 229, 249, -20, 
2001, New Mexico, 6, 5, 0, 0.54545, 304, 243, 61, 
2002, New Mexico, 7, 7, 0, 0.50000, 341, 358, -17, 
2003, New Mexico, 8, 5, 0, 0.61538, 391, 290, 101, 
2004, New Mexico, 7, 5, 0, 0.58333, 244, 224, 20, 
2005, New Mexico, 6, 5, 0, 0.54545, 326, 327, -1, 
2006, New Mexico, 6, 7, 0, 0.46154, 284, 312, -28, 
2007, New Mexico, 9, 4, 0, 0.69231, 321, 247, 74, 
2008, New Mexico, 4, 8, 0, 0.33333, 253, 273, -20, 
2011, San Diego St. (CA), 8, 5, 0, 0.61538, 387, 325, 62, 
2012, San Diego St. (CA), 9, 4, 0, 0.69231, 427, 317, 110, 
2013, San Diego St. (CA), 8, 5, 0, 0.61538, 387, 412, -25, 
1906, Arkansas, 2, 4, 2, 0.37500, 45, 70, -25, 
1907, Arkansas, 3, 4, 1, 0.43750, 73, 110, -37, 
1909, Notre Dame (IN), 7, 0, 1, 0.93750, 236, 14, 222, 
1910, Notre Dame (IN), 4, 1, 1, 0.75000, 192, 25, 167, 
2004, La Salle (PA), 3, 7, 0, 0.30000, 297, 327, -30, 
2005, La Salle (PA), 4, 7, 0, 0.36364, 266, 373, -107, 
1908, Central Arkansas, 3, 3, 0, 0.50000, 63, 61, 2, 
1909, Samford (AL), 5, 2, 1, 0.68750, 82, 30, 52, 
1911, Samford (AL), 1, 6, 1, 0.18750, 6, 158, -152, 
1916, Samford (AL), 6, 4, 0, 0.60000, 146, 92, 54, 
1917, Samford (AL), 2, 2, 1, 0.50000, 37, 135, -98, 
1919, New York (NY), 4, 4, 0, 0.50000, 95, 63, 32, 
1939, Oklahoma St., 5, 4, 1, 0.55000, 128, 115, 13, 
1940, Oklahoma St., 6, 3, 1, 0.65000, 210, 137, 73, 
1941, Oklahoma St., 5, 4, 0, 0.55556, 161, 123, 38, 
1942, Oklahoma St., 6, 3, 1, 0.65000, 235, 116, 119, 
1943, Oklahoma St., 3, 4, 0, 0.42857, 66, 154, -88, 
1944, Oklahoma St., 8, 1, 0, 0.88889, 228, 103, 125, 
1945, Oklahoma St., 9, 0, 0, 1.00000, 285, 76, 209, 
1946, Oklahoma St., 3, 7, 1, 0.31818, 202, 264, -62, 
1947, Oklahoma St., 3, 7, 0, 0.30000, 116, 134, -18, 
1948, Oklahoma St., 6, 4, 0, 0.60000, 219, 127, 92, 
1949, Oklahoma St., 4, 4, 2, 0.50000, 223, 212, 11, 
1899, North Dakota, 6, 0, 0, 1.00000, 179, 5, 174, 
1902, North Dakota, 3, 2, 2, 0.57143, 65, 69, -4, 
1961, North Park (IL), 3, 5, 0, 0.37500, 80, 194, -114, 
1962, North Park (IL), 2, 6, 0, 0.25000, 44, 146, -102, 
1963, North Park (IL), 1, 7, 0, 0.12500, 62, 185, -123, 
1938, Ashland (OH), 0, 7, 0, 0.00000, 57, 257, -200, 
1939, Ashland (OH), 2, 4, 0, 0.33333, 65, 89, -24, 
1940, Ashland (OH), 1, 4, 1, 0.25000, 18, 108, -90, 
1941, Ashland (OH), 0, 5, 0, 0.00000, 7, 199, -192, 
1936, East Stroudsburg (PA), 2, 6, 0, 0.25000, 28, 179, -151, 
1937, East Stroudsburg (PA), 2, 6, 0, 0.25000, 26, 112, -86, 
1938, East Stroudsburg (PA), 2, 6, 0, 0.25000, 79, 114, -35, 
2000, Kean (NJ), 1, 9, 0, 0.10000, 139, 315, -176, 
2001, Kean (NJ), 2, 7, 0, 0.22222, 107, 290, -183, 
2002, Kean (NJ), 4, 6, 0, 0.40000, 171, 268, -97, 
2012, Western Connecticut St., 1, 8, 0, 0.11111, 165, 405, -240, 
2013, Western Connecticut St., 8, 2, 0, 0.80000, 438, 200, 238, 
1953, Dickinson St. (ND), 2, 5, 0, 0.28571, 62, 95, -33, 
1954, Dickinson St. (ND), 3, 4, 0, 0.42857, 164, 180, -16, 
1955, Dickinson St. (ND), 5, 1, 0, 0.83333, 126, 70, 56, 
1954, California-Davis, 1, 7, 0, 0.12500, 47, 226, -179, 
1956, California-Davis, 7, 2, 0, 0.77778, 146, 78, 68, 
1957, California-Davis, 1, 7, 1, 0.16667, 59, 210, -151, 
1959, California-Davis, 1, 8, 0, 0.11111, 64, 197, -133, 
1960, California-Davis, 0, 8, 1, 0.05556, 54, 216, -162, 
1961, California-Davis, 5, 4, 0, 0.55556, 173, 111, 62, 
1962, California-Davis, 5, 4, 0, 0.55556, 131, 110, 21, 
1963, California-Davis, 6, 2, 1, 0.72222, 151, 74, 77, 
1972, Fordham (NY), 5, 5, 0, 0.50000, 137, 185, -48, 
1973, Fordham (NY), 6, 4, 0, 0.60000, 128, 192, -64, 
1974, Fordham (NY), 3, 5, 1, 0.38889, 120, 173, -53, 
1916, Carthage (WI), 2, 5, 0, 0.28571, 29, 171, -142, 
1917, Carthage (WI), 4, 1, 1, 0.75000, 149, 46, 103, 
1918, Carthage (WI), 1, 2, 0, 0.33333, 6, 23, -17, 
1920, Carthage (WI), 1, 5, 1, 0.21429, 14, 180, -166, 
1922, Saint Francis (PA), 0, 5, 0, 0.00000, 0, 170, -170, 
1923, Saint Francis (PA), 0, 7, 0, 0.00000, 0, 373, -373, 
1962, Ball St. (IN), 4, 3, 1, 0.56250, 138, 107, 31, 
1963, Ball St. (IN), 5, 3, 0, 0.62500, 156, 115, 41, 
1964, Ball St. (IN), 5, 3, 0, 0.62500, 175, 139, 36, 
1965, Ball St. (IN), 9, 0, 1, 0.95000, 309, 150, 159, 
1966, Ball St. (IN), 7, 1, 1, 0.83333, 207, 152, 55, 
1967, Ball St. (IN), 7, 3, 0, 0.70000, 262, 126, 136, 
1974, Utah, 1, 10, 0, 0.09091, 115, 339, -224, 
1975, Utah, 1, 10, 0, 0.09091, 132, 332, -200, 
1976, Utah, 3, 8, 0, 0.27273, 245, 361, -116, 
1906, Southwestern (KS), 3, 6, 0, 0.33333, 67, 88, -21, 
1907, Southwestern (KS), 5, 1, 2, 0.75000, 171, 26, 145, 
1919, Charleston (WV), 1, 5, 0, 0.16667, 6, 185, -179, 
1974, Hampton (VA), 3, 7, 0, 0.30000, 147, 265, -118, 
1975, Hampton (VA), 5, 5, 0, 0.50000, 203, 191, 12, 
1976, Hampton (VA), 7, 4, 0, 0.63636, 215, 179, 36, 
1977, Hampton (VA), 7, 4, 0, 0.63636, 256, 202, 54, 
1978, Hampton (VA), 5, 6, 0, 0.45455, 149, 221, -72, 
1979, Hampton (VA), 3, 8, 0, 0.27273, 171, 297, -126, 
1980, Hampton (VA), 5, 6, 0, 0.45455, 223, 304, -81, 
1946, Shepherd (WV), 1, 5, 0, 0.16667, 21, 102, -81, 
1947, Shepherd (WV), 0, 6, 1, 0.07143, 36, 120, -84, 
1992, Bridgewater (VA), 3, 7, 0, 0.30000, 114, 222, -108, 
1993, Bridgewater (VA), 2, 8, 0, 0.20000, 114, 307, -193, 
1994, Bridgewater (VA), 0, 10, 0, 0.00000, 42, 343, -301, 
1942, North Dakota St., 2, 5, 1, 0.31250, 82, 118, -36, 
1945, North Dakota St., 1, 4, 1, 0.25000, 38, 96, -58, 
1905, Illinois, 5, 4, 0, 0.55556, 84, 136, -52, 
1907, Central Missouri St., 8, 2, 0, 0.80000, 290, 57, 233, 
1910, Alabama, 4, 4, 0, 0.50000, 65, 107, -42, 
1911, Kansas St., 5, 4, 1, 0.55000, 47, 87, -40, 
1912, Kansas St., 8, 2, 0, 0.80000, 204, 103, 101, 
1913, Kansas St., 3, 4, 1, 0.43750, 97, 122, -25, 
1914, Kansas St., 1, 5, 1, 0.21429, 44, 150, -106, 
1918, Wisconsin, 3, 3, 0, 0.50000, 42, 44, -2, 
1978, Montana St., 8, 2, 0, 0.80000, 287, 209, 78, 
1979, Montana St., 6, 4, 0, 0.60000, 202, 170, 32, 
1980, Montana St., 4, 6, 0, 0.40000, 153, 162, -9, 
1981, Montana St., 3, 7, 0, 0.30000, 192, 273, -81, 
1993, Colorado St., 5, 6, 0, 0.45455, 230, 268, -38, 
1994, Colorado St., 10, 2, 0, 0.83333, 400, 269, 131, 
1995, Colorado St., 8, 4, 0, 0.66667, 339, 254, 85, 
1996, Colorado St., 7, 5, 0, 0.58333, 380, 336, 44, 
1997, Colorado St., 11, 2, 0, 0.84615, 477, 203, 274, 
1998, Colorado St., 8, 4, 0, 0.66667, 345, 263, 82, 
1999, Colorado St., 8, 4, 0, 0.66667, 345, 269, 76, 
2000, Colorado St., 10, 2, 0, 0.83333, 363, 225, 138, 
2001, Colorado St., 7, 5, 0, 0.58333, 298, 274, 24, 
2002, Colorado St., 10, 4, 0, 0.71429, 418, 332, 86, 
2003, Colorado St., 7, 6, 0, 0.53846, 381, 318, 63, 
2004, Colorado St., 4, 7, 0, 0.36364, 261, 325, -64, 
2005, Colorado St., 6, 6, 0, 0.50000, 321, 369, -48, 
2006, Colorado St., 4, 8, 0, 0.33333, 202, 263, -61, 
2007, Colorado St., 3, 9, 0, 0.25000, 304, 369, -65, 
1981, Siena (NY), 3, 5, 0, 0.37500, 93, 86, 7, 
2007, Southeastern Louisiana, 3, 8, 0, 0.27273, 279, 329, -50, 
2008, Southeastern Louisiana, 5, 7, 0, 0.41667, 327, 389, -62, 
2009, Southeastern Louisiana, 6, 5, 0, 0.54545, 344, 337, 7, 
2010, Southeastern Louisiana, 2, 9, 0, 0.18182, 237, 324, -87, 
2011, Southeastern Louisiana, 3, 8, 0, 0.27273, 311, 415, -104, 
1976, West Virginia Tech, 2, 7, 0, 0.22222, 89, 209, -120, 
1977, West Virginia Tech, 4, 5, 0, 0.44444, 152, 131, 21, 
1978, West Virginia Tech, 6, 3, 0, 0.66667, 160, 196, -36, 
1979, West Virginia Tech, 1, 6, 2, 0.22222, 67, 168, -101, 
1980, West Virginia Tech, 5, 4, 0, 0.55556, 120, 142, -22, 
1981, West Virginia Tech, 6, 4, 0, 0.60000, 164, 144, 20, 
1982, West Virginia Tech, 2, 6, 2, 0.30000, 101, 168, -67, 
1963, Michigan Tech, 6, 2, 0, 0.75000, 114, 87, 27, 
1964, Michigan Tech, 4, 4, 1, 0.50000, 94, 100, -6, 
1965, Michigan Tech, 6, 2, 0, 0.75000, 153, 73, 80, 
1966, Michigan Tech, 4, 3, 0, 0.57143, 160, 69, 91, 
1967, Michigan Tech, 0, 7, 1, 0.06250, 54, 184, -130, 
1968, Michigan Tech, 1, 7, 0, 0.12500, 77, 194, -117, 
1922, East Tennessee St., 6, 2, 0, 0.75000, 142, 94, 48, 
1923, East Tennessee St., 3, 6, 0, 0.33333, 105, 345, -240, 
1924, East Tennessee St., 4, 5, 1, 0.45000, 93, 177, -84, 
1905, DePauw (IN), 3, 6, 0, 0.33333, 139, 200, -61, 
1906, DePauw (IN), 3, 4, 0, 0.42857, 121, 111, 10, 
2002, California (PA), 6, 5, 0, 0.54545, 245, 228, 17, 
2003, California (PA), 4, 7, 0, 0.36364, 153, 211, -58, 
2004, California (PA), 6, 4, 0, 0.60000, 365, 259, 106, 
2005, California (PA), 8, 2, 0, 0.80000, 421, 141, 280, 
2006, California (PA), 8, 3, 0, 0.72727, 341, 158, 183, 
2007, California (PA), 13, 1, 0, 0.92857, 502, 161, 341, 
2008, California (PA), 12, 2, 0, 0.85714, 498, 281, 217, 
2009, California (PA), 11, 4, 0, 0.73333, 534, 341, 193, 
2010, California (PA), 10, 2, 0, 0.83333, 417, 173, 244, 
2011, California (PA), 10, 3, 0, 0.76923, 405, 209, 196, 
1962, Colorado St., 0, 10, 0, 0.00000, 66, 269, -203, 
1963, Colorado St., 3, 7, 0, 0.30000, 118, 299, -181, 
1964, Colorado St., 5, 6, 0, 0.45455, 111, 199, -88, 
1965, Colorado St., 4, 6, 0, 0.40000, 264, 264, 0, 
1966, Colorado St., 7, 3, 0, 0.70000, 275, 178, 97, 
1967, Colorado St., 4, 5, 1, 0.45000, 229, 149, 80, 
1968, Colorado St., 2, 8, 0, 0.20000, 133, 262, -129, 
1969, Colorado St., 4, 6, 0, 0.40000, 218, 288, -70, 
1905, Tulane (LA), 0, 1, 0, 0.00000, 0, 5, -5, 
1944, Bucknell (PA), 7, 2, 1, 0.75000, 204, 79, 125, 
1945, Bucknell (PA), 2, 5, 0, 0.28571, 68, 194, -126, 
1903, Virginia Tech, 5, 1, 0, 0.83333, 108, 21, 87, 
1908, West Virginia, 5, 3, 0, 0.62500, 101, 29, 72, 
1909, West Virginia, 4, 3, 2, 0.55556, 118, 81, 37, 
1910, West Virginia, 2, 4, 1, 0.35714, 20, 95, -75, 
1911, West Virginia, 6, 3, 0, 0.66667, 91, 67, 24, 
1989, San Diego St. (CA), 6, 5, 1, 0.54167, 368, 378, -10, 
1990, San Diego St. (CA), 6, 5, 0, 0.54545, 459, 386, 73, 
1991, San Diego St. (CA), 8, 4, 1, 0.65385, 420, 365, 55, 
1992, San Diego St. (CA), 5, 5, 1, 0.50000, 334, 338, -4, 
1993, San Diego St. (CA), 6, 6, 0, 0.50000, 413, 392, 21, 
1892, Gonzaga (WA), 0, 0, 1, 0.50000, 4, 4, 0, 
1893, Gonzaga (WA), 1, 0, 0, 1.00000, 16, 0, 16, 
1896, Gonzaga (WA), 2, 0, 0, 1.00000, 44, 0, 44, 
1897, Gonzaga (WA), 3, 0, 0, 1.00000, 72, 0, 72, 
1898, Gonzaga (WA), 1, 0, 1, 0.75000, 5, 0, 5, 
1994, Clarion (PA), 4, 6, 0, 0.40000, 283, 314, -31, 
1995, Clarion (PA), 6, 4, 0, 0.60000, 281, 211, 70, 
1996, Clarion (PA), 11, 3, 0, 0.78571, 561, 317, 244, 
1997, Clarion (PA), 3, 7, 0, 0.30000, 172, 251, -79, 
1998, Clarion (PA), 3, 8, 0, 0.27273, 247, 371, -124, 
1999, Clarion (PA), 3, 7, 0, 0.30000, 206, 306, -100, 
2000, Clarion (PA), 7, 4, 0, 0.63636, 294, 252, 42, 
2001, Clarion (PA), 4, 7, 0, 0.36364, 245, 262, -17, 
2002, Clarion (PA), 7, 4, 0, 0.63636, 298, 227, 71, 
2003, Clarion (PA), 3, 8, 0, 0.27273, 164, 230, -66, 
2004, Clarion (PA), 3, 8, 0, 0.27273, 202, 286, -84, 
2005, Clarion (PA), 3, 7, 0, 0.30000, 101, 316, -215, 
1972, Truman St. (MO), 6, 4, 1, 0.59091, 236, 107, 129, 
1973, Truman St. (MO), 2, 7, 2, 0.27273, 114, 186, -72, 
1974, Truman St. (MO), 4, 7, 0, 0.36364, 155, 198, -43, 
1930, Southern Mississippi, 3, 5, 1, 0.38889, 162, 117, 45, 
2012, Virginia-Wise, 3, 8, 0, 0.27273, 181, 371, -190, 
2013, Virginia-Wise, 2, 9, 0, 0.18182, 211, 419, -208, 
1941, Oklahoma, 6, 3, 0, 0.66667, 218, 95, 123, 
1942, Oklahoma, 3, 5, 2, 0.40000, 135, 78, 57, 
1943, Oklahoma, 7, 2, 0, 0.77778, 187, 92, 95, 
1944, Oklahoma, 6, 3, 1, 0.65000, 227, 149, 78, 
1945, Oklahoma, 5, 5, 0, 0.50000, 169, 138, 31, 
2000, Lock Haven (PA), 3, 8, 0, 0.27273, 125, 381, -256, 
2001, Lock Haven (PA), 3, 8, 0, 0.27273, 140, 291, -151, 
2002, Lock Haven (PA), 4, 7, 0, 0.36364, 222, 302, -80, 
2003, Lock Haven (PA), 3, 8, 0, 0.27273, 202, 319, -117, 
2004, Lock Haven (PA), 3, 8, 0, 0.27273, 172, 417, -245, 
1964, Parsons (IA), 6, 3, 0, 0.66667, 264, 185, 79, 
1956, North Dakota St., 5, 4, 0, 0.55556, 141, 122, 19, 
1990, Adrian (MI), 4, 4, 1, 0.50000, 146, 117, 29, 
1991, Adrian (MI), 4, 5, 0, 0.44444, 104, 142, -38, 
1992, Adrian (MI), 2, 7, 0, 0.22222, 160, 176, -16, 
1993, Adrian (MI), 2, 7, 0, 0.22222, 137, 214, -77, 
1994, Adrian (MI), 3, 6, 0, 0.33333, 135, 223, -88, 
1995, Adrian (MI), 6, 3, 0, 0.66667, 189, 191, -2, 
1996, Adrian (MI), 3, 6, 0, 0.33333, 152, 191, -39, 
1997, Adrian (MI), 8, 1, 0, 0.88889, 221, 126, 95, 
1998, Adrian (MI), 5, 4, 0, 0.55556, 178, 172, 6, 
1999, Adrian (MI), 2, 7, 0, 0.22222, 180, 292, -112, 
2000, Adrian (MI), 2, 8, 0, 0.20000, 100, 283, -183, 
2001, Adrian (MI), 2, 8, 0, 0.20000, 171, 286, -115, 
2002, Adrian (MI), 6, 4, 0, 0.60000, 264, 240, 24, 
2003, Adrian (MI), 8, 2, 0, 0.80000, 319, 240, 79, 
2004, Adrian (MI), 6, 4, 0, 0.60000, 211, 138, 73, 
2005, Adrian (MI), 8, 2, 0, 0.80000, 359, 185, 174, 
2006, Adrian (MI), 5, 5, 0, 0.50000, 240, 192, 48, 
2007, Adrian (MI), 7, 3, 0, 0.70000, 291, 144, 147, 
2008, Adrian (MI), 8, 2, 0, 0.80000, 278, 124, 154, 
2009, Adrian (MI), 6, 4, 0, 0.60000, 274, 162, 112, 
2011, Siena Heights (MI), 8, 1, 0, 0.88889, 348, 99, 249, 
2012, Siena Heights (MI), 4, 6, 0, 0.40000, 206, 268, -62, 
2013, Siena Heights (MI), 5, 5, 0, 0.50000, 226, 172, 54, 
1894, Doane (NE), 5, 3, 0, 0.62500, 122, 40, 82, 
1891, Nebraska, 1, 1, 0, 0.50000, 28, 26, 2, 
1985, Butler (IN), 8, 2, 0, 0.80000, 247, 138, 109, 
1986, Butler (IN), 5, 5, 0, 0.50000, 258, 169, 89, 
1987, Butler (IN), 8, 1, 1, 0.85000, 311, 149, 162, 
1988, Butler (IN), 8, 2, 1, 0.77273, 304, 176, 128, 
1989, Butler (IN), 7, 2, 1, 0.75000, 280, 205, 75, 
1995, Ball St. (IN), 7, 4, 0, 0.63636, 204, 187, 17, 
1996, Ball St. (IN), 8, 4, 0, 0.66667, 296, 210, 86, 
1997, Ball St. (IN), 5, 6, 0, 0.45455, 239, 260, -21, 
1998, Ball St. (IN), 1, 10, 0, 0.09091, 150, 343, -193, 
1999, Ball St. (IN), 0, 11, 0, 0.00000, 157, 361, -204, 
2000, Ball St. (IN), 5, 6, 0, 0.45455, 212, 349, -137, 
2001, Ball St. (IN), 5, 6, 0, 0.45455, 268, 296, -28, 
2002, Ball St. (IN), 6, 6, 0, 0.50000, 278, 333, -55, 
2004, DePauw (IN), 8, 2, 0, 0.80000, 261, 160, 101, 
2007, Indiana, 7, 6, 0, 0.53846, 412, 370, 42, 
2008, Indiana, 3, 9, 0, 0.25000, 246, 423, -177, 
2009, Indiana, 4, 8, 0, 0.33333, 282, 354, -72, 
2010, Indiana, 5, 7, 0, 0.41667, 326, 408, -82, 
2013, DePauw (IN), 4, 6, 0, 0.40000, 214, 242, -28, 
1926, Northern Arizona, 5, 2, 0, 0.71429, 139, 55, 84, 
1927, Northern Arizona, 6, 1, 2, 0.77778, 208, 24, 184, 
1923, Saint John's (NY), 5, 0, 1, 0.91667, 111, 32, 79, 
1924, Saint John's (NY), 3, 3, 0, 0.50000, 103, 33, 70, 
1925, Saint John's (NY), 3, 4, 0, 0.42857, 81, 39, 42, 
1926, Saint John's (NY), 1, 5, 1, 0.21429, 29, 138, -109, 
1927, Saint John's (NY), 1, 7, 1, 0.16667, 44, 71, -27, 
1928, Saint John's (NY), 2, 5, 2, 0.33333, 56, 116, -60, 
1929, Saint John's (NY), 3, 7, 0, 0.30000, 124, 179, -55, 
1930, Saint John's (NY), 7, 1, 0, 0.87500, 115, 45, 70, 
1931, Saint John's (NY), 3, 5, 1, 0.38889, 104, 173, -69, 
2012, Eastern New Mexico, 0, 7, 0, 0.00000, 214, 375, -161, 
2013, Eastern New Mexico, 7, 3, 0, 0.70000, 321, 268, 53, 
2004, Bowie St. (MD), 5, 5, 0, 0.50000, 177, 200, -23, 
2005, Bowie St. (MD), 8, 4, 0, 0.66667, 311, 212, 99, 
2006, Bowie St. (MD), 5, 5, 0, 0.50000, 164, 129, 35, 
2007, Bowie St. (MD), 3, 7, 0, 0.30000, 195, 240, -45, 
2008, Bowie St. (MD), 6, 3, 0, 0.66667, 188, 158, 30, 
1909, Johns Hopkins (MD), 6, 1, 0, 0.85714, 103, 31, 72, 
1910, Johns Hopkins (MD), 5, 2, 1, 0.68750, 90, 35, 55, 
1955, Rensselaer Tech (NY), 1, 7, 0, 0.12500, 25, 217, -192, 
1956, Rensselaer Tech (NY), 1, 6, 0, 0.14286, 39, 168, -129, 
1957, Rensselaer Tech (NY), 2, 5, 0, 0.28571, 72, 146, -74, 
1958, Ithaca (NY), 6, 1, 0, 0.85714, 159, 42, 117, 
1959, Ithaca (NY), 5, 2, 0, 0.71429, 182, 45, 137, 
1960, Ithaca (NY), 4, 3, 0, 0.57143, 84, 83, 1, 
1961, Ithaca (NY), 4, 4, 0, 0.50000, 176, 101, 75, 
1962, Ithaca (NY), 6, 2, 0, 0.75000, 229, 149, 80, 
1963, Ithaca (NY), 6, 2, 0, 0.75000, 208, 76, 132, 
1964, Ithaca (NY), 6, 2, 0, 0.75000, 146, 85, 61, 
1965, Ithaca (NY), 8, 0, 0, 1.00000, 204, 76, 128, 
1966, Ithaca (NY), 4, 4, 0, 0.50000, 170, 79, 91, 
1899, Mississippi, 3, 4, 0, 0.42857, 44, 47, -3, 
1963, Portland St. (OR), 6, 2, 0, 0.75000, 196, 108, 88, 
1964, Portland St. (OR), 4, 4, 1, 0.50000, 155, 151, 4, 
1965, Portland St. (OR), 3, 6, 0, 0.33333, 78, 194, -116, 
1966, Portland St. (OR), 4, 6, 0, 0.40000, 179, 200, -21, 
1967, Portland St. (OR), 4, 6, 0, 0.40000, 208, 251, -43, 
1992, Dartmouth (NH), 8, 2, 0, 0.80000, 364, 203, 161, 
1993, Dartmouth (NH), 7, 3, 0, 0.70000, 258, 188, 70, 
1994, Dartmouth (NH), 4, 6, 0, 0.40000, 166, 187, -21, 
1995, Dartmouth (NH), 7, 2, 1, 0.75000, 222, 137, 85, 
1996, Dartmouth (NH), 10, 0, 0, 1.00000, 275, 104, 171, 
1997, Dartmouth (NH), 8, 2, 0, 0.80000, 208, 165, 43, 
1998, Dartmouth (NH), 2, 8, 0, 0.20000, 142, 226, -84, 
1999, Dartmouth (NH), 2, 8, 0, 0.20000, 138, 300, -162, 
2000, Dartmouth (NH), 2, 8, 0, 0.20000, 231, 388, -157, 
2001, Dartmouth (NH), 1, 8, 0, 0.11111, 202, 301, -99, 
2002, Dartmouth (NH), 3, 7, 0, 0.30000, 247, 295, -48, 
2003, Dartmouth (NH), 5, 5, 0, 0.50000, 211, 261, -50, 
2004, Dartmouth (NH), 1, 9, 0, 0.10000, 108, 205, -97, 
1972, Northeastern (MA), 6, 2, 0, 0.75000, 151, 88, 63, 
1973, Northeastern (MA), 3, 6, 0, 0.33333, 210, 229, -19, 
1974, Northeastern (MA), 6, 4, 0, 0.60000, 248, 253, -5, 
1975, Northeastern (MA), 3, 6, 0, 0.33333, 116, 211, -95, 
1976, Northeastern (MA), 2, 7, 0, 0.22222, 206, 204, 2, 
1977, Northeastern (MA), 3, 6, 1, 0.35000, 226, 237, -11, 
1978, Northeastern (MA), 6, 5, 0, 0.54545, 242, 210, 32, 
1979, Northeastern (MA), 3, 7, 0, 0.30000, 176, 226, -50, 
1980, Northeastern (MA), 2, 9, 0, 0.18182, 180, 332, -152, 
1966, Minnesota-Crookston, 0, 3, 0, 0.00000, 13, 32, -19, 
1967, Minnesota-Crookston, 1, 6, 0, 0.14286, 107, 190, -83, 
1968, Minnesota-Crookston, 6, 2, 0, 0.75000, 158, 89, 69, 
1930, Arkansas-Pine Bluff, 7, 1, 0, 0.87500, 236, 43, 193, 
1931, Arkansas-Pine Bluff, 4, 3, 0, 0.57143, 134, 75, 59, 
1956, Rhode Island, 2, 6, 0, 0.25000, 87, 235, -148, 
1957, Rhode Island, 5, 2, 1, 0.68750, 131, 82, 49, 
1958, Rhode Island, 4, 4, 0, 0.50000, 152, 203, -51, 
1959, Rhode Island, 3, 5, 1, 0.38889, 64, 159, -95, 
1960, Rhode Island, 3, 5, 0, 0.37500, 132, 150, -18, 
1936, Alma (MI), 5, 2, 1, 0.68750, 91, 58, 33, 
1937, Alma (MI), 4, 4, 1, 0.50000, 60, 104, -44, 
1938, Alma (MI), 3, 5, 1, 0.38889, 84, 136, -52, 
1939, Alma (MI), 2, 5, 1, 0.31250, 92, 82, 10, 
1940, Alma (MI), 5, 2, 0, 0.71429, 135, 45, 90, 
1941, Alma (MI), 6, 0, 1, 0.92857, 131, 19, 112, 
1942, Alma (MI), 7, 0, 0, 1.00000, 163, 26, 137, 
1943, Alma (MI), 1, 5, 0, 0.16667, 14, 130, -116, 
1918, Boston (MA), 1, 3, 2, 0.33333, 20, 56, -36, 
1919, Boston (MA), 2, 3, 0, 0.40000, 34, 37, -3, 
1914, Louisiana St., 4, 4, 1, 0.50000, 163, 148, 15, 
1915, Louisiana St., 6, 2, 0, 0.75000, 126, 49, 77, 
1916, Louisiana St., 4, 1, 0, 0.80000, 146, 14, 132, 
1917, Wake Forest (NC), 1, 6, 1, 0.18750, 59, 215, -156, 
2013, Shippensburg (PA), 7, 4, 0, 0.63636, 411, 305, 106, 
1929, Lake Forest (IL), 2, 5, 0, 0.28571, 57, 74, -17, 
1930, Lake Forest (IL), 5, 1, 1, 0.78571, 125, 26, 99, 
1931, Lake Forest (IL), 1, 2, 4, 0.42857, 77, 65, 12, 
1932, Lake Forest (IL), 4, 3, 1, 0.56250, 87, 79, 8, 
1936, Swarthmore (PA), 2, 5, 0, 0.28571, 53, 138, -85, 
1937, Swarthmore (PA), 2, 4, 1, 0.35714, 73, 100, -27, 
1975, Tennessee-Martin, 2, 8, 0, 0.20000, 100, 164, -64, 
1976, Tennessee-Martin, 8, 3, 0, 0.72727, 276, 125, 151, 
1977, Tennessee-Martin, 8, 3, 0, 0.72727, 311, 185, 126, 
1979, Vanderbilt (TN), 1, 10, 0, 0.09091, 179, 418, -239, 
1980, Vanderbilt (TN), 2, 9, 0, 0.18182, 140, 352, -212, 
1981, Vanderbilt (TN), 4, 7, 0, 0.36364, 211, 281, -70, 
1982, Vanderbilt (TN), 8, 4, 0, 0.66667, 293, 242, 51, 
1983, Vanderbilt (TN), 2, 9, 0, 0.18182, 183, 274, -91, 
1984, Vanderbilt (TN), 5, 6, 0, 0.45455, 276, 277, -1, 
1985, Vanderbilt (TN), 3, 7, 1, 0.31818, 166, 308, -142, 
2010, San Jose St. (CA), 1, 12, 0, 0.07692, 209, 451, -242, 
2011, San Jose St. (CA), 5, 7, 0, 0.41667, 294, 364, -70, 
2012, San Jose St. (CA), 10, 2, 0, 0.83333, 423, 257, 166, 
2013, Colorado, 4, 8, 0, 0.33333, 305, 459, -154, 
1993, North Central (IL), 3, 6, 0, 0.33333, 205, 331, -126, 
1994, North Central (IL), 3, 6, 0, 0.33333, 152, 277, -125, 
1995, North Central (IL), 3, 5, 1, 0.38889, 136, 200, -64, 
1996, North Central (IL), 5, 4, 0, 0.55556, 207, 199, 8, 
1997, North Central (IL), 5, 4, 0, 0.55556, 252, 143, 109, 
1966, Oklahoma, 6, 4, 0, 0.60000, 192, 122, 70, 
1960, San Francisco (CA), 1, 3, 1, 0.30000, 34, 109, -75, 
1961, San Francisco (CA), 4, 2, 0, 0.66667, 96, 106, -10, 
1962, San Francisco (CA), 3, 3, 0, 0.50000, 66, 76, -10, 
1932, Butler (IN), 2, 4, 1, 0.35714, 41, 79, -38, 
1933, Butler (IN), 2, 6, 0, 0.25000, 77, 152, -75, 
1934, Butler (IN), 6, 1, 1, 0.81250, 125, 43, 82, 
1895, Virginia, 9, 3, 0, 0.75000, 206, 104, 102, 
1900, Detroit (MI), 3, 3, 0, 0.50000, 71, 23, 48, 
1901, Detroit (MI), 3, 3, 0, 0.50000, 66, 58, 8, 
1921, Kansas Wesleyan, 0, 8, 0, 0.00000, 6, 221, -215, 
1922, Kansas Wesleyan, 2, 7, 0, 0.22222, 30, 105, -75, 
1923, Kansas Wesleyan, 4, 5, 1, 0.45000, 108, 64, 44, 
1924, Kansas Wesleyan, 5, 3, 0, 0.62500, 88, 39, 49, 
1925, Kansas Wesleyan, 4, 2, 1, 0.64286, 67, 36, 31, 
1926, Kansas Wesleyan, 4, 4, 0, 0.50000, 90, 73, 17, 
1927, Kansas Wesleyan, 7, 0, 1, 0.93750, 223, 0, 223, 
1928, Kansas Wesleyan, 6, 2, 1, 0.72222, 159, 52, 107, 
1929, Kansas Wesleyan, 6, 0, 2, 0.87500, 164, 46, 118, 
1930, Kansas Wesleyan, 4, 3, 2, 0.55556, 153, 82, 71, 
1931, Kansas Wesleyan, 6, 0, 2, 0.87500, 163, 24, 139, 
1932, Kansas Wesleyan, 5, 3, 0, 0.62500, 116, 97, 19, 
1933, Kansas Wesleyan, 5, 4, 0, 0.55556, 109, 69, 40, 
1934, Kansas Wesleyan, 5, 4, 0, 0.55556, 128, 95, 33, 
1935, Kansas Wesleyan, 4, 3, 1, 0.56250, 81, 72, 9, 
1936, Kansas Wesleyan, 7, 1, 1, 0.83333, 162, 49, 113, 
1937, Kansas Wesleyan, 5, 3, 1, 0.61111, 74, 30, 44, 
1911, Michigan St., 5, 1, 0, 0.83333, 93, 30, 63, 
1912, Michigan St., 7, 1, 0, 0.87500, 297, 98, 199, 
1913, Michigan St., 7, 0, 0, 1.00000, 180, 28, 152, 
1914, Michigan St., 5, 2, 0, 0.71429, 188, 57, 131, 
1915, Michigan St., 5, 1, 0, 0.83333, 258, 38, 220, 
1978, Wake Forest (NC), 1, 10, 0, 0.09091, 104, 274, -170, 
1979, Wake Forest (NC), 8, 4, 0, 0.66667, 240, 283, -43, 
1980, Wake Forest (NC), 5, 6, 0, 0.45455, 251, 213, 38, 
1988, Illinois, 6, 5, 1, 0.54167, 245, 243, 2, 
1989, Illinois, 10, 2, 0, 0.83333, 332, 182, 150, 
1990, Illinois, 8, 4, 0, 0.66667, 293, 246, 47, 
1991, Illinois, 6, 5, 0, 0.54545, 261, 182, 79, 
1992, Texas, 6, 5, 0, 0.54545, 292, 282, 10, 
1993, Texas, 5, 5, 1, 0.50000, 281, 269, 12, 
1994, Texas, 8, 4, 0, 0.66667, 366, 291, 75, 
1995, Texas, 10, 2, 1, 0.80769, 390, 255, 135, 
1996, Texas, 8, 5, 0, 0.61538, 447, 305, 142, 
1997, Texas, 4, 7, 0, 0.36364, 283, 366, -83, 
2001, Arizona, 5, 6, 0, 0.45455, 320, 377, -57, 
2002, Arizona, 4, 8, 0, 0.33333, 227, 310, -83, 
2003, Arizona, 1, 4, 0, 0.20000, 82, 186, -104, 
2013, SUNY-Cortland (NY), 6, 5, 0, 0.54545, 309, 270, 39, 
1971, Massachusetts, 4, 4, 1, 0.50000, 147, 209, -62, 
1972, Massachusetts, 9, 2, 0, 0.81818, 369, 155, 214, 
1973, Massachusetts, 6, 5, 0, 0.54545, 231, 244, -13, 
1974, Massachusetts, 5, 6, 0, 0.45455, 219, 232, -13, 
1975, Massachusetts, 8, 2, 0, 0.80000, 210, 102, 108, 
1976, Massachusetts, 5, 5, 0, 0.50000, 146, 178, -32, 
1977, Massachusetts, 8, 3, 0, 0.72727, 274, 145, 129, 
1981, Syracuse (NY), 4, 6, 1, 0.40909, 248, 265, -17, 
1982, Syracuse (NY), 2, 9, 0, 0.18182, 159, 244, -85, 
1983, Syracuse (NY), 6, 5, 0, 0.54545, 178, 200, -22, 
1984, Syracuse (NY), 6, 5, 0, 0.54545, 151, 151, 0, 
1985, Syracuse (NY), 7, 5, 0, 0.58333, 284, 195, 89, 
1986, Syracuse (NY), 5, 6, 0, 0.45455, 241, 266, -25, 
1987, Syracuse (NY), 11, 0, 1, 0.95833, 379, 169, 210, 
1988, Syracuse (NY), 10, 2, 0, 0.83333, 341, 189, 152, 
1989, Syracuse (NY), 8, 4, 0, 0.66667, 286, 242, 44, 
1990, Syracuse (NY), 7, 4, 2, 0.61538, 341, 213, 128, 
1908, Connecticut, 4, 3, 1, 0.56250, 150, 49, 101, 
1904, Utah, 7, 1, 0, 0.87500, 301, 38, 263, 
1905, Utah, 6, 2, 0, 0.75000, 260, 74, 186, 
1906, Utah, 6, 1, 0, 0.85714, 170, 6, 164, 
1907, Utah, 7, 2, 0, 0.77778, 147, 66, 81, 
1908, Utah, 4, 2, 1, 0.64286, 211, 49, 162, 
1909, Utah, 6, 1, 0, 0.85714, 180, 19, 161, 
1924, Oregon, 4, 3, 2, 0.55556, 94, 66, 28, 
1966, Mississippi Valley St., 2, 7, 0, 0.22222, 184, 248, -64, 
1967, Mississippi Valley St., 2, 7, 0, 0.22222, 83, 294, -211, 
1968, Norfolk St. (VA), 2, 5, 1, 0.31250, 149, 203, -54, 
1969, Norfolk St. (VA), 4, 4, 0, 0.50000, 168, 161, 7, 
1970, Norfolk St. (VA), 3, 6, 0, 0.33333, 177, 204, -27, 
1971, Norfolk St. (VA), 2, 6, 0, 0.25000, 66, 214, -148, 
1988, Troy (AL), 4, 6, 0, 0.40000, 215, 184, 31, 
1989, Troy (AL), 4, 6, 0, 0.40000, 160, 230, -70, 
1990, Troy (AL), 5, 5, 0, 0.50000, 228, 209, 19, 
1921, Saint Mary's (CA), 4, 3, 0, 0.57143, 155, 70, 85, 
1922, Saint Mary's (CA), 3, 6, 0, 0.33333, 67, 151, -84, 
1923, Saint Mary's (CA), 5, 3, 1, 0.61111, 212, 111, 101, 
1924, Saint Mary's (CA), 8, 1, 0, 0.88889, 205, 50, 155, 
1925, Saint Mary's (CA), 8, 2, 0, 0.80000, 313, 72, 241, 
1926, Saint Mary's (CA), 9, 0, 1, 0.95000, 242, 27, 215, 
1927, Saint Mary's (CA), 7, 2, 1, 0.75000, 155, 28, 127, 
1928, Saint Mary's (CA), 5, 4, 0, 0.55556, 105, 59, 46, 
1929, Saint Mary's (CA), 8, 0, 1, 0.94444, 198, 6, 192, 
1930, Saint Mary's (CA), 8, 1, 0, 0.88889, 168, 31, 137, 
1931, Saint Mary's (CA), 8, 2, 0, 0.80000, 119, 65, 54, 
1932, Saint Mary's (CA), 6, 2, 1, 0.72222, 118, 59, 59, 
1933, Saint Mary's (CA), 6, 3, 1, 0.65000, 161, 73, 88, 
1934, Saint Mary's (CA), 7, 2, 0, 0.77778, 125, 40, 85, 
1935, Saint Mary's (CA), 5, 2, 2, 0.66667, 115, 37, 78, 
1936, Saint Mary's (CA), 6, 3, 1, 0.65000, 140, 80, 60, 
1937, Saint Mary's (CA), 4, 3, 2, 0.55556, 71, 50, 21, 
1938, Saint Mary's (CA), 6, 2, 0, 0.75000, 106, 41, 65, 
1939, Saint Mary's (CA), 3, 4, 1, 0.43750, 84, 57, 27, 
1943, Iowa, 1, 6, 1, 0.18750, 83, 153, -70, 
1944, Iowa, 1, 7, 0, 0.12500, 53, 240, -187, 
2013, Saint Ambrose (IA), 7, 4, 0, 0.63636, 486, 312, 174, 
1935, Ball St. (IN), 3, 4, 1, 0.43750, 77, 66, 11, 
1936, Ball St. (IN), 3, 4, 1, 0.43750, 78, 55, 23, 
1937, Ball St. (IN), 5, 2, 1, 0.68750, 135, 38, 97, 
1938, Ball St. (IN), 6, 1, 1, 0.81250, 131, 48, 83, 
1939, Ball St. (IN), 6, 2, 0, 0.75000, 112, 69, 43, 
1940, Ball St. (IN), 3, 4, 1, 0.43750, 78, 69, 9, 
1941, Ball St. (IN), 3, 2, 2, 0.57143, 98, 26, 72, 
1942, Ball St. (IN), 6, 2, 0, 0.75000, 178, 58, 120, 
1944, Ball St. (IN), 2, 2, 0, 0.50000, 58, 45, 13, 
1945, Ball St. (IN), 4, 1, 1, 0.75000, 119, 27, 92, 
1946, Ball St. (IN), 3, 4, 1, 0.43750, 101, 67, 34, 
1947, Ball St. (IN), 5, 1, 2, 0.75000, 99, 53, 46, 
1948, Ball St. (IN), 6, 2, 0, 0.75000, 155, 73, 82, 
1949, Ball St. (IN), 8, 0, 0, 1.00000, 276, 61, 215, 
1950, Ball St. (IN), 2, 4, 1, 0.35714, 74, 122, -48, 
1951, Ball St. (IN), 0, 6, 1, 0.07143, 94, 176, -82, 
1952, Ball St. (IN), 3, 5, 1, 0.38889, 164, 167, -3, 
1908, North Dakota St., 2, 3, 0, 0.40000, 55, 51, 4, 
1910, George Washington (DC), 2, 2, 2, 0.50000, 31, 37, -6, 
1920, East Stroudsburg (PA), 6, 3, 0, 0.66667, 175, 148, 27, 
1921, East Stroudsburg (PA), 1, 3, 1, 0.30000, 30, 71, -41, 
1924, Saint Francis (PA), 2, 3, 0, 0.40000, 89, 125, -36, 
1966, Central Missouri St., 4, 5, 0, 0.44444, 168, 179, -11, 
1967, Central Missouri St., 6, 4, 0, 0.60000, 183, 156, 27, 
1968, Central Missouri St., 7, 2, 1, 0.75000, 242, 123, 119, 
1969, Central Missouri St., 5, 4, 0, 0.55556, 258, 207, 51, 
1970, Central Missouri St., 9, 2, 0, 0.81818, 291, 177, 114, 
1971, Central Missouri St., 4, 6, 0, 0.40000, 132, 166, -34, 
1972, Central Missouri St., 3, 7, 1, 0.31818, 201, 227, -26, 
1973, Central Missouri St., 2, 8, 0, 0.20000, 146, 240, -94, 
1974, Central Missouri St., 3, 7, 1, 0.31818, 200, 216, -16, 
1930, Boston (MA), 1, 7, 1, 0.16667, 33, 235, -202, 
1931, Boston (MA), 1, 8, 0, 0.11111, 40, 97, -57, 
1943, Princeton (NJ), 2, 6, 0, 0.25000, 157, 238, -81, 
1944, Princeton (NJ), 1, 2, 0, 0.33333, 22, 40, -18, 
1987, Murray St. (KY), 6, 5, 0, 0.54545, 285, 197, 88, 
1988, Murray St. (KY), 4, 6, 0, 0.40000, 206, 205, 1, 
1989, Murray St. (KY), 6, 4, 1, 0.59091, 284, 258, 26, 
1990, Murray St. (KY), 2, 9, 0, 0.18182, 95, 429, -334, 
1991, Murray St. (KY), 3, 8, 0, 0.27273, 162, 313, -151, 
1992, Murray St. (KY), 2, 9, 0, 0.18182, 166, 317, -151, 
1998, Assumption (MA), 0, 9, 0, 0.00000, 100, 341, -241, 
1999, Assumption (MA), 3, 7, 0, 0.30000, 216, 320, -104, 
2000, Assumption (MA), 5, 6, 0, 0.45455, 265, 308, -43, 
2001, Assumption (MA), 1, 10, 0, 0.09091, 198, 383, -185, 
2002, Assumption (MA), 2, 9, 0, 0.18182, 120, 346, -226, 
2003, Assumption (MA), 4, 7, 0, 0.36364, 151, 322, -171, 
1914, Boston College (MA), 5, 4, 0, 0.55556, 119, 80, 39, 
1915, Boston College (MA), 3, 4, 0, 0.42857, 45, 69, -24, 
1970, Iona (NY), 3, 5, 0, 0.37500, 117, 152, -35, 
1971, Iona (NY), 7, 1, 0, 0.87500, 237, 94, 143, 
1899, Doane (NE), 2, 2, 0, 0.50000, 53, 26, 27, 
1900, Doane (NE), 2, 2, 0, 0.50000, 30, 55, -25, 
1953, Central Connecticut St., 1, 4, 1, 0.25000, 59, 129, -70, 
1954, Central Connecticut St., 6, 0, 0, 1.00000, 158, 26, 132, 
1955, Central Connecticut St., 4, 3, 0, 0.57143, 67, 86, -19, 
1956, Central Connecticut St., 3, 3, 0, 0.50000, 78, 122, -44, 
1957, Central Connecticut St., 3, 5, 0, 0.37500, 103, 137, -34, 
1958, Central Connecticut St., 0, 7, 1, 0.06250, 36, 198, -162, 
1919, Wofford (SC), 3, 2, 1, 0.58333, 76, 27, 49, 
1922, Wofford (SC), 2, 7, 0, 0.22222, 25, 200, -175, 
1923, Wofford (SC), 6, 3, 0, 0.66667, 115, 106, 9, 
1924, Wofford (SC), 3, 7, 0, 0.30000, 41, 137, -96, 
1925, Wofford (SC), 3, 7, 0, 0.30000, 134, 76, 58, 
1926, Wofford (SC), 2, 8, 0, 0.20000, 71, 184, -113, 
1968, Iowa St., 3, 7, 0, 0.30000, 178, 263, -85, 
1969, Iowa St., 3, 7, 0, 0.30000, 152, 231, -79, 
1970, Iowa St., 5, 6, 0, 0.45455, 248, 284, -36, 
1971, Iowa St., 8, 4, 0, 0.66667, 337, 250, 87, 
1972, Iowa St., 5, 6, 1, 0.45833, 319, 238, 81, 
1973, Pittsburgh (PA), 6, 5, 1, 0.54167, 225, 211, 14, 
1974, Pittsburgh (PA), 7, 4, 0, 0.63636, 227, 202, 25, 
1975, Pittsburgh (PA), 8, 4, 0, 0.66667, 322, 161, 161, 
1976, Pittsburgh (PA), 12, 0, 0, 1.00000, 381, 133, 248, 
1977, Tennessee, 4, 7, 0, 0.36364, 229, 229, 0, 
1978, Tennessee, 5, 5, 1, 0.50000, 251, 209, 42, 
1979, Tennessee, 7, 5, 0, 0.58333, 311, 235, 76, 
1980, Tennessee, 5, 6, 0, 0.45455, 256, 189, 67, 
1981, Tennessee, 8, 4, 0, 0.66667, 244, 265, -21, 
1982, Tennessee, 6, 5, 1, 0.54167, 281, 239, 42, 
1983, Tennessee, 9, 3, 0, 0.75000, 282, 165, 117, 
1984, Tennessee, 7, 4, 1, 0.62500, 327, 276, 51, 
1985, Tennessee, 9, 1, 2, 0.83333, 325, 140, 185, 
1986, Tennessee, 7, 5, 0, 0.58333, 293, 249, 44, 
1987, Tennessee, 10, 2, 1, 0.80769, 422, 246, 176, 
1988, Tennessee, 5, 6, 0, 0.45455, 212, 286, -74, 
1989, Tennessee, 11, 1, 0, 0.91667, 346, 217, 129, 
1990, Tennessee, 9, 2, 2, 0.76923, 465, 220, 245, 
1991, Tennessee, 9, 3, 0, 0.75000, 352, 263, 89, 
1992, Tennessee, 5, 3, 0, 0.62500, 206, 125, 81, 
1993, Pittsburgh (PA), 3, 8, 0, 0.27273, 168, 371, -203, 
1994, Pittsburgh (PA), 3, 8, 0, 0.27273, 246, 307, -61, 
1995, Pittsburgh (PA), 2, 9, 0, 0.18182, 217, 329, -112, 
1996, Pittsburgh (PA), 4, 7, 0, 0.36364, 214, 430, -216, 
1957, Sewanee (TN), 5, 2, 1, 0.68750, 158, 83, 75, 
1958, Sewanee (TN), 8, 0, 0, 1.00000, 285, 28, 257, 
1959, Sewanee (TN), 4, 3, 1, 0.56250, 85, 121, -36, 
1960, Sewanee (TN), 4, 3, 1, 0.56250, 104, 162, -58, 
1961, Sewanee (TN), 5, 2, 1, 0.68750, 145, 101, 44, 
1962, Sewanee (TN), 4, 3, 1, 0.56250, 144, 60, 84, 
1963, Sewanee (TN), 8, 0, 0, 1.00000, 275, 45, 230, 
1964, Sewanee (TN), 8, 1, 0, 0.88889, 305, 63, 242, 
1965, Sewanee (TN), 7, 1, 0, 0.87500, 180, 38, 142, 
1966, Sewanee (TN), 2, 6, 0, 0.25000, 100, 173, -73, 
1967, Sewanee (TN), 5, 3, 0, 0.62500, 193, 95, 98, 
1968, Sewanee (TN), 4, 4, 0, 0.50000, 133, 124, 9, 
1969, Sewanee (TN), 2, 6, 0, 0.25000, 165, 236, -71, 
1970, Sewanee (TN), 2, 6, 0, 0.25000, 112, 170, -58, 
1971, Sewanee (TN), 2, 6, 0, 0.25000, 118, 149, -31, 
1972, Sewanee (TN), 3, 5, 0, 0.37500, 89, 158, -69, 
1973, Sewanee (TN), 5, 3, 0, 0.62500, 167, 82, 85, 
1974, Sewanee (TN), 2, 6, 0, 0.25000, 40, 86, -46, 
1975, Sewanee (TN), 6, 3, 0, 0.66667, 191, 150, 41, 
1976, Sewanee (TN), 5, 4, 0, 0.55556, 146, 139, 7, 
1977, Sewanee (TN), 2, 7, 0, 0.22222, 116, 207, -91, 
1960, Temple (PA), 2, 7, 0, 0.22222, 113, 137, -24, 
1961, Temple (PA), 2, 5, 2, 0.33333, 86, 129, -43, 
1962, Temple (PA), 3, 6, 0, 0.33333, 133, 115, 18, 
1963, Temple (PA), 5, 3, 1, 0.61111, 209, 130, 79, 
1964, Temple (PA), 7, 2, 0, 0.77778, 247, 128, 119, 
1965, Temple (PA), 5, 5, 0, 0.50000, 203, 210, -7, 
1966, Temple (PA), 6, 3, 0, 0.66667, 266, 196, 70, 
1967, Temple (PA), 7, 2, 0, 0.77778, 201, 224, -23, 
1968, Temple (PA), 4, 6, 0, 0.40000, 240, 241, -1, 
1969, Temple (PA), 4, 5, 1, 0.45000, 180, 144, 36, 
1978, Marist (NY), 1, 8, 0, 0.11111, 89, 249, -160, 
1979, Marist (NY), 3, 5, 0, 0.37500, 85, 131, -46, 
1980, Marist (NY), 2, 7, 0, 0.22222, 143, 181, -38, 
1981, Marist (NY), 2, 7, 0, 0.22222, 111, 259, -148, 
1982, Marist (NY), 2, 7, 0, 0.22222, 172, 240, -68, 
1983, Marist (NY), 3, 6, 0, 0.33333, 92, 189, -97, 
1984, Marist (NY), 3, 7, 0, 0.30000, 71, 151, -80, 
1985, Marist (NY), 6, 3, 0, 0.66667, 126, 70, 56, 
1986, Marist (NY), 4, 5, 0, 0.44444, 171, 182, -11, 
1987, Marist (NY), 2, 7, 0, 0.22222, 116, 162, -46, 
1988, Marist (NY), 3, 6, 0, 0.33333, 137, 171, -34, 
1936, San Francisco (CA), 4, 4, 2, 0.50000, 103, 114, -11, 
1937, San Francisco (CA), 4, 5, 1, 0.45000, 48, 85, -37, 
1938, San Francisco (CA), 5, 2, 1, 0.68750, 93, 26, 67, 
1939, San Francisco (CA), 4, 3, 3, 0.55000, 92, 91, 1, 
1940, San Francisco (CA), 1, 6, 1, 0.18750, 73, 125, -52, 
1959, Santa Clara (CA), 4, 1, 0, 0.80000, 111, 62, 49, 
1960, Santa Clara (CA), 4, 3, 0, 0.57143, 161, 120, 41, 
1961, Santa Clara (CA), 2, 3, 1, 0.41667, 141, 147, -6, 
1962, Santa Clara (CA), 3, 6, 0, 0.33333, 180, 191, -11, 
1963, Santa Clara (CA), 6, 3, 0, 0.66667, 233, 115, 118, 
1964, Santa Clara (CA), 7, 2, 0, 0.77778, 212, 83, 129, 
1965, Santa Clara (CA), 8, 1, 0, 0.88889, 193, 79, 114, 
1966, Santa Clara (CA), 7, 2, 0, 0.77778, 211, 115, 96, 
1967, Santa Clara (CA), 8, 1, 0, 0.88889, 259, 149, 110, 
1968, Santa Clara (CA), 4, 5, 0, 0.44444, 154, 176, -22, 
1969, Santa Clara (CA), 6, 4, 0, 0.60000, 270, 222, 48, 
1970, Santa Clara (CA), 5, 4, 1, 0.55000, 303, 279, 24, 
1971, Santa Clara (CA), 6, 4, 0, 0.60000, 263, 168, 95, 
1972, Santa Clara (CA), 4, 4, 1, 0.50000, 222, 197, 25, 
1973, Santa Clara (CA), 4, 6, 0, 0.40000, 168, 231, -63, 
1974, Santa Clara (CA), 7, 3, 0, 0.70000, 207, 209, -2, 
1975, Santa Clara (CA), 6, 5, 0, 0.54545, 308, 264, 44, 
1976, Santa Clara (CA), 7, 4, 0, 0.63636, 308, 306, 2, 
1977, Santa Clara (CA), 2, 7, 1, 0.25000, 185, 244, -59, 
1978, Santa Clara (CA), 5, 6, 0, 0.45455, 178, 214, -36, 
1979, Santa Clara (CA), 7, 3, 0, 0.70000, 270, 137, 133, 
1980, Santa Clara (CA), 9, 3, 0, 0.75000, 341, 254, 87, 
1981, Santa Clara (CA), 2, 8, 0, 0.20000, 132, 233, -101, 
1982, Santa Clara (CA), 7, 4, 0, 0.63636, 255, 217, 38, 
1983, Santa Clara (CA), 6, 4, 0, 0.60000, 173, 144, 29, 
1984, Santa Clara (CA), 7, 4, 0, 0.63636, 213, 145, 68, 
1985, Santa Clara (CA), 8, 2, 1, 0.77273, 306, 203, 103, 
1986, Santa Clara (CA), 4, 7, 0, 0.36364, 230, 334, -104, 
1987, Santa Clara (CA), 6, 5, 0, 0.54545, 204, 190, 14, 
1988, Santa Clara (CA), 7, 4, 0, 0.63636, 251, 233, 18, 
1989, Santa Clara (CA), 7, 4, 0, 0.63636, 250, 211, 39, 
1990, Santa Clara (CA), 6, 5, 0, 0.54545, 251, 231, 20, 
1991, Santa Clara (CA), 5, 6, 0, 0.45455, 309, 281, 28, 
1992, Santa Clara (CA), 4, 6, 0, 0.40000, 245, 334, -89, 
1892, Wabash (IN), 2, 3, 0, 0.40000, 64, 152, -88, 
1936, Johns Hopkins (MD), 1, 6, 0, 0.14286, 49, 129, -80, 
1937, Johns Hopkins (MD), 4, 2, 0, 0.66667, 71, 90, -19, 
1938, Johns Hopkins (MD), 3, 1, 2, 0.66667, 39, 19, 20, 
1939, Johns Hopkins (MD), 3, 3, 0, 0.50000, 52, 72, -20, 
1940, Johns Hopkins (MD), 1, 4, 1, 0.25000, 27, 92, -65, 
1941, Johns Hopkins (MD), 1, 5, 0, 0.16667, 27, 98, -71, 
1942, Johns Hopkins (MD), 0, 4, 1, 0.10000, 32, 120, -88, 
1944, Johns Hopkins (MD), 1, 0, 2, 0.66667, 12, 0, 12, 
1945, Johns Hopkins (MD), 3, 1, 0, 0.75000, 71, 39, 32, 
1969, Miami (OH), 7, 3, 0, 0.70000, 231, 139, 92, 
1970, Miami (OH), 7, 3, 0, 0.70000, 187, 112, 75, 
1971, Miami (OH), 7, 3, 0, 0.70000, 207, 117, 90, 
1972, Miami (OH), 7, 3, 0, 0.70000, 232, 116, 116, 
1973, Miami (OH), 11, 0, 0, 1.00000, 223, 76, 147, 
1974, Colorado, 5, 6, 0, 0.45455, 226, 307, -81, 
1975, Colorado, 9, 3, 0, 0.75000, 331, 251, 80, 
1976, Colorado, 8, 4, 0, 0.66667, 305, 225, 80, 
1977, Colorado, 7, 3, 1, 0.68182, 266, 174, 92, 
1978, Colorado, 6, 5, 0, 0.54545, 230, 206, 24, 
1980, Northern Illinois, 7, 4, 0, 0.63636, 216, 175, 41, 
1981, Northern Illinois, 3, 8, 0, 0.27273, 160, 217, -57, 
1982, Northern Illinois, 5, 5, 0, 0.50000, 137, 136, 1, 
1983, Northern Illinois, 10, 2, 0, 0.83333, 314, 203, 111, 
1984, Indiana, 0, 11, 0, 0.00000, 185, 338, -153, 
1985, Indiana, 4, 7, 0, 0.36364, 251, 340, -89, 
1986, Indiana, 6, 6, 0, 0.50000, 273, 227, 46, 
1987, Indiana, 8, 4, 0, 0.66667, 283, 238, 45, 
1988, Indiana, 8, 3, 1, 0.70833, 396, 235, 161, 
1989, Indiana, 5, 6, 0, 0.45455, 289, 262, 27, 
1990, Indiana, 6, 5, 1, 0.54167, 329, 238, 91, 
1991, Indiana, 7, 4, 1, 0.62500, 305, 224, 81, 
1992, Indiana, 5, 6, 0, 0.45455, 177, 197, -20, 
1993, Indiana, 8, 4, 0, 0.66667, 259, 197, 62, 
1994, Indiana, 7, 4, 0, 0.63636, 294, 285, 9, 
1995, Indiana, 2, 9, 0, 0.18182, 159, 326, -167, 
1996, Indiana, 3, 8, 0, 0.27273, 242, 291, -49, 
1948, Elon (NC), 4, 5, 1, 0.45000, 100, 157, -57, 
1949, Elon (NC), 8, 2, 0, 0.80000, 294, 72, 222, 
1950, Elon (NC), 7, 2, 1, 0.75000, 207, 148, 59, 
1951, Elon (NC), 6, 3, 0, 0.66667, 196, 155, 41, 
1952, Elon (NC), 3, 6, 1, 0.35000, 91, 191, -100, 
1962, Augustana (SD), 6, 3, 0, 0.66667, 125, 118, 7, 
1963, Augustana (SD), 2, 8, 0, 0.20000, 136, 200, -64, 
1964, Augustana (SD), 1, 8, 0, 0.11111, 68, 322, -254, 
1965, Augustana (SD), 1, 6, 1, 0.18750, 105, 170, -65, 
1966, Augustana (SD), 5, 4, 0, 0.55556, 184, 188, -4, 
1967, Augustana (SD), 4, 5, 0, 0.44444, 146, 234, -88, 
1968, Augustana (SD), 2, 7, 0, 0.22222, 166, 305, -139, 
1969, Bemidji St. (MN), 5, 3, 1, 0.61111, 174, 82, 92, 
1970, Bemidji St. (MN), 1, 8, 0, 0.11111, 113, 274, -161, 
1971, Bemidji St. (MN), 3, 5, 1, 0.38889, 154, 239, -85, 
1972, Bemidji St. (MN), 2, 7, 0, 0.22222, 84, 231, -147, 
1973, Bemidji St. (MN), 5, 4, 0, 0.55556, 163, 158, 5, 
1951, Louisiana-Monroe, 6, 2, 0, 0.75000, 253, 128, 125, 
1952, Louisiana-Monroe, 5, 4, 0, 0.55556, 243, 210, 33, 
1953, Louisiana-Monroe, 1, 9, 0, 0.10000, 113, 284, -171, 
1994, Chicago (IL), 5, 5, 0, 0.50000, 174, 177, -3, 
1995, Chicago (IL), 8, 2, 0, 0.80000, 315, 186, 129, 
1996, Chicago (IL), 4, 5, 0, 0.44444, 173, 207, -34, 
1997, Chicago (IL), 5, 4, 0, 0.55556, 179, 195, -16, 
1998, Chicago (IL), 7, 2, 0, 0.77778, 156, 94, 62, 
1999, Chicago (IL), 5, 4, 0, 0.55556, 121, 102, 19, 
2000, Chicago (IL), 7, 2, 0, 0.77778, 193, 106, 87, 
2001, Chicago (IL), 6, 3, 0, 0.66667, 263, 178, 85, 
2002, Chicago (IL), 4, 5, 0, 0.44444, 247, 249, -2, 
2003, Chicago (IL), 2, 7, 0, 0.22222, 164, 268, -104, 
2004, Chicago (IL), 3, 6, 0, 0.33333, 229, 207, 22, 
2005, Chicago (IL), 5, 4, 0, 0.55556, 226, 116, 110, 
2006, Chicago (IL), 4, 5, 0, 0.44444, 193, 156, 37, 
2007, Chicago (IL), 4, 5, 0, 0.44444, 196, 216, -20, 
2008, Chicago (IL), 3, 6, 0, 0.33333, 182, 234, -52, 
2009, Chicago (IL), 5, 4, 0, 0.55556, 242, 252, -10, 
2010, Chicago (IL), 8, 2, 0, 0.80000, 317, 190, 127, 
2011, Chicago (IL), 5, 5, 0, 0.50000, 227, 250, -23, 
2012, Chicago (IL), 4, 6, 0, 0.40000, 160, 205, -45, 
1974, Syracuse (NY), 2, 9, 0, 0.18182, 121, 271, -150, 
1975, Syracuse (NY), 6, 5, 0, 0.54545, 174, 182, -8, 
1976, Syracuse (NY), 3, 8, 0, 0.27273, 154, 263, -109, 
1977, Syracuse (NY), 6, 5, 0, 0.54545, 218, 234, -16, 
1978, Syracuse (NY), 3, 8, 0, 0.27273, 192, 295, -103, 
1979, Syracuse (NY), 7, 5, 0, 0.58333, 324, 293, 31, 
1980, Syracuse (NY), 5, 6, 0, 0.45455, 207, 222, -15, 
1923, Georgetown (DC), 3, 6, 0, 0.33333, 79, 100, -21, 
2012, Arkansas St., 9, 3, 0, 0.75000, 437, 305, 132, 
2013, Auburn (AL), 12, 2, 0, 0.85714, 553, 346, 207, 
1949, West Alabama, 7, 2, 1, 0.75000, 135, 105, 30, 
1950, West Alabama, 6, 3, 1, 0.65000, 292, 147, 145, 
1951, West Alabama, 5, 5, 0, 0.50000, 223, 188, 35, 
1910, Wisconsin-Oshkosh, 3, 2, 1, 0.58333, 137, 44, 93, 
1911, Wisconsin-Oshkosh, 6, 2, 1, 0.72222, 96, 49, 47, 
1924, Cooper Union (NY), 0, 6, 0, 0.00000, 0, 211, -211, 
1925, Cooper Union (NY), 0, 3, 1, 0.12500, 6, 86, -80, 
2002, Kansas, 2, 10, 0, 0.16667, 248, 507, -259, 
2003, Kansas, 6, 7, 0, 0.46154, 384, 396, -12, 
2004, Kansas, 4, 7, 0, 0.36364, 262, 235, 27, 
2005, Kansas, 7, 5, 0, 0.58333, 269, 264, 5, 
2006, Kansas, 6, 6, 0, 0.50000, 348, 306, 42, 
2007, Kansas, 12, 1, 0, 0.92308, 556, 213, 343, 
2008, Kansas, 8, 5, 0, 0.61538, 434, 375, 59, 
2009, Kansas, 5, 7, 0, 0.41667, 353, 341, 12, 
2013, SUNY-Brockport (NY), 8, 3, 0, 0.72727, 335, 219, 116, 
1977, Fort Valley St. (GA), 5, 5, 0, 0.50000, 172, 172, 0, 
1978, Fort Valley St. (GA), 6, 3, 2, 0.63636, 145, 112, 33, 
1998, Cornell (NY), 4, 6, 0, 0.40000, 159, 200, -41, 
1999, Cornell (NY), 7, 3, 0, 0.70000, 254, 235, 19, 
2000, Cornell (NY), 5, 5, 0, 0.50000, 264, 334, -70, 
2012, Columbia (NY), 3, 7, 0, 0.30000, 145, 272, -127, 
2013, Columbia (NY), 0, 10, 0, 0.00000, 73, 402, -329, 
2002, Delaware Valley (PA), 2, 8, 0, 0.20000, 196, 382, -186, 
2003, Delaware Valley (PA), 9, 2, 0, 0.81818, 408, 315, 93, 
2004, Delaware Valley (PA), 12, 1, 0, 0.92308, 357, 253, 104, 
2005, Delaware Valley (PA), 12, 1, 0, 0.92308, 450, 237, 213, 
1969, Widener (PA), 2, 7, 0, 0.22222, 81, 191, -110, 
1970, Widener (PA), 5, 4, 0, 0.55556, 197, 114, 83, 
1971, Widener (PA), 7, 3, 0, 0.70000, 217, 141, 76, 
1972, Widener (PA), 8, 1, 0, 0.88889, 287, 81, 206, 
1973, Widener (PA), 8, 1, 0, 0.88889, 338, 90, 248, 
1974, Widener (PA), 8, 1, 0, 0.88889, 270, 111, 159, 
1975, Widener (PA), 10, 1, 0, 0.90909, 307, 103, 204, 
1976, Widener (PA), 8, 1, 0, 0.88889, 261, 98, 163, 
1977, Widener (PA), 11, 1, 0, 0.91667, 378, 139, 239, 
1978, Widener (PA), 8, 1, 0, 0.88889, 203, 69, 134, 
1979, Widener (PA), 10, 1, 0, 0.90909, 331, 115, 216, 
1980, Widener (PA), 11, 1, 0, 0.91667, 500, 118, 382, 
1981, Widener (PA), 13, 0, 0, 1.00000, 319, 106, 213, 
1982, Widener (PA), 9, 2, 0, 0.81818, 267, 117, 150, 
1983, Widener (PA), 7, 3, 0, 0.70000, 224, 137, 87, 
1984, Widener (PA), 8, 3, 0, 0.72727, 307, 193, 114, 
1985, Widener (PA), 7, 3, 0, 0.70000, 227, 108, 119, 
1986, Widener (PA), 7, 4, 0, 0.63636, 176, 141, 35, 
1987, Widener (PA), 8, 2, 0, 0.80000, 276, 125, 151, 
1988, Widener (PA), 9, 2, 0, 0.81818, 306, 103, 203, 
1989, Widener (PA), 8, 2, 0, 0.80000, 239, 112, 127, 
1990, Widener (PA), 7, 2, 1, 0.75000, 179, 104, 75, 
1991, Widener (PA), 3, 7, 0, 0.30000, 122, 185, -63, 
1992, Delaware Valley (PA), 3, 7, 0, 0.30000, 176, 207, -31, 
1993, Delaware Valley (PA), 2, 8, 0, 0.20000, 153, 299, -146, 
1994, Delaware Valley (PA), 2, 7, 0, 0.22222, 126, 321, -195, 
1995, Delaware Valley (PA), 3, 7, 0, 0.30000, 122, 230, -108, 
1997, La Salle (PA), 1, 8, 0, 0.11111, 104, 367, -263, 
1998, La Salle (PA), 3, 6, 0, 0.33333, 171, 267, -96, 
1999, La Salle (PA), 4, 6, 0, 0.40000, 181, 252, -71, 
2000, La Salle (PA), 7, 4, 0, 0.63636, 217, 211, 6, 
2001, La Salle (PA), 5, 4, 0, 0.55556, 154, 206, -52, 
1903, Rutgers (NJ), 4, 4, 1, 0.50000, 94, 110, -16, 
1905, Rutgers (NJ), 3, 6, 0, 0.33333, 44, 99, -55, 
1903, Delaware, 4, 4, 0, 0.50000, 77, 69, 8, 
1904, Delaware, 1, 5, 1, 0.21429, 24, 105, -81, 
1905, Delaware, 3, 4, 1, 0.43750, 52, 43, 9, 
1977, Saint Mary's (CA), 4, 5, 0, 0.44444, 160, 140, 20, 
1978, Saint Mary's (CA), 7, 3, 0, 0.70000, 243, 181, 62, 
1979, Saint Mary's (CA), 6, 4, 0, 0.60000, 207, 135, 72, 
1980, Saint Mary's (CA), 5, 6, 0, 0.45455, 276, 205, 71, 
1981, Saint Mary's (CA), 7, 3, 0, 0.70000, 252, 122, 130, 
1982, Saint Mary's (CA), 7, 2, 1, 0.75000, 238, 129, 109, 
1983, Saint Mary's (CA), 8, 2, 0, 0.80000, 187, 103, 84, 
1974, Eastern Michigan, 4, 6, 1, 0.40909, 143, 178, -35, 
1975, Eastern Michigan, 4, 6, 0, 0.40000, 198, 171, 27, 
1898, Connecticut, 0, 3, 0, 0.00000, 0, 89, -89, 
1989, Bucknell (PA), 5, 5, 0, 0.50000, 253, 260, -7, 
1990, Bucknell (PA), 7, 4, 0, 0.63636, 337, 278, 59, 
1991, Bucknell (PA), 1, 9, 0, 0.10000, 99, 326, -227, 
1992, Bucknell (PA), 4, 7, 0, 0.36364, 201, 318, -117, 
1993, Bucknell (PA), 4, 7, 0, 0.36364, 193, 302, -109, 
1994, Bucknell (PA), 5, 6, 0, 0.45455, 272, 311, -39, 
1981, Michigan Tech, 1, 8, 0, 0.11111, 116, 244, -128, 
1982, Michigan Tech, 1, 8, 0, 0.11111, 160, 289, -129, 
1983, Michigan Tech, 3, 7, 0, 0.30000, 232, 289, -57, 
1984, Michigan Tech, 4, 6, 0, 0.40000, 288, 325, -37, 
1973, Dayton (OH), 5, 5, 1, 0.50000, 158, 206, -48, 
1974, Dayton (OH), 3, 8, 0, 0.27273, 191, 310, -119, 
1975, Dayton (OH), 5, 6, 0, 0.45455, 202, 222, -20, 
1976, Dayton (OH), 4, 7, 0, 0.36364, 185, 228, -43, 
1949, Georgetown (DC), 5, 5, 0, 0.50000, 139, 210, -71, 
1950, Georgetown (DC), 2, 7, 0, 0.22222, 116, 187, -71, 
1990, Johns Hopkins (MD), 5, 4, 1, 0.55000, 186, 171, 15, 
1991, Johns Hopkins (MD), 5, 4, 1, 0.55000, 227, 155, 72, 
1992, Johns Hopkins (MD), 6, 4, 0, 0.60000, 190, 193, -3, 
1993, Johns Hopkins (MD), 4, 6, 0, 0.40000, 191, 207, -16, 
1994, Johns Hopkins (MD), 4, 6, 0, 0.40000, 133, 151, -18, 
1995, Johns Hopkins (MD), 6, 3, 1, 0.65000, 197, 126, 71, 
1996, Johns Hopkins (MD), 7, 3, 0, 0.70000, 162, 106, 56, 
1997, Johns Hopkins (MD), 7, 3, 0, 0.70000, 264, 159, 105, 
1998, Johns Hopkins (MD), 7, 3, 0, 0.70000, 288, 195, 93, 
1999, Johns Hopkins (MD), 4, 6, 0, 0.40000, 248, 260, -12, 
2000, Johns Hopkins (MD), 5, 5, 0, 0.50000, 257, 233, 24, 
2001, Johns Hopkins (MD), 6, 3, 0, 0.66667, 202, 126, 76, 
2002, Johns Hopkins (MD), 9, 2, 0, 0.81818, 270, 178, 92, 
2003, Johns Hopkins (MD), 10, 1, 0, 0.90909, 315, 77, 238, 
2004, Johns Hopkins (MD), 9, 2, 0, 0.81818, 259, 165, 94, 
2005, Johns Hopkins (MD), 8, 3, 0, 0.72727, 177, 147, 30, 
2006, Johns Hopkins (MD), 5, 5, 0, 0.50000, 185, 147, 38, 
2007, Johns Hopkins (MD), 4, 6, 0, 0.40000, 212, 224, -12, 
2008, Johns Hopkins (MD), 8, 3, 0, 0.72727, 287, 219, 68, 
2009, Johns Hopkins (MD), 10, 3, 0, 0.76923, 388, 214, 174, 
2010, Johns Hopkins (MD), 8, 3, 0, 0.72727, 394, 188, 206, 
2011, Johns Hopkins (MD), 10, 1, 0, 0.90909, 438, 144, 294, 
2012, Johns Hopkins (MD), 10, 2, 0, 0.83333, 441, 214, 227, 
2013, Johns Hopkins (MD), 10, 1, 0, 0.90909, 445, 189, 256, 
1998, Iona (NY), 4, 6, 0, 0.40000, 224, 283, -59, 
1999, Iona (NY), 5, 5, 0, 0.50000, 239, 271, -32, 
2000, Iona (NY), 4, 7, 0, 0.36364, 259, 333, -74, 
2001, Iona (NY), 4, 5, 0, 0.44444, 178, 256, -78, 
2002, Iona (NY), 5, 6, 0, 0.45455, 156, 243, -87, 
2003, Iona (NY), 6, 5, 0, 0.54545, 267, 275, -8, 
2004, Iona (NY), 2, 8, 0, 0.20000, 182, 349, -167, 
2005, Iona (NY), 3, 7, 0, 0.30000, 171, 280, -109, 
2006, Iona (NY), 3, 7, 0, 0.30000, 147, 174, -27, 
2007, Iona (NY), 7, 4, 0, 0.63636, 292, 237, 55, 
2008, Iona (NY), 3, 8, 0, 0.27273, 210, 420, -210, 
1990, Westfield St. (MA), 3, 7, 0, 0.30000, 170, 216, -46, 
1991, Westfield St. (MA), 3, 7, 0, 0.30000, 236, 270, -34, 
1992, Westfield St. (MA), 6, 3, 0, 0.66667, 204, 118, 86, 
1993, Westfield St. (MA), 7, 2, 1, 0.75000, 231, 94, 137, 
1994, Westfield St. (MA), 5, 5, 0, 0.50000, 193, 181, 12, 
1995, Westfield St. (MA), 3, 6, 0, 0.33333, 117, 127, -10, 
1996, Westfield St. (MA), 4, 6, 0, 0.40000, 158, 278, -120, 
1997, Westfield St. (MA), 4, 6, 0, 0.40000, 239, 354, -115, 
1998, Westfield St. (MA), 5, 5, 0, 0.50000, 143, 167, -24, 
1999, Westfield St. (MA), 4, 6, 0, 0.40000, 225, 253, -28, 
2000, Westfield St. (MA), 3, 6, 0, 0.33333, 150, 158, -8, 
2001, Westfield St. (MA), 10, 1, 0, 0.90909, 268, 118, 150, 
2002, Westfield St. (MA), 8, 3, 0, 0.72727, 283, 110, 173, 
2003, Westfield St. (MA), 7, 3, 0, 0.70000, 239, 205, 34, 
2004, Westfield St. (MA), 5, 4, 0, 0.55556, 175, 152, 23, 
2005, Westfield St. (MA), 4, 5, 0, 0.44444, 100, 166, -66, 
2006, Westfield St. (MA), 1, 8, 0, 0.11111, 116, 177, -61, 
2007, Westfield St. (MA), 5, 4, 0, 0.55556, 211, 228, -17, 
2008, Westfield St. (MA), 6, 4, 0, 0.60000, 253, 190, 63, 
2009, Westfield St. (MA), 7, 3, 0, 0.70000, 205, 115, 90, 
2010, Westfield St. (MA), 5, 5, 0, 0.50000, 205, 235, -30, 
2011, Westfield St. (MA), 5, 5, 0, 0.50000, 232, 225, 7, 
2012, Westfield St. (MA), 3, 7, 0, 0.30000, 245, 258, -13, 
2013, Westfield St. (MA), 5, 5, 0, 0.50000, 260, 195, 65, 
1996, California, 6, 6, 0, 0.50000, 382, 407, -25, 
1987, Alabama St., 8, 3, 0, 0.72727, 188, 158, 30, 
1988, Alabama St., 7, 3, 0, 0.70000, 176, 104, 72, 
1989, Alabama St., 5, 5, 1, 0.50000, 229, 194, 35, 
1990, Alabama St., 8, 2, 1, 0.77273, 384, 177, 207, 
1991, Alabama St., 11, 0, 1, 0.95833, 489, 183, 306, 
1992, Alabama St., 5, 6, 0, 0.45455, 228, 252, -24, 
1993, Alabama St., 5, 4, 1, 0.55000, 190, 192, -2, 
1994, Alabama St., 6, 5, 0, 0.54545, 269, 304, -35, 
1995, Alabama St., 8, 3, 0, 0.72727, 348, 223, 125, 
1996, Alabama St., 3, 8, 0, 0.27273, 135, 248, -113, 
1997, Alabama St., 3, 8, 0, 0.27273, 184, 242, -58, 
1902, Maryland, 3, 5, 2, 0.40000, 28, 90, -62, 
1903, Maryland, 7, 4, 0, 0.63636, 104, 64, 40, 
1904, Maryland, 2, 4, 2, 0.37500, 33, 62, -29, 
1911, Notre Dame (IN), 6, 0, 2, 0.87500, 222, 9, 213, 
1912, Notre Dame (IN), 7, 0, 0, 1.00000, 389, 27, 362, 
1927, Indiana St., 4, 2, 1, 0.64286, 72, 77, -5, 
1928, Indiana St., 4, 3, 0, 0.57143, 99, 97, 2, 
1929, Indiana St., 5, 2, 1, 0.68750, 115, 37, 78, 
1930, Indiana St., 5, 3, 1, 0.61111, 78, 91, -13, 
1933, Indiana St., 7, 1, 0, 0.87500, 154, 81, 73, 
1934, Indiana St., 3, 5, 0, 0.37500, 84, 94, -10, 
1935, Indiana St., 5, 3, 0, 0.62500, 94, 83, 11, 
1936, Indiana St., 2, 3, 2, 0.42857, 22, 64, -42, 
1937, Indiana St., 1, 7, 0, 0.12500, 40, 120, -80, 
1938, Indiana St., 1, 7, 0, 0.12500, 69, 171, -102, 
1939, Indiana St., 2, 6, 0, 0.25000, 59, 161, -102, 
1940, Indiana St., 5, 1, 2, 0.75000, 118, 40, 78, 
1941, Indiana St., 5, 2, 1, 0.68750, 104, 38, 66, 
1946, Indiana St., 4, 4, 0, 0.50000, 70, 59, 11, 
1947, Indiana St., 5, 3, 0, 0.62500, 107, 105, 2, 
1948, Indiana St., 4, 4, 0, 0.50000, 75, 77, -2, 
1988, Arizona St., 6, 5, 0, 0.54545, 192, 277, -85, 
1989, Arizona St., 6, 4, 1, 0.59091, 241, 258, -17, 
1990, Arizona St., 4, 7, 0, 0.36364, 272, 294, -22, 
1991, Arizona St., 6, 5, 0, 0.54545, 218, 210, 8, 
1922, Coast Guard (CT), 0, 3, 0, 0.00000, 13, 44, -31, 
1923, Coast Guard (CT), 0, 3, 0, 0.00000, 0, 54, -54, 
2009, Syracuse (NY), 4, 8, 0, 0.33333, 254, 335, -81, 
2010, Syracuse (NY), 8, 5, 0, 0.61538, 288, 251, 37, 
2011, Syracuse (NY), 5, 7, 0, 0.41667, 290, 342, -52, 
2012, Syracuse (NY), 8, 5, 0, 0.61538, 390, 322, 68, 
1990, West Virginia Tech, 3, 7, 0, 0.30000, 267, 365, -98, 
1904, North Dakota St., 3, 3, 0, 0.50000, 44, 44, 0, 
1905, North Dakota St., 1, 4, 1, 0.25000, 68, 72, -4, 
1900, Hanover (IN), 2, 2, 1, 0.50000, 82, 84, -2, 
1901, Hanover (IN), 4, 3, 1, 0.56250, 47, 22, 25, 
1902, Hanover (IN), 0, 4, 1, 0.10000, 6, 118, -112, 
1903, Hanover (IN), 0, 4, 0, 0.00000, 11, 107, -96, 
1904, Hanover (IN), 2, 2, 0, 0.50000, 106, 98, 8, 
1909, Howard (DC), 4, 0, 0, 1.00000, 44, 0, 44, 
1910, Howard (DC), 5, 0, 0, 1.00000, 92, 0, 92, 
1911, Howard (DC), 3, 0, 1, 0.87500, 44, 0, 44, 
1912, Howard (DC), 5, 0, 0, 1.00000, 72, 7, 65, 
1913, Howard (DC), 3, 1, 1, 0.70000, 176, 8, 168, 
1914, Howard (DC), 4, 1, 0, 0.80000, 135, 20, 115, 
1915, Howard (DC), 2, 1, 0, 0.66667, 32, 21, 11, 
1916, Howard (DC), 5, 1, 2, 0.75000, 121, 33, 88, 
1989, Richmond (VA), 1, 10, 0, 0.09091, 125, 300, -175, 
1990, Richmond (VA), 1, 10, 0, 0.09091, 133, 312, -179, 
1991, Richmond (VA), 2, 9, 0, 0.18182, 210, 350, -140, 
1992, Richmond (VA), 7, 4, 0, 0.63636, 338, 250, 88, 
1993, Richmond (VA), 5, 6, 0, 0.45455, 208, 273, -65, 
1994, Richmond (VA), 3, 8, 0, 0.27273, 185, 313, -128, 
1997, Tennessee-Martin, 1, 10, 0, 0.09091, 123, 384, -261, 
1998, Tennessee-Martin, 0, 11, 0, 0.00000, 214, 502, -288, 
1999, Tennessee-Martin, 1, 10, 0, 0.09091, 128, 499, -371, 
1965, Livingstone (NC), 3, 5, 0, 0.37500, 169, 173, -4, 
1966, Livingstone (NC), 6, 3, 1, 0.65000, 261, 126, 135, 
1967, Livingstone (NC), 3, 6, 0, 0.33333, 150, 211, -61, 
1968, Livingstone (NC), 4, 4, 0, 0.50000, 81, 101, -20, 
1969, Livingstone (NC), 5, 3, 0, 0.62500, 202, 105, 97, 
1970, Livingstone (NC), 2, 7, 0, 0.22222, 142, 173, -31, 
1971, Livingstone (NC), 4, 6, 0, 0.40000, 130, 183, -53, 
1972, Livingstone (NC), 2, 8, 0, 0.20000, 150, 263, -113, 
1918, Richmond (VA), 3, 1, 1, 0.70000, 22, 19, 3, 
1920, Samford (AL), 3, 5, 1, 0.38889, 110, 289, -179, 
1921, Samford (AL), 3, 6, 0, 0.33333, 139, 158, -19, 
1954, Jamestown (ND), 6, 2, 0, 0.75000, 258, 66, 192, 
1955, Jamestown (ND), 6, 1, 0, 0.85714, 131, 41, 90, 
1956, Jamestown (ND), 4, 2, 1, 0.64286, 130, 77, 53, 
1983, Long Island-CW Post (NY), 5, 5, 0, 0.50000, 186, 174, 12, 
1984, Long Island-CW Post (NY), 5, 2, 1, 0.68750, 205, 139, 66, 
1985, Long Island-CW Post (NY), 7, 2, 0, 0.77778, 237, 131, 106, 
1986, Long Island-CW Post (NY), 2, 7, 0, 0.22222, 163, 233, -70, 
1987, Long Island-CW Post (NY), 2, 8, 0, 0.20000, 157, 255, -98, 
1988, Long Island-CW Post (NY), 5, 5, 0, 0.50000, 232, 250, -18, 
1989, Long Island-CW Post (NY), 5, 5, 0, 0.50000, 180, 155, 25, 
1990, Long Island-CW Post (NY), 7, 3, 0, 0.70000, 284, 168, 116, 
1991, Long Island-CW Post (NY), 4, 6, 0, 0.40000, 201, 260, -59, 
1992, Long Island-CW Post (NY), 6, 3, 1, 0.65000, 298, 198, 100, 
1993, Long Island-CW Post (NY), 10, 1, 0, 0.90909, 461, 172, 289, 
1994, Long Island-CW Post (NY), 5, 6, 0, 0.45455, 255, 289, -34, 
1995, Long Island-CW Post (NY), 6, 4, 0, 0.60000, 233, 147, 86, 
1996, Long Island-CW Post (NY), 7, 3, 0, 0.70000, 179, 145, 34, 
1997, Long Island-CW Post (NY), 6, 4, 0, 0.60000, 203, 109, 94, 
1919, Oklahoma Baptist University, 1, 7, 1, 0.16667, 31, 435, -404, 
1956, Virginia, 4, 6, 0, 0.40000, 92, 167, -75, 
1957, Virginia, 3, 6, 1, 0.35000, 117, 171, -54, 
1958, Air Force (CO), 9, 0, 2, 0.90909, 247, 102, 145, 
1959, Air Force (CO), 5, 4, 1, 0.55000, 160, 124, 36, 
1960, Air Force (CO), 4, 6, 0, 0.40000, 147, 178, -31, 
1961, Air Force (CO), 3, 7, 0, 0.30000, 87, 173, -86, 
1962, Air Force (CO), 5, 5, 0, 0.50000, 173, 171, 2, 
1963, Air Force (CO), 7, 4, 0, 0.63636, 249, 150, 99, 
1964, Air Force (CO), 4, 5, 1, 0.45000, 106, 146, -40, 
1965, Air Force (CO), 3, 6, 1, 0.35000, 166, 156, 10, 
1966, Air Force (CO), 4, 6, 0, 0.40000, 154, 161, -7, 
1967, Air Force (CO), 2, 6, 2, 0.30000, 86, 173, -87, 
1968, Air Force (CO), 7, 3, 0, 0.70000, 251, 156, 95, 
1969, Air Force (CO), 6, 4, 0, 0.60000, 267, 177, 90, 
1970, Air Force (CO), 9, 3, 0, 0.75000, 356, 239, 117, 
1971, Air Force (CO), 6, 4, 0, 0.60000, 187, 187, 0, 
1972, Air Force (CO), 6, 4, 0, 0.60000, 303, 183, 120, 
1973, Air Force (CO), 6, 4, 0, 0.60000, 223, 239, -16, 
1974, Air Force (CO), 2, 9, 0, 0.18182, 178, 215, -37, 
1975, Air Force (CO), 2, 8, 1, 0.22727, 156, 265, -109, 
1976, Air Force (CO), 4, 7, 0, 0.36364, 180, 273, -93, 
1977, Air Force (CO), 2, 8, 1, 0.22727, 114, 296, -182, 
2004, Grand Valley St. (MI), 10, 3, 0, 0.76923, 380, 187, 193, 
2005, Grand Valley St. (MI), 13, 0, 0, 1.00000, 434, 159, 275, 
2006, Grand Valley St. (MI), 15, 0, 0, 1.00000, 533, 233, 300, 
2007, Grand Valley St. (MI), 12, 1, 0, 0.92308, 497, 189, 308, 
2008, Grand Valley St. (MI), 11, 1, 0, 0.91667, 462, 152, 310, 
2009, Grand Valley St. (MI), 13, 2, 0, 0.86667, 538, 266, 272, 
1902, Mississippi, 4, 3, 0, 0.57143, 121, 46, 75, 
1903, Mississippi St., 3, 0, 2, 0.80000, 71, 6, 65, 
1904, Mississippi St., 2, 5, 0, 0.28571, 106, 130, -24, 
1905, Mississippi St., 3, 4, 0, 0.42857, 98, 94, 4, 
1906, Mississippi St., 2, 2, 1, 0.50000, 101, 45, 56, 
2004, Kent St. (OH), 5, 6, 0, 0.45455, 335, 264, 71, 
2005, Kent St. (OH), 1, 10, 0, 0.09091, 180, 331, -151, 
2006, Kent St. (OH), 6, 6, 0, 0.50000, 214, 241, -27, 
2007, Kent St. (OH), 3, 9, 0, 0.25000, 259, 350, -91, 
2008, Kent St. (OH), 4, 8, 0, 0.33333, 308, 380, -72, 
2009, Kent St. (OH), 5, 7, 0, 0.41667, 231, 269, -38, 
2010, Kent St. (OH), 5, 7, 0, 0.41667, 256, 275, -19, 
2013, New Mexico St., 2, 10, 0, 0.16667, 251, 535, -284, 
1942, East Stroudsburg (PA), 6, 0, 0, 1.00000, 101, 13, 88, 
1945, East Stroudsburg (PA), 2, 4, 0, 0.33333, 46, 88, -42, 
1946, East Stroudsburg (PA), 5, 2, 0, 0.71429, 176, 33, 143, 
1947, East Stroudsburg (PA), 3, 3, 0, 0.50000, 101, 38, 63, 
1948, East Stroudsburg (PA), 4, 3, 1, 0.56250, 101, 62, 39, 
1949, East Stroudsburg (PA), 5, 3, 0, 0.62500, 112, 72, 40, 
1950, East Stroudsburg (PA), 4, 3, 1, 0.56250, 118, 106, 12, 
1951, East Stroudsburg (PA), 4, 4, 0, 0.50000, 136, 140, -4, 
1952, East Stroudsburg (PA), 4, 4, 0, 0.50000, 69, 107, -38, 
1953, East Stroudsburg (PA), 3, 3, 0, 0.50000, 66, 59, 7, 
1954, East Stroudsburg (PA), 6, 2, 0, 0.75000, 174, 68, 106, 
1955, East Stroudsburg (PA), 4, 3, 0, 0.57143, 144, 119, 25, 
1956, East Stroudsburg (PA), 7, 2, 0, 0.77778, 203, 53, 150, 
1957, East Stroudsburg (PA), 3, 4, 1, 0.43750, 137, 111, 26, 
1972, New York Tech, 7, 3, 0, 0.70000, 150, 80, 70, 
1973, New York Tech, 5, 4, 0, 0.55556, 106, 87, 19, 
1939, Southern Illinois, 0, 8, 0, 0.00000, 29, 124, -95, 
1940, Southern Illinois, 2, 5, 1, 0.31250, 52, 108, -56, 
1941, Southern Illinois, 5, 2, 1, 0.68750, 142, 45, 97, 
1942, Southern Illinois, 2, 4, 0, 0.33333, 82, 106, -24, 
1944, Southern Illinois, 3, 3, 0, 0.50000, 104, 112, -8, 
1945, Southern Illinois, 4, 1, 2, 0.71429, 78, 55, 23, 
1946, Southern Illinois, 4, 4, 0, 0.50000, 101, 78, 23, 
1947, Southern Illinois, 7, 2, 1, 0.75000, 183, 67, 116, 
1948, Southern Illinois, 2, 6, 0, 0.25000, 80, 196, -116, 
1949, Southern Illinois, 2, 7, 0, 0.22222, 95, 219, -124, 
1921, Virginia Union, 6, 0, 1, 0.92857, 179, 10, 169, 
1922, Virginia Union, 4, 2, 2, 0.62500, 39, 14, 25, 
1923, Virginia Union, 5, 0, 2, 0.85714, 50, 6, 44, 
1923, West Virginia Tech, 4, 3, 1, 0.56250, 72, 115, -43, 
1924, West Virginia Tech, 4, 2, 2, 0.62500, 151, 42, 109, 
1925, West Virginia Tech, 5, 1, 2, 0.75000, 195, 32, 163, 
1926, West Virginia Tech, 2, 3, 0, 0.40000, 51, 69, -18, 
1936, Charleston (WV), 0, 10, 1, 0.04545, 39, 307, -268, 
1913, Arkansas-Monticello, 5, 3, 0, 0.62500, 149, 66, 83, 
1914, Arkansas-Monticello, 2, 4, 0, 0.33333, 140, 170, -30, 
1984, Tuskegee (AL), 1, 8, 0, 0.11111, 111, 236, -125, 
1985, Tuskegee (AL), 3, 6, 1, 0.35000, 142, 186, -44, 
1986, Tuskegee (AL), 6, 3, 0, 0.66667, 192, 122, 70, 
1987, Tuskegee (AL), 9, 1, 0, 0.90000, 229, 91, 138, 
1988, Tuskegee (AL), 3, 6, 0, 0.33333, 98, 210, -112, 
1989, Tuskegee (AL), 5, 5, 0, 0.50000, 166, 273, -107, 
1990, Tuskegee (AL), 8, 3, 0, 0.72727, 407, 267, 140, 
1991, Tuskegee (AL), 6, 4, 0, 0.60000, 378, 234, 144, 
1992, Tuskegee (AL), 3, 6, 1, 0.35000, 192, 239, -47, 
1993, Tuskegee (AL), 3, 8, 0, 0.27273, 286, 313, -27, 
1950, Savannah St. (GA), 3, 4, 1, 0.43750, 90, 106, -16, 
1951, Savannah St. (GA), 5, 4, 1, 0.55000, 179, 180, -1, 
1952, Savannah St. (GA), 1, 8, 0, 0.11111, 42, 272, -230, 
1953, South Carolina St., 6, 3, 0, 0.66667, 180, 99, 81, 
1954, South Carolina St., 7, 2, 0, 0.77778, 198, 61, 137, 
1926, Campbell (NC), 4, 4, 0, 0.50000, 42, 73, -31, 
1917, Hardin-Simmons (TX), 0, 6, 0, 0.00000, 15, 197, -182, 
1918, Hardin-Simmons (TX), 0, 2, 0, 0.00000, 19, 58, -39, 
1968, Dickinson St. (ND), 4, 3, 1, 0.56250, 174, 148, 26, 
1969, Dickinson St. (ND), 5, 2, 1, 0.68750, 201, 134, 67, 
1970, Dickinson St. (ND), 2, 6, 0, 0.25000, 126, 173, -47, 
1953, Texas Christian, 3, 7, 0, 0.30000, 116, 150, -34, 
1954, Texas Christian, 4, 6, 0, 0.40000, 164, 155, 9, 
1955, Texas Christian, 9, 2, 0, 0.81818, 306, 105, 201, 
1956, Texas Christian, 8, 3, 0, 0.72727, 231, 110, 121, 
1957, Texas Christian, 5, 4, 1, 0.55000, 134, 101, 33, 
1958, Texas Christian, 8, 2, 1, 0.77273, 219, 78, 141, 
1959, Texas Christian, 8, 3, 0, 0.72727, 169, 75, 94, 
1960, Texas Christian, 4, 4, 2, 0.50000, 85, 94, -9, 
1961, Texas Christian, 3, 5, 2, 0.40000, 113, 194, -81, 
1962, Texas Christian, 6, 4, 0, 0.60000, 167, 154, 13, 
1963, Texas Christian, 4, 5, 1, 0.45000, 131, 166, -35, 
1964, Texas Christian, 4, 6, 0, 0.40000, 94, 169, -75, 
1965, Texas Christian, 6, 5, 0, 0.54545, 161, 156, 5, 
1966, Texas Christian, 2, 8, 0, 0.20000, 55, 149, -94, 
1907, West Virginia Wesleyan, 1, 4, 1, 0.25000, 22, 115, -93, 
2012, Mesa St. (CO), 4, 7, 0, 0.36364, 225, 334, -109, 
2013, Mesa St. (CO), 5, 6, 0, 0.45455, 233, 212, 21, 
1899, Alabama, 3, 1, 0, 0.75000, 34, 31, 3, 
1887, Wabash (IN), 0, 1, 0, 0.00000, 10, 12, -2, 
1912, North Carolina, 3, 4, 1, 0.43750, 85, 168, -83, 
1924, Western Michigan, 5, 1, 1, 0.78571, 101, 46, 55, 
1925, Western Michigan, 6, 2, 1, 0.72222, 125, 47, 78, 
1926, Western Michigan, 7, 1, 0, 0.87500, 132, 20, 112, 
1927, Western Michigan, 3, 4, 0, 0.42857, 100, 75, 25, 
1928, Western Michigan, 5, 2, 0, 0.71429, 119, 32, 87, 
1959, Ashland (OH), 4, 3, 2, 0.55556, 125, 125, 0, 
1960, Ashland (OH), 6, 3, 0, 0.66667, 204, 105, 99, 
1961, Ashland (OH), 3, 6, 0, 0.33333, 141, 175, -34, 
1962, Ashland (OH), 4, 4, 1, 0.50000, 115, 98, 17, 
1963, Ashland (OH), 9, 1, 0, 0.90000, 178, 56, 122, 
1964, Ashland (OH), 6, 3, 0, 0.66667, 158, 91, 67, 
1965, Ashland (OH), 7, 1, 1, 0.83333, 162, 88, 74, 
1966, Ashland (OH), 5, 3, 2, 0.60000, 160, 107, 53, 
1967, Ashland (OH), 8, 0, 1, 0.94444, 297, 78, 219, 
1968, Ashland (OH), 8, 2, 0, 0.80000, 293, 109, 184, 
1969, Ashland (OH), 5, 3, 1, 0.61111, 142, 95, 47, 
1970, Ashland (OH), 5, 5, 0, 0.50000, 184, 176, 8, 
1971, Ashland (OH), 6, 4, 0, 0.60000, 241, 123, 118, 
1972, Ashland (OH), 11, 0, 0, 1.00000, 354, 62, 292, 
1973, Ashland (OH), 7, 3, 0, 0.70000, 248, 151, 97, 
1974, Ashland (OH), 5, 5, 0, 0.50000, 201, 164, 37, 
1975, Ashland (OH), 4, 6, 0, 0.40000, 190, 202, -12, 
1976, Ashland (OH), 6, 4, 0, 0.60000, 235, 174, 61, 
1977, Ashland (OH), 6, 4, 0, 0.60000, 225, 187, 38, 
1978, Ashland (OH), 2, 8, 0, 0.20000, 125, 222, -97, 
1979, Ashland (OH), 3, 6, 0, 0.33333, 133, 171, -38, 
1980, Ashland (OH), 6, 3, 1, 0.65000, 131, 102, 29, 
1981, Ashland (OH), 6, 4, 0, 0.60000, 213, 136, 77, 
1982, Ashland (OH), 8, 3, 0, 0.72727, 234, 141, 93, 
1983, Ashland (OH), 5, 5, 0, 0.50000, 152, 123, 29, 
1984, Ashland (OH), 6, 3, 1, 0.65000, 179, 145, 34, 
1985, Ashland (OH), 6, 4, 0, 0.60000, 173, 110, 63, 
1986, Ashland (OH), 9, 2, 0, 0.81818, 243, 181, 62, 
1987, Ashland (OH), 7, 2, 1, 0.75000, 289, 242, 47, 
1988, Ashland (OH), 6, 4, 0, 0.60000, 194, 133, 61, 
1989, Ashland (OH), 6, 4, 0, 0.60000, 172, 111, 61, 
1990, Ashland (OH), 7, 3, 1, 0.68182, 247, 153, 94, 
1991, Ashland (OH), 9, 2, 0, 0.81818, 290, 110, 180, 
1992, Ashland (OH), 8, 3, 0, 0.72727, 264, 138, 126, 
1993, Ashland (OH), 9, 2, 0, 0.81818, 252, 109, 143, 
2013, MIT (MA), 6, 3, 0, 0.66667, 294, 214, 80, 
1917, Cincinnati (OH), 0, 6, 0, 0.00000, 0, 189, -189, 
1969, Saint Francis (PA), 1, 5, 0, 0.16667, 22, 172, -150, 
1970, Saint Francis (PA), 3, 4, 0, 0.42857, 111, 79, 32, 
1971, Saint Francis (PA), 7, 1, 0, 0.87500, 206, 95, 111, 
1972, Saint Francis (PA), 5, 4, 0, 0.55556, 175, 70, 105, 
1973, Saint Francis (PA), 5, 4, 0, 0.55556, 127, 127, 0, 
1974, Saint Francis (PA), 7, 1, 0, 0.87500, 151, 89, 62, 
1975, Saint Francis (PA), 3, 4, 1, 0.43750, 132, 136, -4, 
1976, Saint Francis (PA), 2, 6, 0, 0.25000, 83, 168, -85, 
1977, Saint Francis (PA), 3, 5, 1, 0.38889, 126, 142, -16, 
1978, Saint Francis (PA), 4, 5, 0, 0.44444, 168, 197, -29, 
1979, Saint Francis (PA), 2, 6, 0, 0.25000, 110, 121, -11, 
1981, Saint Francis (PA), 3, 6, 1, 0.35000, 112, 217, -105, 
1962, Adrian (MI), 3, 4, 0, 0.42857, 91, 153, -62, 
1963, Adrian (MI), 4, 4, 0, 0.50000, 135, 130, 5, 
1964, Adrian (MI), 2, 6, 0, 0.25000, 57, 140, -83, 
1965, Adrian (MI), 1, 7, 0, 0.12500, 57, 141, -84, 
1966, Adrian (MI), 3, 5, 0, 0.37500, 63, 178, -115, 
1967, Adrian (MI), 1, 7, 0, 0.12500, 35, 195, -160, 
2013, Albright (PA), 8, 3, 0, 0.72727, 372, 223, 149, 
1996, Boston (MA), 1, 10, 0, 0.09091, 119, 373, -254, 
1997, Boston (MA), 1, 10, 0, 0.09091, 162, 353, -191, 
2004, Central Connecticut St., 8, 2, 0, 0.80000, 261, 192, 69, 
2005, Central Connecticut St., 7, 4, 0, 0.63636, 273, 274, -1, 
2006, Fordham (NY), 3, 8, 0, 0.27273, 158, 289, -131, 
2007, Fordham (NY), 8, 4, 0, 0.66667, 348, 298, 50, 
2008, Fordham (NY), 5, 6, 0, 0.45455, 238, 262, -24, 
2009, Fordham (NY), 5, 6, 0, 0.45455, 314, 287, 27, 
2010, Fordham (NY), 5, 6, 0, 0.45455, 234, 269, -35, 
2011, Fordham (NY), 1, 10, 0, 0.09091, 145, 369, -224, 
1988, Southeast Missouri St., 6, 4, 0, 0.60000, 251, 176, 75, 
1989, Southeast Missouri St., 7, 4, 0, 0.63636, 282, 204, 78, 
2013, Midwestern St. (TX), 7, 3, 0, 0.70000, 392, 239, 153, 
1908, Central Missouri St., 5, 3, 1, 0.61111, 161, 109, 52, 
1909, Central Missouri St., 2, 4, 2, 0.37500, 44, 32, 12, 
1910, Tulane (LA), 0, 7, 0, 0.00000, 6, 126, -120, 
1911, Tulane (LA), 5, 3, 1, 0.61111, 106, 46, 60, 
1912, Tulane (LA), 5, 3, 0, 0.62500, 216, 99, 117, 
1918, New York (NY), 0, 4, 0, 0.00000, 2, 38, -36, 
1895, Kentucky, 4, 5, 0, 0.44444, 64, 94, -30, 
1897, Colgate (NY), 5, 2, 1, 0.68750, 66, 26, 40, 
1898, Colgate (NY), 2, 5, 0, 0.28571, 23, 78, -55, 
1928, Bemidji St. (MN), 4, 0, 2, 0.83333, 109, 6, 103, 
1929, Bemidji St. (MN), 2, 5, 0, 0.28571, 47, 112, -65, 
1930, Bemidji St. (MN), 3, 4, 0, 0.42857, 44, 114, -70, 
1907, Mississippi, 0, 6, 0, 0.00000, 6, 195, -189, 
1886, Harvard (MA), 12, 2, 0, 0.85714, 765, 41, 724, 
1986, Kent St. (OH), 5, 6, 0, 0.45455, 179, 288, -109, 
1987, Kent St. (OH), 7, 4, 0, 0.63636, 233, 212, 21, 
1988, Kansas, 1, 10, 0, 0.09091, 189, 496, -307, 
1989, Kansas, 4, 7, 0, 0.36364, 248, 383, -135, 
1990, Kansas, 3, 7, 1, 0.31818, 213, 365, -152, 
1991, Kansas, 6, 5, 0, 0.54545, 313, 244, 69, 
1992, Kansas, 8, 4, 0, 0.66667, 373, 262, 111, 
1993, Kansas, 5, 7, 0, 0.41667, 242, 256, -14, 
1994, Kansas, 6, 5, 0, 0.54545, 314, 242, 72, 
1995, Kansas, 10, 2, 0, 0.83333, 345, 261, 84, 
1996, Kansas, 4, 7, 0, 0.36364, 300, 358, -58, 
1997, Minnesota, 3, 9, 0, 0.25000, 238, 334, -96, 
1998, Minnesota, 5, 6, 0, 0.45455, 229, 249, -20, 
1999, Minnesota, 8, 4, 0, 0.66667, 368, 196, 172, 
2000, Minnesota, 6, 6, 0, 0.50000, 375, 318, 57, 
2001, Minnesota, 4, 7, 0, 0.36364, 308, 299, 9, 
2002, Minnesota, 8, 5, 0, 0.61538, 376, 319, 57, 
2003, Minnesota, 10, 3, 0, 0.76923, 503, 285, 218, 
2004, Minnesota, 7, 5, 0, 0.58333, 361, 273, 88, 
2005, Minnesota, 7, 5, 0, 0.58333, 429, 348, 81, 
2006, Minnesota, 6, 7, 0, 0.46154, 376, 338, 38, 
1937, Colorado School of Mines, 2, 5, 0, 0.28571, 31, 144, -113, 
1938, Colorado School of Mines, 4, 3, 0, 0.57143, 130, 61, 69, 
1939, Colorado School of Mines, 8, 0, 0, 1.00000, 268, 44, 224, 
1940, Colorado School of Mines, 3, 4, 0, 0.42857, 65, 138, -73, 
1941, Colorado School of Mines, 2, 4, 2, 0.37500, 98, 108, -10, 
1942, Colorado School of Mines, 3, 4, 0, 0.42857, 52, 167, -115, 
1943, Colorado School of Mines, 0, 1, 0, 0.00000, 7, 26, -19, 
1946, Colorado School of Mines, 1, 4, 1, 0.25000, 62, 132, -70, 
1950, Montana St., 1, 8, 0, 0.11111, 87, 281, -194, 
1951, Montana St., 0, 7, 0, 0.00000, 38, 220, -182, 
1996, Boise St. (ID), 1, 9, 0, 0.10000, 188, 363, -175, 
1973, Cincinnati (OH), 4, 7, 0, 0.36364, 210, 109, 101, 
1974, Cincinnati (OH), 7, 4, 0, 0.63636, 227, 175, 52, 
1975, Cincinnati (OH), 6, 5, 0, 0.54545, 209, 182, 27, 
1976, Cincinnati (OH), 9, 2, 0, 0.81818, 204, 114, 90, 
1977, Arizona, 5, 7, 0, 0.41667, 256, 250, 6, 
1978, Arizona, 5, 6, 0, 0.45455, 245, 205, 40, 
1979, Arizona, 6, 5, 1, 0.54167, 244, 243, 1, 
1980, Brooklyn (NY), 1, 9, 0, 0.10000, 76, 349, -273, 
1971, Eastern Washington, 5, 5, 0, 0.50000, 221, 250, -29, 
1972, Eastern Washington, 3, 7, 0, 0.30000, 159, 189, -30, 
1973, Eastern Washington, 5, 4, 0, 0.55556, 121, 116, 5, 
1974, Eastern Washington, 4, 5, 0, 0.44444, 153, 193, -40, 
1975, Eastern Washington, 3, 6, 0, 0.33333, 116, 211, -95, 
1976, Eastern Washington, 4, 4, 1, 0.50000, 183, 246, -63, 
1977, Eastern Washington, 5, 4, 0, 0.55556, 222, 194, 28, 
1978, Eastern Washington, 4, 6, 0, 0.40000, 258, 195, 63, 
2013, Shaw (NC), 6, 4, 0, 0.60000, 314, 249, 65, 
1894, Virginia Tech, 4, 1, 0, 0.80000, 112, 10, 102, 
1898, Virginia, 6, 6, 0, 0.50000, 117, 80, 37, 
2005, Livingstone (NC), 1, 9, 0, 0.10000, 160, 375, -215, 
2006, Livingstone (NC), 1, 9, 0, 0.10000, 100, 234, -134, 
2007, Livingstone (NC), 0, 10, 0, 0.00000, 83, 430, -347, 
2008, Livingstone (NC), 2, 8, 0, 0.20000, 160, 350, -190, 
2009, Livingstone (NC), 0, 4, 0, 0.00000, 19, 173, -154, 
1965, Holy Cross (MA), 2, 7, 1, 0.25000, 71, 173, -102, 
1966, Holy Cross (MA), 6, 3, 1, 0.65000, 135, 163, -28, 
1967, Worcester Tech (MA), 1, 6, 0, 0.14286, 78, 153, -75, 
1968, Worcester Tech (MA), 5, 2, 0, 0.71429, 140, 135, 5, 
1969, Worcester Tech (MA), 3, 5, 0, 0.37500, 116, 192, -76, 
1970, Worcester Tech (MA), 2, 6, 0, 0.25000, 95, 224, -129, 
1971, Worcester Tech (MA), 2, 6, 0, 0.25000, 170, 194, -24, 
1972, Worcester Tech (MA), 3, 5, 0, 0.37500, 139, 116, 23, 
1973, Worcester Tech (MA), 2, 6, 0, 0.25000, 114, 103, 11, 
1974, Worcester Tech (MA), 2, 6, 0, 0.25000, 98, 158, -60, 
1975, Worcester Tech (MA), 2, 5, 1, 0.31250, 151, 211, -60, 
1976, Worcester Tech (MA), 2, 6, 0, 0.25000, 152, 230, -78, 
1977, Worcester Tech (MA), 1, 7, 0, 0.12500, 88, 201, -113, 
1951, Bluffton (OH), 6, 2, 0, 0.75000, 162, 103, 59, 
1952, Bluffton (OH), 5, 4, 0, 0.55556, 193, 145, 48, 
1953, Bluffton (OH), 3, 4, 0, 0.42857, 69, 86, -17, 
1954, Bluffton (OH), 4, 4, 0, 0.50000, 108, 106, 2, 
1955, Bluffton (OH), 3, 6, 0, 0.33333, 149, 200, -51, 
1956, Bluffton (OH), 8, 1, 0, 0.88889, 251, 131, 120, 
1957, Bluffton (OH), 7, 2, 0, 0.77778, 243, 159, 84, 
1958, Bluffton (OH), 8, 1, 0, 0.88889, 293, 66, 227, 
1959, Bluffton (OH), 6, 3, 0, 0.66667, 183, 132, 51, 
1960, Bluffton (OH), 5, 3, 1, 0.61111, 166, 152, 14, 
1961, Bluffton (OH), 5, 3, 0, 0.62500, 136, 112, 24, 
1962, Bluffton (OH), 7, 2, 0, 0.77778, 221, 119, 102, 
1963, Bluffton (OH), 7, 2, 0, 0.77778, 224, 116, 108, 
1964, Bluffton (OH), 3, 5, 1, 0.38889, 130, 120, 10, 
1965, Bluffton (OH), 7, 2, 0, 0.77778, 157, 61, 96, 
1946, Nebraska, 3, 6, 0, 0.33333, 126, 161, -35, 
1947, Nebraska, 2, 7, 0, 0.22222, 73, 191, -118, 
2005, Missouri Southern St., 1, 4, 0, 0.20000, 127, 154, -27, 
1954, Kansas, 0, 10, 0, 0.00000, 93, 377, -284, 
1955, Kansas, 3, 6, 1, 0.35000, 93, 222, -129, 
1956, Kansas, 3, 6, 1, 0.35000, 163, 215, -52, 
1957, Kansas, 5, 4, 1, 0.55000, 115, 230, -115, 
1911, Kalamazoo (MI), 2, 2, 0, 0.50000, 24, 53, -29, 
1912, Kalamazoo (MI), 1, 3, 1, 0.30000, 60, 121, -61, 
1913, Kalamazoo (MI), 2, 4, 0, 0.33333, 66, 81, -15, 
1914, Kalamazoo (MI), 4, 1, 0, 0.80000, 106, 22, 84, 
1915, Kalamazoo (MI), 3, 2, 0, 0.60000, 96, 29, 67, 
1916, Lake Forest (IL), 1, 7, 0, 0.12500, 63, 162, -99, 
1917, Lake Forest (IL), 2, 5, 0, 0.28571, 61, 101, -40, 
1918, Lake Forest (IL), 0, 1, 0, 0.00000, 0, 20, -20, 
2005, Arkansas-Monticello, 1, 10, 0, 0.09091, 160, 491, -331, 
2006, Arkansas-Monticello, 1, 10, 0, 0.09091, 124, 355, -231, 
2007, Arkansas-Monticello, 4, 7, 0, 0.36364, 289, 446, -157, 
2008, Arkansas-Monticello, 7, 4, 0, 0.63636, 377, 320, 57, 
2009, Arkansas-Monticello, 5, 6, 0, 0.45455, 235, 302, -67, 
2010, Arkansas-Monticello, 4, 7, 0, 0.36364, 249, 308, -59, 
1922, Idaho, 3, 5, 0, 0.37500, 74, 51, 23, 
1923, Idaho, 5, 2, 1, 0.68750, 164, 26, 138, 
1924, Idaho, 5, 2, 1, 0.68750, 118, 32, 86, 
1925, Idaho, 3, 5, 0, 0.37500, 79, 153, -74, 
1929, Gonzaga (WA), 4, 3, 0, 0.57143, 104, 100, 4, 
1901, Carthage (WI), 1, 1, 0, 0.50000, 17, 33, -16, 
1934, East Carolina (NC), 1, 4, 1, 0.25000, 18, 87, -69, 
1935, East Carolina (NC), 3, 3, 0, 0.50000, 78, 32, 46, 
2013, Bethel (KS), 2, 9, 0, 0.18182, 308, 542, -234, 
2002, Allegheny (PA), 5, 5, 0, 0.50000, 231, 204, 27, 
2003, Allegheny (PA), 7, 4, 0, 0.63636, 264, 190, 74, 
2004, Allegheny (PA), 5, 5, 0, 0.50000, 233, 190, 43, 
2005, Allegheny (PA), 3, 7, 0, 0.30000, 247, 218, 29, 
2006, Allegheny (PA), 6, 4, 0, 0.60000, 303, 217, 86, 
2007, Allegheny (PA), 5, 5, 0, 0.50000, 173, 150, 23, 
2008, Allegheny (PA), 5, 5, 0, 0.50000, 179, 230, -51, 
2009, Allegheny (PA), 8, 2, 0, 0.80000, 223, 203, 20, 
2010, Allegheny (PA), 7, 3, 0, 0.70000, 251, 167, 84, 
2011, Allegheny (PA), 5, 5, 0, 0.50000, 205, 201, 4, 
2012, Allegheny (PA), 5, 5, 0, 0.50000, 114, 190, -76, 
2013, Allegheny (PA), 0, 10, 0, 0.00000, 65, 358, -293, 
1995, Emporia St. (KS), 5, 6, 0, 0.45455, 319, 314, 5, 
1996, Emporia St. (KS), 5, 6, 0, 0.45455, 345, 381, -36, 
1997, Emporia St. (KS), 8, 3, 0, 0.72727, 465, 298, 167, 
1998, Emporia St. (KS), 9, 2, 0, 0.81818, 428, 276, 152, 
2003, Texas St., 4, 8, 0, 0.33333, 315, 417, -102, 
2013, Bethany (KS), 2, 9, 0, 0.18182, 206, 389, -183, 
1893, Tuskegee (AL), 0, 1, 0, 0.00000, 0, 10, -10, 
1895, Tuskegee (AL), 0, 1, 0, 0.00000, 0, 6, -6, 
1999, James Madison (VA), 8, 4, 0, 0.66667, 273, 260, 13, 
2000, James Madison (VA), 6, 5, 0, 0.54545, 300, 185, 115, 
2001, James Madison (VA), 2, 9, 0, 0.18182, 201, 260, -59, 
2002, James Madison (VA), 5, 7, 0, 0.41667, 196, 272, -76, 
2003, James Madison (VA), 6, 6, 0, 0.50000, 307, 284, 23, 
2004, James Madison (VA), 13, 2, 0, 0.86667, 421, 268, 153, 
2005, James Madison (VA), 7, 4, 0, 0.63636, 391, 168, 223, 
2006, James Madison (VA), 9, 3, 0, 0.75000, 389, 201, 188, 
2007, James Madison (VA), 8, 4, 0, 0.66667, 400, 265, 135, 
2008, James Madison (VA), 12, 2, 0, 0.85714, 534, 323, 211, 
2009, James Madison (VA), 6, 5, 0, 0.54545, 242, 208, 34, 
2010, James Madison (VA), 6, 5, 0, 0.54545, 195, 162, 33, 
2011, James Madison (VA), 8, 5, 0, 0.61538, 289, 255, 34, 
2012, James Madison (VA), 7, 4, 0, 0.63636, 317, 231, 86, 
2013, James Madison (VA), 6, 6, 0, 0.50000, 339, 289, 50, 
1915, Willamette (OR), 3, 3, 1, 0.50000, 47, 155, -108, 
1916, Willamette (OR), 4, 3, 0, 0.57143, 141, 135, 6, 
1917, Willamette (OR), 1, 1, 0, 0.50000, 20, 14, 6, 
1919, Willamette (OR), 3, 1, 2, 0.66667, 86, 49, 37, 
1920, Willamette (OR), 4, 1, 1, 0.75000, 80, 20, 60, 
1947, Bethune-Cookman (FL), 10, 2, 0, 0.83333, 331, 59, 272, 
1948, Bethune-Cookman (FL), 7, 2, 1, 0.75000, 166, 66, 100, 
1949, Bethune-Cookman (FL), 5, 3, 0, 0.62500, 155, 100, 55, 
1950, Bethune-Cookman (FL), 4, 4, 1, 0.50000, 228, 162, 66, 
1951, Bethune-Cookman (FL), 7, 2, 0, 0.77778, 294, 112, 182, 
1952, Bethune-Cookman (FL), 9, 1, 0, 0.90000, 301, 40, 261, 
1953, Bethune-Cookman (FL), 6, 3, 2, 0.63636, 259, 107, 152, 
1954, Bethune-Cookman (FL), 5, 3, 0, 0.62500, 182, 95, 87, 
1955, Bethune-Cookman (FL), 5, 4, 1, 0.55000, 173, 162, 11, 
1956, Bethune-Cookman (FL), 6, 3, 0, 0.66667, 128, 139, -11, 
1957, Bethune-Cookman (FL), 2, 6, 0, 0.25000, 79, 162, -83, 
1958, Bethune-Cookman (FL), 1, 7, 0, 0.12500, 82, 161, -79, 
1959, Bethune-Cookman (FL), 6, 2, 0, 0.75000, 154, 122, 32, 
1895, Mississippi St., 0, 2, 0, 0.00000, 0, 37, -37, 
1965, Elon (NC), 2, 8, 0, 0.20000, 76, 124, -48, 
1966, Elon (NC), 1, 9, 0, 0.10000, 99, 225, -126, 
1978, Cal St.-Sacramento, 1, 9, 0, 0.10000, 83, 304, -221, 
1979, Cal St.-Sacramento, 4, 6, 0, 0.40000, 121, 196, -75, 
1980, Cal St.-Sacramento, 3, 7, 0, 0.30000, 161, 185, -24, 
1981, Cal St.-Sacramento, 5, 6, 0, 0.45455, 256, 186, 70, 
1982, Cal St.-Sacramento, 8, 3, 0, 0.72727, 249, 245, 4, 
1983, Cal St.-Sacramento, 5, 5, 1, 0.50000, 258, 245, 13, 
1984, Cal St.-Sacramento, 6, 5, 0, 0.54545, 277, 218, 59, 
1985, Cal St.-Sacramento, 8, 3, 0, 0.72727, 326, 229, 97, 
1986, Cal St.-Sacramento, 6, 4, 1, 0.59091, 308, 268, 40, 
1987, Cal St.-Sacramento, 4, 7, 0, 0.36364, 130, 192, -62, 
1988, Cal St.-Sacramento, 10, 3, 0, 0.76923, 479, 272, 207, 
1989, Cal St.-Sacramento, 5, 4, 0, 0.55556, 202, 236, -34, 
1990, Cal St.-Sacramento, 4, 6, 0, 0.40000, 225, 259, -34, 
1991, Cal St.-Sacramento, 8, 2, 0, 0.80000, 367, 224, 143, 
1992, Cal St.-Sacramento, 7, 3, 0, 0.70000, 268, 149, 119, 
2010, Northern Illinois, 1, 0, 0, 1.00000, 40, 17, 23, 
2004, Concordia-Saint Paul (MN), 7, 4, 0, 0.63636, 383, 284, 99, 
2005, Concordia-Saint Paul (MN), 9, 3, 0, 0.75000, 424, 297, 127, 
2006, Concordia-Saint Paul (MN), 5, 6, 0, 0.45455, 253, 272, -19, 
2007, Concordia-Saint Paul (MN), 4, 7, 0, 0.36364, 278, 332, -54, 
2008, Concordia-Saint Paul (MN), 4, 7, 0, 0.36364, 210, 314, -104, 
2009, Concordia-Saint Paul (MN), 3, 8, 0, 0.27273, 250, 405, -155, 
2010, Concordia-Saint Paul (MN), 8, 4, 0, 0.66667, 322, 217, 105, 
1921, Oklahoma St., 5, 4, 1, 0.55000, 135, 125, 10, 
1922, Oklahoma St., 5, 4, 1, 0.55000, 130, 86, 44, 
1923, Oklahoma St., 2, 9, 0, 0.18182, 40, 97, -57, 
1924, Oklahoma St., 6, 1, 2, 0.77778, 117, 50, 67, 
1925, Oklahoma St., 2, 5, 1, 0.31250, 41, 115, -74, 
1926, Oklahoma St., 3, 4, 1, 0.43750, 79, 114, -35, 
1927, Oklahoma St., 4, 4, 0, 0.50000, 110, 138, -28, 
1928, Oklahoma St., 1, 7, 0, 0.12500, 25, 200, -175, 
1929, Marshall (WV), 5, 3, 1, 0.61111, 184, 79, 105, 
1930, Marshall (WV), 3, 5, 1, 0.38889, 111, 130, -19, 
1987, Catawba (NC), 4, 7, 0, 0.36364, 249, 278, -29, 
1988, Catawba (NC), 8, 4, 0, 0.66667, 308, 234, 74, 
1989, Catawba (NC), 4, 7, 0, 0.36364, 234, 277, -43, 
1990, Catawba (NC), 5, 6, 0, 0.45455, 208, 198, 10, 
1970, Case Western Reserve (OH), 2, 5, 1, 0.31250, 60, 115, -55, 
1971, Case Western Reserve (OH), 3, 6, 0, 0.33333, 113, 186, -73, 
1972, Case Western Reserve (OH), 4, 5, 0, 0.44444, 112, 157, -45, 
1973, Case Western Reserve (OH), 0, 9, 0, 0.00000, 52, 292, -240, 
1974, Case Western Reserve (OH), 2, 7, 0, 0.22222, 135, 245, -110, 
1975, Case Western Reserve (OH), 0, 8, 0, 0.00000, 39, 230, -191, 
2005, Henderson St. (AR), 3, 8, 0, 0.27273, 246, 350, -104, 
2006, Henderson St. (AR), 8, 3, 0, 0.72727, 310, 191, 119, 
2007, Henderson St. (AR), 7, 3, 0, 0.70000, 291, 161, 130, 
2008, Henderson St. (AR), 5, 5, 0, 0.50000, 328, 284, 44, 
2009, Henderson St. (AR), 3, 7, 0, 0.30000, 312, 313, -1, 
2010, Henderson St. (AR), 7, 4, 0, 0.63636, 388, 256, 132, 
2011, Henderson St. (AR), 6, 4, 0, 0.60000, 275, 269, 6, 
2012, Henderson St. (AR), 10, 1, 0, 0.90909, 554, 233, 321, 
2013, Henderson St. (AR), 11, 1, 0, 0.91667, 639, 288, 351, 
1984, Pittsburg St. (KS), 5, 4, 0, 0.55556, 200, 232, -32, 
1974, Jacksonville St. (AL), 7, 4, 0, 0.63636, 252, 138, 114, 
1975, Jacksonville St. (AL), 7, 3, 0, 0.70000, 204, 101, 103, 
1976, Jacksonville St. (AL), 6, 4, 0, 0.60000, 203, 105, 98, 
1971, West Texas A&M;, 2, 9, 0, 0.18182, 143, 281, -138, 
1972, West Texas A&M;, 5, 5, 0, 0.50000, 217, 198, 19, 
1973, West Texas A&M;, 2, 9, 0, 0.18182, 115, 310, -195, 
1974, West Texas A&M;, 6, 5, 0, 0.54545, 220, 148, 72, 
1975, West Texas A&M;, 5, 6, 0, 0.45455, 259, 216, 43, 
1976, West Texas A&M;, 4, 5, 2, 0.45455, 219, 252, -33, 
1968, Hanover (IN), 5, 4, 0, 0.55556, 201, 180, 21, 
1969, Hanover (IN), 6, 3, 0, 0.66667, 240, 224, 16, 
1970, Hanover (IN), 2, 7, 0, 0.22222, 147, 247, -100, 
1971, Hanover (IN), 3, 6, 0, 0.33333, 72, 99, -27, 
1940, Texas A&M-Kingsville;, 6, 3, 0, 0.66667, 118, 92, 26, 
1946, Texas A&M-Kingsville;, 2, 7, 0, 0.22222, 52, 201, -149, 
1947, Texas A&M-Kingsville;, 7, 1, 1, 0.83333, 163, 81, 82, 
1948, Texas A&M-Kingsville;, 5, 5, 0, 0.50000, 216, 132, 84, 
1949, Texas A&M-Kingsville;, 8, 2, 0, 0.80000, 246, 130, 116, 
1950, Texas A&M-Kingsville;, 6, 3, 0, 0.66667, 147, 105, 42, 
1951, Texas A&M-Kingsville;, 5, 4, 0, 0.55556, 165, 179, -14, 
1952, Texas A&M-Kingsville;, 3, 8, 0, 0.27273, 219, 257, -38, 
1953, Texas A&M-Kingsville;, 4, 5, 0, 0.44444, 120, 230, -110, 
1909, Louisiana St., 2, 1, 0, 0.66667, 64, 22, 42, 
1910, Louisiana St., 1, 5, 0, 0.16667, 45, 119, -74, 
2013, Redlands (CA), 7, 3, 0, 0.70000, 277, 174, 103, 
2010, Winston-Salem St. (NC), 8, 2, 0, 0.80000, 371, 156, 215, 
2011, Winston-Salem St. (NC), 13, 1, 0, 0.92857, 554, 224, 330, 
2012, Winston-Salem St. (NC), 14, 1, 0, 0.93333, 603, 261, 342, 
2013, Winston-Salem St. (NC), 10, 2, 0, 0.83333, 431, 181, 250, 
1979, Howard Payne (TX), 2, 8, 0, 0.20000, 126, 256, -130, 
1980, Howard Payne (TX), 1, 8, 1, 0.15000, 69, 184, -115, 
1981, Howard Payne (TX), 3, 7, 0, 0.30000, 107, 285, -178, 
1896, Utah St., 0, 1, 0, 0.00000, 0, 6, -6, 
1995, Saint Francis (PA), 0, 10, 0, 0.00000, 125, 300, -175, 
1996, Saint Francis (PA), 3, 7, 0, 0.30000, 165, 261, -96, 
1997, Saint Francis (PA), 2, 9, 0, 0.18182, 153, 350, -197, 
1913, Franklin & Marshall (PA), 6, 2, 0, 0.75000, 208, 54, 154, 
1914, Franklin & Marshall (PA), 6, 2, 1, 0.72222, 103, 56, 47, 
1915, Iowa St., 6, 2, 0, 0.75000, 129, 75, 54, 
1916, Iowa St., 5, 2, 1, 0.68750, 106, 36, 70, 
1917, Iowa St., 5, 2, 0, 0.71429, 129, 20, 109, 
1918, Iowa St., 0, 3, 0, 0.00000, 0, 38, -38, 
1919, Iowa St., 5, 2, 1, 0.68750, 73, 20, 53, 
1924, Franklin & Marshall (PA), 3, 5, 1, 0.38889, 101, 153, -52, 
1925, Franklin & Marshall (PA), 5, 4, 0, 0.55556, 88, 75, 13, 
1944, Franklin & Marshall (PA), 1, 8, 0, 0.11111, 69, 109, -40, 
1945, Franklin & Marshall (PA), 4, 0, 1, 0.90000, 76, 13, 63, 
1964, North Central (IL), 4, 3, 1, 0.56250, 133, 96, 37, 
1965, North Central (IL), 5, 3, 0, 0.62500, 177, 90, 87, 
1966, North Central (IL), 6, 3, 0, 0.66667, 160, 138, 22, 
1967, North Central (IL), 2, 7, 0, 0.22222, 179, 298, -119, 
1968, North Central (IL), 1, 8, 0, 0.11111, 92, 421, -329, 
1969, North Central (IL), 0, 9, 0, 0.00000, 101, 314, -213, 
1922, Tennessee-Chattanooga, 6, 2, 1, 0.72222, 208, 60, 148, 
1923, Tennessee-Chattanooga, 3, 4, 2, 0.44444, 89, 124, -35, 
1924, Tennessee-Chattanooga, 1, 7, 1, 0.16667, 48, 151, -103, 
1907, Tennessee-Chattanooga, 0, 6, 0, 0.00000, 7, 150, -143, 
1913, Southern Illinois, 4, 2, 1, 0.64286, 100, 91, 9, 
1914, Southern Illinois, 4, 4, 0, 0.50000, 193, 147, 46, 
1915, Southern Illinois, 5, 3, 0, 0.62500, 186, 80, 106, 
1916, Southern Illinois, 3, 4, 0, 0.42857, 106, 64, 42, 
1921, Southern Illinois, 2, 2, 3, 0.50000, 16, 40, -24, 
1922, Southern Illinois, 1, 6, 0, 0.14286, 53, 93, -40, 
1923, Southern Illinois, 3, 2, 2, 0.57143, 69, 63, 6, 
1924, Southern Illinois, 5, 3, 0, 0.62500, 203, 70, 133, 
1925, Southern Illinois, 0, 5, 1, 0.08333, 0, 31, -31, 
1926, Southern Illinois, 5, 1, 2, 0.75000, 74, 27, 47, 
1927, Southern Illinois, 3, 5, 2, 0.40000, 67, 103, -36, 
1928, Southern Illinois, 7, 1, 2, 0.80000, 180, 31, 149, 
1929, Southern Illinois, 5, 3, 1, 0.61111, 52, 54, -2, 
1930, Southern Illinois, 9, 0, 0, 1.00000, 224, 24, 200, 
1931, Southern Illinois, 7, 2, 0, 0.77778, 63, 26, 37, 
1932, Southern Illinois, 2, 5, 3, 0.35000, 70, 72, -2, 
1933, Southern Illinois, 4, 4, 1, 0.50000, 88, 50, 38, 
1934, Southern Illinois, 5, 3, 0, 0.62500, 74, 76, -2, 
1935, Southern Illinois, 1, 7, 1, 0.16667, 32, 130, -98, 
1936, Southern Illinois, 3, 4, 1, 0.43750, 50, 48, 2, 
1937, Southern Illinois, 2, 7, 0, 0.22222, 28, 115, -87, 
1938, Southern Illinois, 2, 7, 0, 0.22222, 21, 124, -103, 
1915, Saint Mary's (CA), 3, 6, 0, 0.33333, 76, 161, -85, 
1916, Saint Mary's (CA), 5, 4, 1, 0.55000, 75, 94, -19, 
1916, Marquette (WI), 4, 3, 1, 0.56250, 166, 73, 93, 
1908, Delaware, 3, 4, 1, 0.43750, 46, 51, -5, 
1909, Delaware, 1, 6, 1, 0.18750, 22, 140, -118, 
1910, Delaware, 1, 2, 2, 0.40000, 19, 49, -30, 
1911, Delaware, 2, 5, 2, 0.33333, 54, 56, -2, 
1912, Delaware, 1, 6, 1, 0.18750, 50, 121, -71, 
1913, Delaware, 2, 4, 2, 0.37500, 55, 82, -27, 
1914, Delaware, 7, 1, 1, 0.83333, 172, 66, 106, 
1915, Delaware, 6, 3, 0, 0.66667, 183, 139, 44, 
1916, Delaware, 4, 3, 1, 0.56250, 60, 66, -6, 
1922, Delaware, 5, 3, 1, 0.61111, 84, 42, 42, 
1923, Delaware, 5, 3, 1, 0.61111, 76, 45, 31, 
1924, Delaware, 4, 3, 1, 0.56250, 44, 45, -1, 
1908, Tulsa (OK), 2, 3, 0, 0.40000, 80, 43, 37, 
1914, Tulsa (OK), 6, 2, 0, 0.75000, 261, 48, 213, 
1915, Tulsa (OK), 6, 1, 1, 0.81250, 257, 33, 224, 
1916, Tulsa (OK), 10, 0, 0, 1.00000, 566, 40, 526, 
1909, New Mexico, 4, 2, 0, 0.66667, 117, 77, 40, 
1965, Chadron St. (NE), 2, 6, 1, 0.27778, 120, 202, -82, 
1966, Chadron St. (NE), 0, 10, 0, 0.00000, 79, 348, -269, 
1900, Yale (CT), 12, 0, 0, 1.00000, 336, 10, 326, 
1990, Utah, 4, 7, 0, 0.36364, 214, 342, -128, 
1991, Utah, 7, 5, 0, 0.58333, 276, 277, -1, 
1992, Utah, 6, 6, 0, 0.50000, 320, 289, 31, 
1993, Utah, 7, 6, 0, 0.53846, 390, 396, -6, 
1994, Utah, 10, 2, 0, 0.83333, 426, 210, 216, 
1995, Utah, 7, 4, 0, 0.63636, 296, 230, 66, 
1996, Utah, 8, 4, 0, 0.66667, 313, 309, 4, 
1997, Utah, 6, 5, 0, 0.54545, 253, 200, 53, 
1998, Utah, 7, 4, 0, 0.63636, 339, 227, 112, 
1999, Utah, 9, 3, 0, 0.75000, 380, 210, 170, 
2000, Utah, 4, 7, 0, 0.36364, 234, 207, 27, 
2001, Utah, 8, 4, 0, 0.66667, 329, 210, 119, 
2002, Utah, 5, 6, 0, 0.45455, 249, 226, 23, 
2005, Weber St. (UT), 6, 5, 0, 0.54545, 277, 277, 0, 
2006, Weber St. (UT), 4, 7, 0, 0.36364, 201, 265, -64, 
2007, Weber St. (UT), 5, 6, 0, 0.45455, 299, 324, -25, 
2008, Weber St. (UT), 10, 4, 0, 0.71429, 493, 317, 176, 
2009, Weber St. (UT), 7, 5, 0, 0.58333, 338, 260, 78, 
2010, Weber St. (UT), 6, 5, 0, 0.54545, 279, 342, -63, 
2011, Weber St. (UT), 5, 6, 0, 0.45455, 347, 354, -7, 
1912, Lafayette (PA), 4, 5, 1, 0.45000, 71, 118, -47, 
1913, Lafayette (PA), 4, 5, 1, 0.45000, 87, 76, 11, 
1895, Marquette (WI), 3, 1, 0, 0.75000, 74, 38, 36, 
1934, Dubuque (IA), 2, 3, 1, 0.41667, 153, 47, 106, 
1935, Dubuque (IA), 3, 4, 0, 0.42857, 23, 75, -52, 
1936, Dubuque (IA), 1, 6, 1, 0.18750, 18, 200, -182, 
1974, Lane (TN), 0, 9, 0, 0.00000, 81, 298, -217, 
1975, Lane (TN), 2, 6, 0, 0.25000, 90, 159, -69, 
1976, Lane (TN), 5, 4, 0, 0.55556, 138, 191, -53, 
1977, Lane (TN), 2, 6, 0, 0.25000, 112, 159, -47, 
1978, Lane (TN), 1, 5, 2, 0.25000, 92, 153, -61, 
1979, Lane (TN), 1, 7, 0, 0.12500, 52, 128, -76, 
1980, Lane (TN), 3, 5, 0, 0.37500, 142, 126, 16, 
1981, Lane (TN), 2, 7, 1, 0.25000, 145, 231, -86, 
1982, Lane (TN), 6, 2, 1, 0.72222, 249, 124, 125, 
1983, Lane (TN), 6, 4, 0, 0.60000, 196, 128, 68, 
1984, Lane (TN), 2, 6, 0, 0.25000, 147, 195, -48, 
1985, Lane (TN), 3, 5, 1, 0.38889, 187, 187, 0, 
1986, Lane (TN), 4, 6, 0, 0.40000, 147, 270, -123, 
1987, Lane (TN), 1, 7, 1, 0.16667, 127, 338, -211, 
1935, South Carolina, 3, 7, 0, 0.30000, 73, 187, -114, 
1936, South Carolina, 5, 7, 0, 0.41667, 100, 139, -39, 
1937, South Carolina, 5, 6, 1, 0.45833, 192, 166, 26, 
1929, Texas A&M-Kingsville;, 3, 4, 1, 0.43750, 64, 143, -79, 
1930, Texas A&M-Kingsville;, 4, 3, 3, 0.55000, 103, 75, 28, 
1931, Texas A&M-Kingsville;, 8, 1, 0, 0.88889, 210, 56, 154, 
1932, Texas A&M-Kingsville;, 6, 2, 0, 0.75000, 134, 54, 80, 
1933, Texas A&M-Kingsville;, 6, 2, 0, 0.75000, 193, 40, 153, 
1934, Texas A&M-Kingsville;, 5, 1, 1, 0.78571, 196, 47, 149, 
1935, Texas A&M-Kingsville;, 3, 5, 0, 0.37500, 45, 121, -76, 
1936, Texas A&M-Kingsville;, 6, 4, 0, 0.60000, 166, 159, 7, 
1937, Texas A&M-Kingsville;, 4, 3, 1, 0.56250, 136, 66, 70, 
1938, Texas A&M-Kingsville;, 6, 3, 0, 0.66667, 175, 137, 38, 
1939, Texas A&M-Kingsville;, 6, 1, 3, 0.75000, 107, 42, 65, 
1941, Texas A&M-Kingsville;, 8, 2, 0, 0.80000, 335, 123, 212, 
1969, Princeton (NJ), 6, 3, 0, 0.66667, 248, 138, 110, 
1970, Princeton (NJ), 5, 4, 0, 0.55556, 195, 180, 15, 
1971, Princeton (NJ), 4, 5, 0, 0.44444, 195, 160, 35, 
1972, Princeton (NJ), 3, 5, 1, 0.38889, 120, 161, -41, 
1919, Chadron St. (NE), 2, 3, 0, 0.40000, 32, 78, -46, 
1923, Bowling Green (OH), 3, 5, 0, 0.37500, 68, 131, -63, 
1970, Duquesne (PA), 4, 3, 1, 0.56250, 130, 111, 19, 
1971, Duquesne (PA), 4, 4, 0, 0.50000, 173, 134, 39, 
1972, Duquesne (PA), 7, 1, 0, 0.87500, 233, 69, 164, 
1973, Duquesne (PA), 10, 0, 0, 1.00000, 181, 23, 158, 
1974, Duquesne (PA), 5, 2, 0, 0.71429, 133, 95, 38, 
1975, Duquesne (PA), 5, 4, 0, 0.55556, 137, 154, -17, 
1976, Duquesne (PA), 6, 2, 0, 0.75000, 202, 85, 117, 
1977, Duquesne (PA), 7, 2, 0, 0.77778, 201, 114, 87, 
1978, Duquesne (PA), 5, 3, 0, 0.62500, 98, 90, 8, 
1979, Duquesne (PA), 5, 4, 0, 0.55556, 188, 115, 73, 
1980, Duquesne (PA), 4, 5, 0, 0.44444, 131, 161, -30, 
1981, Duquesne (PA), 4, 5, 0, 0.44444, 165, 112, 53, 
1982, Duquesne (PA), 6, 3, 0, 0.66667, 160, 142, 18, 
1983, Duquesne (PA), 5, 4, 1, 0.55000, 182, 153, 29, 
1988, Duquesne (PA), 2, 7, 0, 0.22222, 107, 210, -103, 
1989, Duquesne (PA), 6, 4, 0, 0.60000, 121, 126, -5, 
1990, Duquesne (PA), 1, 8, 1, 0.15000, 74, 291, -217, 
1991, Duquesne (PA), 0, 9, 0, 0.00000, 100, 314, -214, 
1992, Duquesne (PA), 5, 4, 0, 0.55556, 170, 159, 11, 
1983, McNeese St. (LA), 6, 5, 0, 0.54545, 192, 212, -20, 
1984, McNeese St. (LA), 7, 3, 1, 0.68182, 239, 170, 69, 
1985, McNeese St. (LA), 6, 3, 2, 0.63636, 172, 126, 46, 
1986, McNeese St. (LA), 2, 9, 0, 0.18182, 228, 284, -56, 
1917, Maine, 1, 3, 1, 0.30000, 21, 56, -35, 
1931, Miami (FL), 4, 8, 0, 0.33333, 90, 170, -80, 
1932, Miami (FL), 4, 3, 1, 0.56250, 57, 39, 18, 
1933, Miami (FL), 5, 1, 2, 0.75000, 197, 46, 151, 
1934, Miami (FL), 5, 3, 1, 0.61111, 150, 92, 58, 
1897, Alabama, 1, 0, 0, 1.00000, 6, 0, 6, 
1935, Arkansas-Pine Bluff, 4, 6, 0, 0.40000, 109, 164, -55, 
1936, Arkansas-Pine Bluff, 5, 4, 1, 0.55000, 70, 81, -11, 
1995, Iowa St., 3, 8, 0, 0.27273, 264, 409, -145, 
1996, Iowa St., 2, 9, 0, 0.18182, 314, 401, -87, 
1997, Iowa St., 1, 10, 0, 0.09091, 214, 493, -279, 
1998, Iowa St., 3, 8, 0, 0.27273, 221, 328, -107, 
1999, Iowa St., 4, 7, 0, 0.36364, 247, 272, -25, 
2000, Iowa St., 9, 3, 0, 0.75000, 343, 322, 21, 
2001, Iowa St., 7, 5, 0, 0.58333, 309, 245, 64, 
2002, Iowa St., 7, 7, 0, 0.50000, 404, 396, 8, 
2003, Iowa St., 2, 10, 0, 0.16667, 173, 437, -264, 
2004, Iowa St., 7, 5, 0, 0.58333, 246, 259, -13, 
2005, Iowa St., 7, 5, 0, 0.58333, 339, 230, 109, 
2006, Iowa St., 4, 8, 0, 0.33333, 226, 369, -143, 
2011, North Texas, 5, 7, 0, 0.41667, 298, 368, -70, 
2012, North Texas, 4, 8, 0, 0.33333, 251, 334, -83, 
2013, North Texas, 9, 4, 0, 0.69231, 414, 231, 183, 
1897, Georgia, 2, 1, 0, 0.66667, 56, 17, 39, 
1898, Georgia, 4, 2, 0, 0.66667, 70, 70, 0, 
1909, Boston College (MA), 3, 4, 1, 0.43750, 71, 42, 29, 
1909, Indiana St., 0, 0, 1, 0.50000, 5, 5, 0, 
1925, Manhattan (NY), 1, 6, 1, 0.18750, 57, 216, -159, 
1926, Manhattan (NY), 4, 4, 0, 0.50000, 81, 125, -44, 
1927, Manhattan (NY), 4, 2, 1, 0.64286, 225, 50, 175, 
1900, Fordham (NY), 3, 1, 1, 0.70000, 71, 15, 56, 
1901, Fordham (NY), 2, 1, 1, 0.62500, 27, 13, 14, 
1982, Colorado, 2, 8, 1, 0.22727, 160, 301, -141, 
1983, Colorado, 4, 7, 0, 0.36364, 252, 342, -90, 
1984, Colorado, 1, 10, 0, 0.09091, 172, 364, -192, 
1985, Colorado, 7, 5, 0, 0.58333, 228, 174, 54, 
1986, Colorado, 6, 6, 0, 0.50000, 242, 193, 49, 
1987, Colorado, 7, 4, 0, 0.63636, 268, 180, 88, 
1988, Colorado, 8, 4, 0, 0.66667, 322, 196, 126, 
1989, Colorado, 11, 1, 0, 0.91667, 458, 171, 287, 
1990, Colorado, 11, 1, 1, 0.88462, 399, 229, 170, 
1991, Colorado, 8, 3, 1, 0.70833, 329, 180, 149, 
1992, Colorado, 9, 2, 1, 0.79167, 340, 224, 116, 
1993, Colorado, 8, 3, 1, 0.70833, 368, 250, 118, 
1994, Colorado, 11, 1, 0, 0.91667, 439, 235, 204, 
1919, Kansas, 3, 2, 3, 0.56250, 85, 35, 50, 
2013, East Central (OK), 5, 5, 0, 0.50000, 314, 302, 12, 
1904, Marshall (WV), 1, 3, 3, 0.35714, 16, 26, -10, 
1905, Marshall (WV), 6, 2, 0, 0.75000, 40, 98, -58, 
1906, Marshall (WV), 4, 0, 1, 0.90000, 56, 5, 51, 
1919, Abilene Christian (TX), 2, 2, 0, 0.50000, 77, 88, -11, 
1894, Michigan, 9, 1, 1, 0.86364, 240, 84, 156, 
1895, Michigan, 8, 1, 0, 0.88889, 266, 14, 252, 
1918, Emporia St. (KS), 2, 2, 0, 0.50000, 26, 49, -23, 
1920, Lawrence (WI), 7, 1, 0, 0.87500, 174, 66, 108, 
1921, Lawrence (WI), 5, 2, 0, 0.71429, 97, 40, 57, 
1922, Lawrence (WI), 6, 0, 1, 0.92857, 134, 10, 124, 
1960, Hardin-Simmons (TX), 0, 10, 0, 0.00000, 68, 308, -240, 
1961, Hardin-Simmons (TX), 0, 10, 0, 0.00000, 43, 377, -334, 
1970, Clark Atlanta (GA), 1, 5, 0, 0.16667, 30, 88, -58, 
1971, Clark Atlanta (GA), 3, 4, 0, 0.42857, 66, 127, -61, 
1972, Clark Atlanta (GA), 2, 5, 1, 0.31250, 119, 136, -17, 
1973, Clark Atlanta (GA), 4, 2, 1, 0.64286, 106, 110, -4, 
1974, Clark Atlanta (GA), 9, 1, 0, 0.90000, 218, 154, 64, 
1975, Clark Atlanta (GA), 4, 4, 1, 0.50000, 98, 111, -13, 
1976, Clark Atlanta (GA), 3, 6, 0, 0.33333, 152, 250, -98, 
1977, Clark Atlanta (GA), 3, 5, 0, 0.37500, 100, 85, 15, 
1978, Clark Atlanta (GA), 7, 2, 0, 0.77778, 151, 105, 46, 
1979, Clark Atlanta (GA), 2, 5, 1, 0.31250, 136, 175, -39, 
1980, Clark Atlanta (GA), 3, 4, 0, 0.42857, 174, 168, 6, 
1981, Clark Atlanta (GA), 4, 5, 0, 0.44444, 116, 240, -124, 
1982, Clark Atlanta (GA), 1, 8, 0, 0.11111, 70, 206, -136, 
1983, Clark Atlanta (GA), 2, 7, 0, 0.22222, 129, 240, -111, 
1984, Clark Atlanta (GA), 2, 7, 0, 0.22222, 80, 257, -177, 
1985, Clark Atlanta (GA), 2, 6, 0, 0.25000, 116, 253, -137, 
1986, Clark Atlanta (GA), 1, 9, 0, 0.10000, 81, 209, -128, 
1987, Clark Atlanta (GA), 1, 8, 0, 0.11111, 71, 223, -152, 
1971, Ball St. (IN), 4, 5, 1, 0.45000, 136, 155, -19, 
1972, Ball St. (IN), 5, 4, 1, 0.55000, 235, 180, 55, 
1973, Ball St. (IN), 5, 5, 1, 0.50000, 226, 201, 25, 
1974, Ball St. (IN), 6, 4, 0, 0.60000, 265, 177, 88, 
1975, Ball St. (IN), 9, 2, 0, 0.81818, 244, 171, 73, 
1976, Ball St. (IN), 8, 3, 0, 0.72727, 257, 124, 133, 
1977, Ball St. (IN), 9, 2, 0, 0.81818, 377, 169, 208, 
1978, Wisconsin, 5, 4, 2, 0.54545, 223, 277, -54, 
1979, Wisconsin, 4, 7, 0, 0.36364, 208, 311, -103, 
1980, Wisconsin, 4, 7, 0, 0.36364, 138, 211, -73, 
1981, Wisconsin, 7, 5, 0, 0.58333, 268, 219, 49, 
1982, Wisconsin, 7, 5, 0, 0.58333, 287, 252, 35, 
1983, Wisconsin, 7, 4, 0, 0.63636, 359, 242, 117, 
1984, Wisconsin, 7, 4, 1, 0.62500, 242, 206, 36, 
1985, Wisconsin, 5, 6, 0, 0.45455, 231, 263, -32, 
1961, Bethune-Cookman (FL), 5, 3, 0, 0.62500, 178, 144, 34, 
1962, Bethune-Cookman (FL), 7, 2, 0, 0.77778, 294, 111, 183, 
1963, Bethune-Cookman (FL), 6, 3, 0, 0.66667, 223, 148, 75, 
1964, Bethune-Cookman (FL), 6, 3, 0, 0.66667, 263, 153, 110, 
1965, Bethune-Cookman (FL), 5, 2, 1, 0.68750, 212, 139, 73, 
1966, Bethune-Cookman (FL), 5, 2, 0, 0.71429, 134, 123, 11, 
1967, Bethune-Cookman (FL), 5, 2, 0, 0.71429, 206, 101, 105, 
1968, Bethune-Cookman (FL), 4, 4, 0, 0.50000, 194, 157, 37, 
1969, Bethune-Cookman (FL), 4, 3, 1, 0.56250, 191, 139, 52, 
1970, Bethune-Cookman (FL), 5, 4, 0, 0.55556, 174, 157, 17, 
1971, Bethune-Cookman (FL), 5, 4, 0, 0.55556, 220, 117, 103, 
1972, Bethune-Cookman (FL), 4, 5, 1, 0.45000, 281, 217, 64, 
1994, Bethune-Cookman (FL), 5, 6, 0, 0.45455, 260, 261, -1, 
1995, Bethune-Cookman (FL), 3, 8, 0, 0.27273, 219, 334, -115, 
1996, Bethune-Cookman (FL), 2, 9, 0, 0.18182, 195, 384, -189, 
1997, Bethune-Cookman (FL), 4, 7, 0, 0.36364, 207, 229, -22, 
1962, Louisiana St., 9, 1, 1, 0.86364, 175, 34, 141, 
1963, Louisiana St., 7, 4, 0, 0.63636, 142, 112, 30, 
1964, Louisiana St., 8, 2, 1, 0.77273, 128, 89, 39, 
1965, Louisiana St., 8, 3, 0, 0.72727, 265, 164, 101, 
1966, Louisiana St., 5, 4, 1, 0.55000, 135, 124, 11, 
1967, Louisiana St., 7, 3, 1, 0.68182, 268, 127, 141, 
1968, Louisiana St., 8, 3, 0, 0.72727, 221, 171, 50, 
1969, Louisiana St., 9, 1, 0, 0.90000, 349, 91, 258, 
1970, Louisiana St., 9, 3, 0, 0.75000, 289, 113, 176, 
1971, Louisiana St., 9, 3, 0, 0.75000, 353, 153, 200, 
1972, Louisiana St., 9, 2, 1, 0.79167, 252, 145, 107, 
1973, Louisiana St., 9, 3, 0, 0.75000, 267, 169, 98, 
1974, Louisiana St., 5, 5, 1, 0.50000, 202, 168, 34, 
1975, Louisiana St., 5, 6, 0, 0.45455, 159, 202, -43, 
1976, Louisiana St., 7, 3, 1, 0.68182, 255, 149, 106, 
1977, Louisiana St., 8, 4, 0, 0.66667, 389, 220, 169, 
1978, Louisiana St., 8, 4, 0, 0.66667, 279, 193, 86, 
1979, Louisiana St., 7, 5, 0, 0.58333, 275, 151, 124, 
1895, Navy (MD), 5, 2, 0, 0.71429, 152, 16, 136, 
1892, California, 2, 1, 1, 0.62500, 44, 34, 10, 
2005, Southern Oregon, 1, 9, 0, 0.10000, 166, 303, -137, 
1999, Middle Tennessee St., 3, 8, 0, 0.27273, 272, 379, -107, 
2000, Middle Tennessee St., 6, 5, 0, 0.54545, 350, 316, 34, 
2001, Middle Tennessee St., 8, 3, 0, 0.72727, 408, 286, 122, 
2002, Middle Tennessee St., 4, 8, 0, 0.33333, 297, 332, -35, 
2003, Middle Tennessee St., 4, 8, 0, 0.33333, 332, 375, -43, 
2004, Middle Tennessee St., 5, 6, 0, 0.45455, 269, 293, -24, 
2005, Middle Tennessee St., 4, 7, 0, 0.36364, 210, 206, 4, 
1946, West Alabama, 4, 2, 0, 0.66667, 110, 70, 40, 
1947, Troy (AL), 5, 4, 1, 0.55000, 183, 109, 74, 
1948, Troy (AL), 6, 5, 0, 0.54545, 171, 121, 50, 
1949, Troy (AL), 6, 3, 1, 0.65000, 166, 105, 61, 
1950, Troy (AL), 3, 6, 1, 0.35000, 123, 160, -37, 
1979, Eureka (IL), 2, 6, 0, 0.25000, 94, 164, -70, 
1980, Eureka (IL), 3, 5, 1, 0.38889, 96, 172, -76, 
1981, Eureka (IL), 3, 5, 1, 0.38889, 93, 140, -47, 
1982, Eureka (IL), 1, 7, 0, 0.12500, 52, 204, -152, 
1983, Eureka (IL), 1, 8, 0, 0.11111, 58, 261, -203, 
1984, Eureka (IL), 2, 7, 0, 0.22222, 71, 194, -123, 
1985, Eureka (IL), 4, 5, 0, 0.44444, 162, 184, -22, 
1986, Eureka (IL), 3, 5, 1, 0.38889, 96, 133, -37, 
1987, Eureka (IL), 2, 8, 0, 0.20000, 75, 146, -71, 
1988, Eureka (IL), 1, 9, 0, 0.10000, 62, 213, -151, 
1989, Eureka (IL), 4, 6, 0, 0.40000, 119, 307, -188, 
1946, Edinboro (PA), 0, 6, 0, 0.00000, 7, 161, -154, 
1947, Edinboro (PA), 1, 6, 0, 0.14286, 25, 154, -129, 
1948, Edinboro (PA), 1, 7, 0, 0.12500, 20, 146, -126, 
1949, Edinboro (PA), 1, 5, 2, 0.25000, 63, 140, -77, 
1950, Edinboro (PA), 3, 4, 0, 0.42857, 82, 121, -39, 
1951, Edinboro (PA), 0, 5, 1, 0.08333, 45, 117, -72, 
1952, Edinboro (PA), 3, 4, 0, 0.42857, 83, 75, 8, 
1953, Edinboro (PA), 3, 5, 1, 0.38889, 136, 94, 42, 
1954, Edinboro (PA), 1, 6, 0, 0.14286, 78, 148, -70, 
1955, Edinboro (PA), 1, 8, 0, 0.11111, 44, 193, -149, 
1999, Virginia Military Institute, 1, 10, 0, 0.09091, 77, 400, -323, 
2000, Virginia Military Institute, 2, 9, 0, 0.18182, 227, 434, -207, 
2001, Virginia Military Institute, 1, 10, 0, 0.09091, 164, 446, -282, 
2002, Virginia Military Institute, 6, 6, 0, 0.50000, 314, 415, -101, 
2003, Virginia Military Institute, 6, 6, 0, 0.50000, 359, 257, 102, 
2004, Virginia Military Institute, 0, 11, 0, 0.00000, 137, 327, -190, 
2005, Virginia Military Institute, 3, 8, 0, 0.27273, 230, 319, -89, 
1958, Lafayette (PA), 5, 3, 1, 0.61111, 144, 107, 37, 
1959, Lafayette (PA), 5, 4, 0, 0.55556, 159, 122, 37, 
1960, Lafayette (PA), 5, 4, 0, 0.55556, 89, 160, -71, 
1961, Lafayette (PA), 2, 6, 1, 0.27778, 80, 163, -83, 
1962, Lafayette (PA), 3, 6, 0, 0.33333, 77, 157, -80, 
1914, Doane (NE), 4, 2, 2, 0.62500, 68, 67, 1, 
1915, Arkansas, 4, 2, 1, 0.64286, 121, 55, 66, 
1916, Arkansas, 4, 4, 0, 0.50000, 261, 124, 137, 
1956, Fort Hays St. (KS), 1, 8, 0, 0.11111, 75, 214, -139, 
1957, Fort Hays St. (KS), 4, 4, 0, 0.50000, 164, 198, -34, 
1958, Fort Hays St. (KS), 4, 4, 1, 0.50000, 97, 150, -53, 
1959, Fort Hays St. (KS), 3, 6, 0, 0.33333, 116, 190, -74, 
1960, Fort Hays St. (KS), 2, 7, 0, 0.22222, 116, 227, -111, 
1961, Fort Hays St. (KS), 0, 9, 0, 0.00000, 119, 145, -26, 
1962, Fort Hays St. (KS), 6, 2, 1, 0.72222, 193, 101, 92, 
1963, Fort Hays St. (KS), 2, 6, 1, 0.27778, 99, 248, -149, 
1964, Fort Hays St. (KS), 5, 4, 0, 0.55556, 210, 169, 41, 
1965, Fort Hays St. (KS), 6, 3, 0, 0.66667, 198, 118, 80, 
1966, Fort Hays St. (KS), 7, 2, 0, 0.77778, 193, 75, 118, 
1967, Fort Hays St. (KS), 3, 5, 0, 0.37500, 144, 125, 19, 
1968, Fort Hays St. (KS), 2, 7, 0, 0.22222, 132, 188, -56, 
1961, Delta St. (MS), 7, 2, 1, 0.75000, 210, 83, 127, 
1962, Delta St. (MS), 7, 2, 0, 0.77778, 193, 100, 93, 
1963, Delta St. (MS), 6, 3, 0, 0.66667, 181, 117, 64, 
1964, Delta St. (MS), 7, 3, 0, 0.70000, 145, 84, 61, 
1965, Delta St. (MS), 8, 1, 0, 0.88889, 199, 73, 126, 
1966, Delta St. (MS), 6, 4, 0, 0.60000, 214, 118, 96, 
1967, Delta St. (MS), 5, 5, 0, 0.50000, 158, 203, -45, 
1968, Delta St. (MS), 5, 5, 0, 0.50000, 245, 181, 64, 
1969, Delta St. (MS), 4, 6, 0, 0.40000, 214, 168, 46, 
1970, Delta St. (MS), 3, 6, 1, 0.35000, 156, 259, -103, 
1971, Delta St. (MS), 3, 5, 1, 0.38889, 162, 173, -11, 
1972, Delta St. (MS), 7, 3, 0, 0.70000, 234, 124, 110, 
1973, Delta St. (MS), 8, 3, 0, 0.72727, 285, 202, 83, 
1964, Jamestown (ND), 1, 7, 0, 0.12500, 45, 293, -248, 
1985, West Alabama, 6, 5, 0, 0.54545, 193, 162, 31, 
1986, West Alabama, 3, 8, 0, 0.27273, 190, 244, -54, 
1987, West Alabama, 5, 5, 1, 0.50000, 171, 154, 17, 
1988, West Alabama, 0, 11, 0, 0.00000, 127, 287, -160, 
1989, West Alabama, 3, 7, 1, 0.31818, 172, 276, -104, 
1990, West Alabama, 3, 8, 0, 0.27273, 176, 344, -168, 
2000, Tennessee-Martin, 2, 9, 0, 0.18182, 122, 453, -331, 
2001, Tennessee-Martin, 1, 10, 0, 0.09091, 198, 422, -224, 
2002, Tennessee-Martin, 2, 6, 0, 0.25000, 133, 270, -137, 
2004, West Alabama, 2, 9, 0, 0.18182, 208, 391, -183, 
2005, West Alabama, 2, 9, 0, 0.18182, 196, 329, -133, 
1920, West Texas A&M;, 0, 6, 1, 0.07143, 40, 108, -68, 
1909, Princeton (NJ), 6, 2, 1, 0.72222, 101, 50, 51, 
1896, Central Michigan, 3, 1, 0, 0.75000, 62, 22, 40, 
1894, Carlisle Indian School (PA), 1, 6, 2, 0.22222, 62, 112, -50, 
1895, Carlisle Indian School (PA), 4, 4, 0, 0.50000, 88, 114, -26, 
1901, Dartmouth (NH), 9, 1, 0, 0.90000, 267, 53, 214, 
1902, Dartmouth (NH), 6, 2, 1, 0.72222, 105, 39, 66, 
1903, Northwestern (IL), 10, 1, 3, 0.82143, 229, 67, 162, 
1904, Northwestern (IL), 8, 2, 0, 0.80000, 312, 55, 257, 
1905, Northwestern (IL), 8, 2, 1, 0.77273, 214, 122, 92, 
1921, Carson-Newman (TN), 6, 2, 1, 0.72222, 121, 28, 93, 
1933, Northeastern (MA), 1, 3, 1, 0.30000, 40, 51, -11, 
1934, Northeastern (MA), 6, 1, 1, 0.81250, 140, 75, 65, 
1935, Northeastern (MA), 5, 0, 3, 0.81250, 134, 37, 97, 
1936, Northeastern (MA), 5, 4, 0, 0.55556, 133, 93, 40, 
1914, Florida, 5, 2, 0, 0.71429, 152, 46, 106, 
1915, Florida, 4, 3, 0, 0.57143, 99, 65, 34, 
1916, Florida, 0, 5, 0, 0.00000, 3, 95, -92, 
1919, Eastern Kentucky, 0, 2, 0, 0.00000, 0, 49, -49, 
1914, Wofford (SC), 1, 7, 1, 0.16667, 31, 253, -222, 
1905, Maine, 4, 3, 1, 0.56250, 68, 68, 0, 
1906, Maine, 2, 4, 2, 0.37500, 15, 33, -18, 
1907, Maine, 2, 4, 2, 0.37500, 23, 137, -114, 
1908, Maine, 4, 4, 0, 0.50000, 95, 69, 26, 
1920, Pacific (CA), 1, 2, 1, 0.37500, 28, 55, -27, 
1921, Allegheny (PA), 3, 4, 1, 0.43750, 53, 131, -78, 
1922, Allegheny (PA), 6, 3, 0, 0.66667, 239, 67, 172, 
1923, Allegheny (PA), 7, 1, 0, 0.87500, 146, 41, 105, 
1924, Lafayette (PA), 7, 2, 0, 0.77778, 158, 58, 100, 
1925, Lafayette (PA), 7, 1, 1, 0.83333, 208, 43, 165, 
1926, Lafayette (PA), 9, 0, 0, 1.00000, 327, 37, 290, 
1927, Lafayette (PA), 5, 3, 1, 0.61111, 262, 114, 148, 
1928, Lafayette (PA), 6, 1, 2, 0.77778, 237, 44, 193, 
1929, Lafayette (PA), 3, 5, 0, 0.37500, 84, 64, 20, 
1930, Lafayette (PA), 5, 3, 1, 0.61111, 141, 126, 15, 
1931, Lafayette (PA), 7, 2, 0, 0.77778, 188, 26, 162, 
1932, Lafayette (PA), 3, 5, 0, 0.37500, 94, 75, 19, 
1933, Lafayette (PA), 3, 5, 1, 0.38889, 124, 128, -4, 
1934, Lafayette (PA), 2, 6, 0, 0.25000, 71, 132, -61, 
1935, Lafayette (PA), 2, 7, 0, 0.22222, 39, 297, -258, 
1941, South Dakota St., 2, 5, 0, 0.28571, 32, 131, -99, 
1942, South Dakota St., 4, 4, 0, 0.50000, 65, 92, -27, 
1944, South Dakota St., 1, 1, 0, 0.50000, 13, 26, -13, 
1945, South Dakota St., 1, 4, 1, 0.25000, 51, 144, -93, 
1946, South Dakota St., 3, 3, 2, 0.50000, 131, 76, 55, 
1948, Samford (AL), 4, 4, 0, 0.50000, 68, 114, -46, 
1914, Dayton (OH), 2, 2, 0, 0.50000, 46, 34, 12, 
1915, Dayton (OH), 3, 2, 0, 0.60000, 49, 22, 27, 
1916, Dayton (OH), 4, 3, 0, 0.57143, 169, 191, -22, 
2003, Austin Peay St. (TN), 4, 7, 0, 0.36364, 194, 276, -82, 
2004, Austin Peay St. (TN), 2, 9, 0, 0.18182, 161, 313, -152, 
2005, Austin Peay St. (TN), 2, 9, 0, 0.18182, 140, 412, -272, 
2006, Austin Peay St. (TN), 3, 8, 0, 0.27273, 245, 271, -26, 
2012, North Greenville (SC), 5, 6, 0, 0.45455, 181, 317, -136, 
2013, Gardner-Webb (NC), 7, 5, 0, 0.58333, 263, 276, -13, 
1944, William & Mary (VA), 5, 2, 1, 0.68750, 191, 65, 126, 
1945, William & Mary (VA), 6, 3, 0, 0.66667, 180, 110, 70, 
1946, William & Mary (VA), 8, 2, 0, 0.80000, 347, 71, 276, 
1947, William & Mary (VA), 9, 2, 0, 0.81818, 320, 87, 233, 
1948, William & Mary (VA), 7, 2, 2, 0.72727, 183, 67, 116, 
1949, William & Mary (VA), 6, 4, 0, 0.60000, 256, 169, 87, 
1950, William & Mary (VA), 4, 7, 0, 0.36364, 220, 230, -10, 
1923, Arizona St., 4, 2, 0, 0.66667, 152, 102, 50, 
1924, Arizona St., 6, 1, 1, 0.81250, 160, 85, 75, 
1925, Arizona St., 6, 2, 0, 0.75000, 154, 59, 95, 
1926, Arizona St., 4, 1, 1, 0.75000, 97, 42, 55, 
1927, Arizona St., 2, 3, 1, 0.41667, 63, 50, 13, 
1928, Arizona St., 3, 2, 1, 0.58333, 133, 73, 60, 
1929, Arizona St., 0, 6, 0, 0.00000, 13, 143, -130, 
1895, West Virginia, 5, 1, 0, 0.83333, 58, 10, 48, 
2013, Valley City St. (ND), 5, 5, 0, 0.50000, 327, 235, 92, 
1921, Eastern Michigan, 3, 3, 0, 0.50000, 82, 50, 32, 
1922, Eastern Michigan, 3, 2, 2, 0.57143, 31, 28, 3, 
1925, Mesa St. (CO), 3, 1, 0, 0.75000, 52, 36, 16, 
1957, San Diego (CA), 6, 3, 0, 0.66667, 235, 127, 108, 
1958, San Diego (CA), 7, 2, 0, 0.77778, 211, 122, 89, 
1903, Arkansas, 3, 4, 0, 0.42857, 50, 63, -13, 
1925, Duquesne (PA), 0, 7, 0, 0.00000, 9, 165, -156, 
1926, Duquesne (PA), 2, 5, 1, 0.31250, 53, 108, -55, 
1920, Northwestern (IL), 3, 4, 0, 0.42857, 66, 90, -24, 
1921, Northwestern (IL), 1, 6, 0, 0.14286, 34, 120, -86, 
1923, Denver (CO), 6, 3, 0, 0.66667, 117, 99, 18, 
1924, Denver (CO), 4, 2, 2, 0.62500, 36, 35, 1, 
1917, Colgate (NY), 4, 2, 0, 0.66667, 118, 40, 78, 
1934, Missouri St., 1, 5, 1, 0.21429, 31, 176, -145, 
1935, Missouri St., 3, 4, 1, 0.43750, 59, 81, -22, 
1936, Missouri St., 1, 5, 2, 0.25000, 55, 92, -37, 
1937, Missouri St., 0, 8, 1, 0.05556, 50, 240, -190, 
1965, Northern Arizona, 5, 4, 1, 0.55000, 196, 106, 90, 
1966, Northern Arizona, 6, 4, 0, 0.60000, 202, 159, 43, 
1967, Northern Arizona, 5, 5, 0, 0.50000, 228, 222, 6, 
1968, Northern Arizona, 6, 4, 0, 0.60000, 229, 156, 73, 
1969, Edinboro (PA), 4, 4, 1, 0.50000, 194, 203, -9, 
1970, Edinboro (PA), 9, 1, 0, 0.90000, 237, 89, 148, 
1971, Edinboro (PA), 9, 1, 0, 0.90000, 355, 155, 200, 
1972, Edinboro (PA), 3, 5, 1, 0.38889, 167, 158, 9, 
1973, Edinboro (PA), 4, 4, 1, 0.50000, 168, 182, -14, 
1974, Edinboro (PA), 5, 2, 2, 0.66667, 131, 127, 4, 
1975, Edinboro (PA), 8, 3, 0, 0.72727, 255, 156, 99, 
1976, Edinboro (PA), 6, 4, 0, 0.60000, 273, 174, 99, 
1977, Edinboro (PA), 3, 6, 1, 0.35000, 139, 123, 16, 
1978, Edinboro (PA), 3, 6, 1, 0.35000, 167, 247, -80, 
1923, San Jose St. (CA), 0, 6, 0, 0.00000, 3, 262, -259, 
1937, Hofstra (NY), 2, 4, 0, 0.33333, 63, 72, -9, 
1938, Hofstra (NY), 2, 3, 1, 0.41667, 46, 47, -1, 
1939, Hofstra (NY), 4, 2, 0, 0.66667, 60, 61, -1, 
1940, Hofstra (NY), 4, 3, 0, 0.57143, 147, 73, 74, 
1941, Hofstra (NY), 5, 2, 0, 0.71429, 149, 77, 72, 
1946, Hofstra (NY), 4, 3, 0, 0.57143, 79, 66, 13, 
1895, Villanova (PA), 3, 3, 0, 0.50000, 60, 50, 10, 
1896, Villanova (PA), 10, 4, 0, 0.71429, 157, 94, 63, 
1963, Tennessee, 5, 5, 0, 0.50000, 168, 121, 47, 
1974, Saint Mary's (CA), 3, 6, 0, 0.33333, 162, 181, -19, 
1975, Saint Mary's (CA), 3, 8, 0, 0.27273, 188, 240, -52, 
1976, Saint Mary's (CA), 3, 6, 0, 0.33333, 179, 242, -63, 
1945, Western Carolina (NC), 1, 3, 0, 0.25000, 51, 124, -73, 
1953, Virginia, 1, 8, 0, 0.11111, 75, 242, -167, 
1954, Virginia, 3, 6, 0, 0.33333, 113, 162, -49, 
1955, Virginia, 1, 9, 0, 0.10000, 96, 201, -105, 
2008, Becker College (MA), 2, 7, 0, 0.22222, 155, 348, -193, 
2009, Becker College (MA), 0, 10, 0, 0.00000, 129, 520, -391, 
2010, Becker College (MA), 2, 8, 0, 0.20000, 133, 430, -297, 
1906, Johns Hopkins (MD), 2, 5, 1, 0.31250, 15, 62, -47, 
1999, New Hampshire, 5, 6, 0, 0.45455, 325, 294, 31, 
2000, New Hampshire, 6, 5, 0, 0.54545, 289, 314, -25, 
2001, New Hampshire, 4, 7, 0, 0.36364, 329, 392, -63, 
2002, New Hampshire, 3, 8, 0, 0.27273, 199, 345, -146, 
2003, New Hampshire, 5, 7, 0, 0.41667, 406, 380, 26, 
2004, New Hampshire, 10, 3, 0, 0.76923, 426, 339, 87, 
2005, New Hampshire, 11, 2, 0, 0.84615, 542, 289, 253, 
2006, New Hampshire, 9, 4, 0, 0.69231, 459, 312, 147, 
2007, New Hampshire, 7, 5, 0, 0.58333, 429, 352, 77, 
2008, New Hampshire, 10, 3, 0, 0.76923, 463, 306, 157, 
2009, New Hampshire, 10, 3, 0, 0.76923, 414, 274, 140, 
2010, New Hampshire, 8, 5, 0, 0.61538, 322, 214, 108, 
2011, New Hampshire, 8, 4, 0, 0.66667, 394, 379, 15, 
2012, New Hampshire, 8, 4, 0, 0.66667, 409, 363, 46, 
2013, New Hampshire, 10, 5, 0, 0.66667, 462, 345, 117, 
1985, Central Florida, 4, 7, 0, 0.36364, 266, 386, -120, 
1986, Central Florida, 6, 5, 0, 0.54545, 310, 227, 83, 
1987, Central Florida, 9, 4, 0, 0.69231, 401, 210, 191, 
1988, Central Florida, 6, 5, 0, 0.54545, 267, 288, -21, 
1989, Central Florida, 7, 3, 0, 0.70000, 256, 168, 88, 
1990, Central Florida, 10, 4, 0, 0.71429, 444, 280, 164, 
1991, Central Florida, 6, 5, 0, 0.54545, 278, 230, 48, 
1992, Central Florida, 7, 4, 0, 0.63636, 416, 249, 167, 
1993, Central Florida, 9, 3, 0, 0.75000, 413, 277, 136, 
1994, Central Florida, 7, 4, 0, 0.63636, 399, 263, 136, 
1995, Central Florida, 6, 5, 0, 0.54545, 283, 280, 3, 
1996, Central Florida, 5, 6, 0, 0.45455, 277, 261, 16, 
1997, Central Florida, 5, 6, 0, 0.45455, 374, 303, 71, 
1955, Nevada, 2, 5, 0, 0.28571, 70, 199, -129, 
1956, Nevada, 0, 7, 1, 0.06250, 122, 198, -76, 
1957, Nevada, 1, 8, 0, 0.11111, 107, 229, -122, 
1958, Nevada, 3, 3, 0, 0.50000, 100, 97, 3, 
1983, New Haven (CT), 1, 9, 0, 0.10000, 112, 210, -98, 
1984, New Haven (CT), 5, 5, 0, 0.50000, 170, 231, -61, 
1985, New Haven (CT), 6, 4, 0, 0.60000, 228, 145, 83, 
1986, Columbia (NY), 0, 10, 0, 0.00000, 91, 379, -288, 
1987, Columbia (NY), 0, 10, 0, 0.00000, 104, 311, -207, 
1988, Columbia (NY), 2, 8, 0, 0.20000, 140, 303, -163, 
2012, Colorado St., 4, 8, 0, 0.33333, 254, 363, -109, 
2013, Colorado St., 8, 6, 0, 0.57143, 507, 417, 90, 
1927, Ferris St. (MI), 4, 3, 0, 0.57143, 109, 87, 22, 
1928, Ferris St. (MI), 6, 2, 0, 0.75000, 151, 79, 72, 
1929, Ferris St. (MI), 3, 2, 1, 0.58333, 89, 73, 16, 
1930, Ferris St. (MI), 3, 3, 0, 0.50000, 50, 92, -42, 
1931, Ferris St. (MI), 3, 4, 1, 0.43750, 64, 98, -34, 
1933, Ferris St. (MI), 2, 4, 0, 0.33333, 38, 110, -72, 
1934, Ferris St. (MI), 1, 5, 0, 0.16667, 25, 49, -24, 
1935, Ferris St. (MI), 4, 2, 0, 0.66667, 50, 53, -3, 
1936, Ferris St. (MI), 1, 5, 1, 0.21429, 19, 140, -121, 
1937, Ferris St. (MI), 2, 3, 2, 0.42857, 74, 112, -38, 
1938, Ferris St. (MI), 0, 5, 2, 0.14286, 18, 187, -169, 
1939, Ferris St. (MI), 2, 6, 0, 0.25000, 46, 170, -124, 
2013, California Lutheran, 4, 5, 0, 0.44444, 264, 218, 46, 
1936, Davidson (NC), 5, 4, 0, 0.55556, 144, 97, 47, 
1937, Davidson (NC), 2, 8, 0, 0.20000, 56, 142, -86, 
1938, Davidson (NC), 4, 6, 0, 0.40000, 70, 163, -93, 
1939, Davidson (NC), 2, 7, 0, 0.22222, 81, 166, -85, 
1940, Davidson (NC), 5, 5, 0, 0.50000, 153, 205, -52, 
1941, Davidson (NC), 1, 6, 3, 0.25000, 63, 176, -113, 
1942, Davidson (NC), 2, 6, 1, 0.27778, 68, 167, -99, 
1943, Davidson (NC), 0, 5, 0, 0.00000, 15, 122, -107, 
1944, North Carolina, 1, 7, 1, 0.16667, 33, 173, -140, 
1945, Virginia Tech, 2, 6, 0, 0.25000, 78, 150, -72, 
1923, Army (NY), 6, 2, 1, 0.72222, 237, 56, 181, 
1924, Army (NY), 5, 1, 2, 0.75000, 111, 41, 70, 
1925, Army (NY), 7, 2, 0, 0.77778, 185, 71, 114, 
1926, Oregon, 2, 4, 1, 0.35714, 86, 88, -2, 
1927, Oregon, 2, 4, 1, 0.35714, 45, 69, -24, 
1928, Oregon, 9, 2, 0, 0.81818, 235, 59, 176, 
1929, Oregon, 7, 3, 0, 0.70000, 209, 91, 118, 
1930, Holy Cross (MA), 8, 2, 0, 0.80000, 195, 45, 150, 
1931, Holy Cross (MA), 7, 2, 1, 0.75000, 166, 53, 113, 
1932, Holy Cross (MA), 6, 1, 0, 0.85714, 101, 35, 66, 
1903, New Mexico, 3, 0, 1, 0.87500, 30, 0, 30, 
1904, New Mexico, 1, 0, 0, 1.00000, 11, 0, 11, 
1903, Oregon St., 2, 4, 1, 0.35714, 21, 32, -11, 
1904, DePauw (IN), 8, 2, 0, 0.80000, 212, 61, 151, 
1906, Ohio, 7, 1, 0, 0.87500, 158, 28, 130, 
1907, Ohio, 3, 4, 1, 0.43750, 76, 139, -63, 
1908, Ohio, 3, 5, 0, 0.37500, 100, 65, 35, 
2005, Stephen F. Austin (TX), 5, 6, 0, 0.45455, 324, 380, -56, 
2006, Stephen F. Austin (TX), 4, 7, 0, 0.36364, 204, 232, -28, 
1996, San Diego (CA), 4, 6, 0, 0.40000, 197, 257, -60, 
1997, San Diego (CA), 8, 3, 0, 0.72727, 369, 287, 82, 
1998, San Diego (CA), 2, 8, 0, 0.20000, 184, 259, -75, 
1999, San Diego (CA), 5, 5, 0, 0.50000, 215, 201, 14, 
2000, San Diego (CA), 4, 6, 0, 0.40000, 242, 313, -71, 
2001, San Diego (CA), 6, 3, 0, 0.66667, 236, 203, 33, 
2002, San Diego (CA), 5, 5, 0, 0.50000, 297, 309, -12, 
2003, San Diego (CA), 5, 1, 0, 0.83333, 224, 137, 87, 
1997, West Texas A&M;, 7, 4, 0, 0.63636, 321, 185, 136, 
1998, West Texas A&M;, 8, 3, 0, 0.72727, 368, 190, 178, 
1999, West Texas A&M;, 3, 8, 0, 0.27273, 162, 238, -76, 
2000, West Texas A&M;, 5, 6, 0, 0.45455, 244, 266, -22, 
2001, West Texas A&M;, 2, 9, 0, 0.18182, 230, 360, -130, 
1893, Monmouth (IL), 4, 2, 0, 0.66667, 116, 44, 72, 
1894, Monmouth (IL), 7, 2, 1, 0.75000, 145, 46, 99, 
1895, Monmouth (IL), 5, 4, 0, 0.55556, 95, 58, 37, 
1896, Monmouth (IL), 6, 5, 0, 0.54545, 146, 89, 57, 
1980, Arkansas-Pine Bluff, 5, 6, 0, 0.45455, 167, 166, 1, 
1981, Arkansas-Pine Bluff, 5, 4, 2, 0.54545, 224, 213, 11, 
1982, Arkansas-Pine Bluff, 5, 5, 1, 0.50000, 219, 210, 9, 
1983, Arkansas-Pine Bluff, 2, 7, 1, 0.25000, 169, 301, -132, 
1905, Fordham (NY), 5, 2, 0, 0.71429, 74, 67, 7, 
2012, Alabama-Birmingham, 3, 9, 0, 0.25000, 339, 450, -111, 
2013, Alabama-Birmingham, 2, 10, 0, 0.16667, 315, 525, -210, 
1970, East Carolina (NC), 3, 8, 0, 0.27273, 136, 253, -117, 
1971, Duke (NC), 6, 5, 0, 0.54545, 170, 149, 21, 
1972, Duke (NC), 5, 6, 0, 0.45455, 132, 156, -24, 
1973, Duke (NC), 2, 8, 1, 0.22727, 132, 204, -72, 
1974, Duke (NC), 6, 5, 0, 0.54545, 201, 208, -7, 
1975, Duke (NC), 4, 5, 2, 0.45455, 197, 212, -15, 
1976, Duke (NC), 5, 5, 1, 0.50000, 234, 245, -11, 
1977, Duke (NC), 5, 6, 0, 0.45455, 231, 221, 10, 
1978, Duke (NC), 4, 7, 0, 0.36364, 108, 247, -139, 
1912, Villanova (PA), 3, 3, 0, 0.50000, 62, 170, -108, 
1923, Villanova (PA), 0, 7, 1, 0.06250, 0, 171, -171, 
1946, Southeastern Louisiana, 9, 0, 0, 1.00000, 236, 46, 190, 
1947, Southeastern Louisiana, 3, 5, 1, 0.38889, 124, 159, -35, 
1948, Southeastern Louisiana, 3, 6, 1, 0.35000, 96, 167, -71, 
1949, Southeastern Louisiana, 4, 5, 1, 0.45000, 148, 193, -45, 
1950, Southeastern Louisiana, 6, 4, 0, 0.60000, 113, 96, 17, 
1928, Massachusetts, 2, 5, 1, 0.31250, 25, 90, -65, 
1929, Massachusetts, 3, 4, 1, 0.43750, 56, 82, -26, 
1930, Massachusetts, 1, 8, 0, 0.11111, 32, 248, -216, 
1945, Central Arkansas, 1, 6, 0, 0.14286, 21, 195, -174, 
1946, Central Arkansas, 2, 6, 0, 0.25000, 57, 139, -82, 
1927, West Virginia Tech, 0, 6, 0, 0.00000, 6, 260, -254, 
2000, Adams St. (CO), 3, 7, 0, 0.30000, 132, 315, -183, 
2001, Adams St. (CO), 2, 9, 0, 0.18182, 216, 360, -144, 
2002, Adams St. (CO), 5, 6, 0, 0.45455, 245, 254, -9, 
2003, Adams St. (CO), 4, 7, 0, 0.36364, 310, 312, -2, 
2004, Adams St. (CO), 7, 4, 0, 0.63636, 225, 167, 58, 
2005, Adams St. (CO), 6, 5, 0, 0.54545, 309, 282, 27, 
2006, Adams St. (CO), 6, 5, 0, 0.54545, 271, 209, 62, 
2007, Adams St. (CO), 2, 9, 0, 0.18182, 186, 359, -173, 
1958, Johnson C. Smith (NC), 6, 2, 0, 0.75000, 156, 78, 78, 
1959, Johnson C. Smith (NC), 5, 4, 0, 0.55556, 120, 140, -20, 
1960, Johnson C. Smith (NC), 6, 3, 0, 0.66667, 166, 90, 76, 
1961, Johnson C. Smith (NC), 8, 1, 0, 0.88889, 229, 52, 177, 
1962, Johnson C. Smith (NC), 7, 2, 0, 0.77778, 153, 87, 66, 
1963, Johnson C. Smith (NC), 7, 2, 0, 0.77778, 230, 48, 182, 
1964, Johnson C. Smith (NC), 7, 2, 1, 0.75000, 267, 156, 111, 
1965, Johnson C. Smith (NC), 5, 4, 0, 0.55556, 210, 115, 95, 
1966, Johnson C. Smith (NC), 3, 5, 1, 0.38889, 98, 189, -91, 
1967, Johnson C. Smith (NC), 6, 2, 1, 0.72222, 304, 109, 195, 
1968, Johnson C. Smith (NC), 5, 4, 0, 0.55556, 195, 168, 27, 
1969, Johnson C. Smith (NC), 8, 2, 0, 0.80000, 251, 149, 102, 
1970, Johnson C. Smith (NC), 8, 2, 0, 0.80000, 313, 160, 153, 
1971, Johnson C. Smith (NC), 5, 4, 0, 0.55556, 139, 99, 40, 
1972, Johnson C. Smith (NC), 6, 5, 0, 0.54545, 232, 235, -3, 
1973, Johnson C. Smith (NC), 7, 4, 0, 0.63636, 243, 167, 76, 
1974, Johnson C. Smith (NC), 4, 7, 0, 0.36364, 186, 233, -47, 
1975, Johnson C. Smith (NC), 8, 3, 0, 0.72727, 259, 129, 130, 
1976, Johnson C. Smith (NC), 4, 7, 0, 0.36364, 154, 183, -29, 
1977, Johnson C. Smith (NC), 3, 8, 0, 0.27273, 136, 303, -167, 
1905, Notre Dame (IN), 5, 4, 0, 0.55556, 312, 80, 232, 
1982, Salisbury (MD), 5, 4, 0, 0.55556, 203, 208, -5, 
1983, Salisbury (MD), 10, 1, 1, 0.87500, 258, 129, 129, 
1984, Salisbury (MD), 6, 3, 0, 0.66667, 236, 165, 71, 
1985, Salisbury (MD), 10, 2, 0, 0.83333, 436, 166, 270, 
1986, Salisbury (MD), 13, 1, 0, 0.92857, 441, 210, 231, 
1987, Central Connecticut St., 4, 4, 1, 0.50000, 164, 133, 31, 
1988, Central Connecticut St., 5, 3, 1, 0.61111, 191, 216, -25, 
1989, Central Connecticut St., 5, 5, 0, 0.50000, 197, 187, 10, 
1990, Central Connecticut St., 2, 7, 0, 0.22222, 173, 253, -80, 
1991, Central Connecticut St., 2, 7, 1, 0.25000, 206, 325, -119, 
1916, Gonzaga (WA), 3, 2, 0, 0.60000, 49, 51, -2, 
1919, New Mexico, 3, 0, 2, 0.80000, 136, 15, 121, 
2000, Southern Nazarene (OK), 5, 4, 0, 0.55556, 240, 171, 69, 
2001, Southern Nazarene (OK), 5, 4, 0, 0.55556, 258, 132, 126, 
2002, Southern Nazarene (OK), 7, 3, 0, 0.70000, 192, 147, 45, 
2003, Southern Nazarene (OK), 6, 4, 0, 0.60000, 269, 214, 55, 
2004, Southern Nazarene (OK), 6, 4, 0, 0.60000, 192, 165, 27, 
2005, Southern Nazarene (OK), 6, 4, 0, 0.60000, 249, 203, 46, 
1931, Louisville (KY), 0, 8, 0, 0.00000, 50, 251, -201, 
1974, Delta St. (MS), 8, 3, 0, 0.72727, 209, 144, 65, 
1975, Delta St. (MS), 6, 4, 0, 0.60000, 196, 126, 70, 
1976, Delta St. (MS), 4, 6, 1, 0.40909, 185, 169, 16, 
1977, Delta St. (MS), 4, 6, 0, 0.40000, 159, 150, 9, 
1904, Vanderbilt (TN), 8, 0, 0, 1.00000, 452, 4, 448, 
1905, Vanderbilt (TN), 7, 1, 0, 0.87500, 372, 22, 350, 
1906, Vanderbilt (TN), 8, 1, 0, 0.88889, 278, 16, 262, 
1907, Vanderbilt (TN), 5, 1, 1, 0.78571, 242, 36, 206, 
1908, Vanderbilt (TN), 7, 2, 1, 0.75000, 207, 61, 146, 
1909, Vanderbilt (TN), 7, 3, 0, 0.70000, 210, 32, 178, 
1910, Vanderbilt (TN), 8, 0, 1, 0.94444, 166, 8, 158, 
1911, Vanderbilt (TN), 8, 1, 0, 0.88889, 259, 9, 250, 
1912, Vanderbilt (TN), 8, 1, 1, 0.85000, 391, 19, 372, 
1913, Vanderbilt (TN), 5, 3, 0, 0.62500, 218, 100, 118, 
1914, Vanderbilt (TN), 3, 6, 0, 0.33333, 166, 95, 71, 
1915, Vanderbilt (TN), 9, 1, 0, 0.90000, 513, 38, 475, 
1916, Vanderbilt (TN), 7, 1, 1, 0.83333, 328, 25, 303, 
1917, Vanderbilt (TN), 5, 3, 0, 0.62500, 142, 170, -28, 
1919, Vanderbilt (TN), 5, 1, 2, 0.75000, 110, 68, 42, 
1920, Vanderbilt (TN), 5, 3, 1, 0.61111, 169, 124, 45, 
1921, Vanderbilt (TN), 7, 0, 1, 0.93750, 161, 21, 140, 
1922, Vanderbilt (TN), 8, 0, 1, 0.94444, 177, 16, 161, 
1923, Vanderbilt (TN), 5, 2, 1, 0.68750, 137, 33, 104, 
1924, Vanderbilt (TN), 6, 3, 1, 0.65000, 150, 53, 97, 
1925, Vanderbilt (TN), 6, 3, 0, 0.66667, 158, 63, 95, 
1926, Vanderbilt (TN), 8, 1, 0, 0.88889, 241, 42, 199, 
1927, Vanderbilt (TN), 8, 1, 2, 0.81818, 295, 93, 202, 
1928, Vanderbilt (TN), 8, 2, 0, 0.80000, 152, 57, 95, 
1929, Vanderbilt (TN), 7, 2, 0, 0.77778, 187, 56, 131, 
1930, Vanderbilt (TN), 8, 2, 0, 0.80000, 225, 45, 180, 
1931, Vanderbilt (TN), 5, 4, 0, 0.55556, 192, 109, 83, 
1932, Vanderbilt (TN), 6, 1, 2, 0.77778, 128, 46, 82, 
1933, Vanderbilt (TN), 4, 3, 3, 0.55000, 126, 107, 19, 
1934, Vanderbilt (TN), 6, 3, 0, 0.66667, 105, 100, 5, 
1981, Morningside (IA), 5, 6, 0, 0.45455, 145, 219, -74, 
1982, Morningside (IA), 2, 9, 0, 0.18182, 134, 246, -112, 
1998, Indiana St., 5, 6, 0, 0.45455, 261, 275, -14, 
1999, Indiana St., 3, 8, 0, 0.27273, 284, 373, -89, 
2000, Indiana St., 1, 10, 0, 0.09091, 122, 408, -286, 
2001, Indiana St., 3, 8, 0, 0.27273, 168, 347, -179, 
2002, Indiana St., 5, 7, 0, 0.41667, 226, 318, -92, 
2003, Indiana St., 3, 9, 0, 0.25000, 170, 356, -186, 
2004, Indiana St., 4, 7, 0, 0.36364, 243, 415, -172, 
1973, New Haven (CT), 0, 8, 0, 0.00000, 28, 221, -193, 
1974, New Haven (CT), 0, 9, 0, 0.00000, 38, 216, -178, 
1975, New Haven (CT), 2, 7, 0, 0.22222, 67, 222, -155, 
2006, Central Connecticut St., 8, 3, 0, 0.72727, 363, 192, 171, 
2007, Central Connecticut St., 6, 5, 0, 0.54545, 311, 309, 2, 
2008, Central Connecticut St., 7, 4, 0, 0.63636, 330, 246, 84, 
2009, Central Connecticut St., 9, 3, 0, 0.75000, 300, 268, 32, 
2010, Central Connecticut St., 8, 3, 0, 0.72727, 332, 327, 5, 
2011, Central Connecticut St., 4, 7, 0, 0.36364, 276, 325, -49, 
2012, Central Connecticut St., 2, 8, 0, 0.20000, 235, 381, -146, 
2013, Central Connecticut St., 4, 8, 0, 0.33333, 337, 425, -88, 
1899, DePauw (IN), 1, 3, 0, 0.25000, 23, 96, -73, 
1900, DePauw (IN), 6, 5, 2, 0.53846, 112, 129, -17, 
1916, West Virginia, 5, 2, 2, 0.66667, 198, 38, 160, 
1917, West Virginia, 6, 3, 1, 0.65000, 161, 50, 111, 
1919, West Virginia, 8, 2, 0, 0.80000, 326, 47, 279, 
1920, West Virginia, 5, 4, 1, 0.55000, 169, 113, 56, 
1904, Colorado St., 0, 4, 1, 0.10000, 6, 125, -119, 
1905, Colorado St., 3, 4, 0, 0.42857, 67, 95, -28, 
1908, Montana St., 2, 1, 2, 0.60000, 40, 25, 15, 
1909, Montana St., 0, 6, 1, 0.07143, 11, 85, -74, 
1910, Montana St., 1, 3, 2, 0.33333, 2, 43, -41, 
1933, Northern Arizona, 5, 2, 0, 0.71429, 59, 44, 15, 
1934, Northern Arizona, 1, 5, 1, 0.21429, 44, 99, -55, 
1935, Northern Arizona, 3, 3, 3, 0.50000, 99, 57, 42, 
1936, Northern Arizona, 4, 4, 1, 0.50000, 65, 117, -52, 
1897, Miami (OH), 2, 4, 1, 0.35714, 32, 56, -24, 
1912, West Virginia Wesleyan, 8, 0, 0, 1.00000, 380, 14, 366, 
1913, West Virginia Wesleyan, 5, 3, 0, 0.62500, 191, 75, 116, 
1914, Arizona, 5, 1, 0, 0.83333, 85, 20, 65, 
1915, Arizona, 6, 3, 0, 0.66667, 152, 34, 118, 
1916, Arizona, 5, 3, 0, 0.62500, 247, 93, 154, 
1917, Arizona, 3, 2, 0, 0.60000, 118, 41, 77, 
1919, Arizona, 7, 1, 0, 0.87500, 253, 19, 234, 
1920, Arizona, 6, 1, 0, 0.85714, 381, 65, 316, 
1921, Arizona, 7, 2, 0, 0.77778, 418, 68, 350, 
1922, Arizona, 6, 3, 0, 0.66667, 109, 53, 56, 
1923, Arizona, 5, 3, 0, 0.62500, 146, 127, 19, 
1924, Arizona, 2, 4, 0, 0.33333, 40, 93, -53, 
1925, Arizona, 3, 3, 1, 0.50000, 70, 88, -18, 
1926, Arizona, 5, 1, 1, 0.78571, 143, 18, 125, 
1927, Arizona, 4, 2, 1, 0.64286, 165, 59, 106, 
1928, Arizona, 5, 1, 2, 0.75000, 152, 110, 42, 
1929, Arizona, 7, 1, 0, 0.87500, 182, 22, 160, 
1930, Arizona, 6, 1, 1, 0.81250, 122, 33, 89, 
1907, South Carolina, 3, 0, 0, 1.00000, 30, 4, 26, 
1907, Butler (IN), 1, 3, 2, 0.33333, 16, 72, -56, 
1908, Butler (IN), 6, 0, 1, 0.92857, 118, 11, 107, 
1910, Butler (IN), 4, 3, 1, 0.56250, 66, 101, -35, 
1960, Southern California, 4, 6, 0, 0.40000, 95, 152, -57, 
1961, Southern California, 4, 5, 1, 0.45000, 150, 167, -17, 
1962, Southern California, 11, 0, 0, 1.00000, 261, 92, 169, 
1963, Southern California, 7, 3, 0, 0.70000, 207, 114, 93, 
1964, Southern California, 7, 3, 0, 0.70000, 207, 130, 77, 
1965, Southern California, 7, 2, 1, 0.75000, 262, 92, 170, 
1966, Southern California, 7, 4, 0, 0.63636, 199, 128, 71, 
1967, Southern California, 10, 1, 0, 0.90909, 258, 87, 171, 
1968, Southern California, 9, 1, 1, 0.86364, 259, 168, 91, 
1969, Southern California, 10, 0, 1, 0.95455, 261, 128, 133, 
1970, Southern California, 6, 4, 1, 0.59091, 343, 233, 110, 
1971, Southern California, 6, 4, 1, 0.59091, 229, 164, 65, 
1972, Southern California, 12, 0, 0, 1.00000, 467, 134, 333, 
1973, Southern California, 9, 2, 1, 0.79167, 322, 202, 120, 
1974, Southern California, 10, 1, 1, 0.87500, 363, 142, 221, 
1975, Southern California, 8, 4, 0, 0.66667, 247, 140, 107, 
1898, San Jose St. (CA), 5, 0, 1, 0.91667, 80, 17, 63, 
1992, Amherst (MA), 0, 8, 0, 0.00000, 68, 288, -220, 
1933, Mississippi St., 3, 6, 1, 0.35000, 69, 149, -80, 
1934, Mississippi St., 4, 6, 0, 0.40000, 79, 126, -47, 
1900, North Carolina St., 0, 5, 0, 0.00000, 7, 69, -62, 
1901, North Carolina St., 1, 2, 0, 0.33333, 27, 75, -48, 
1902, Georgia Tech, 0, 6, 2, 0.12500, 23, 122, -99, 
1895, Carthage (WI), 2, 0, 0, 1.00000, 28, 0, 28, 
1896, Carthage (WI), 4, 0, 0, 1.00000, 72, 18, 54, 
1897, Carthage (WI), 4, 0, 0, 1.00000, 18, 0, 18, 
1898, Carthage (WI), 3, 0, 0, 1.00000, 34, 16, 18, 
1899, Carthage (WI), 3, 2, 1, 0.58333, 44, 29, 15, 
1900, Carthage (WI), 4, 3, 0, 0.57143, 50, 78, -28, 
1937, Memphis (TN), 3, 6, 0, 0.33333, 117, 99, 18, 
1938, Memphis (TN), 10, 0, 0, 1.00000, 281, 41, 240, 
1939, Mississippi St., 8, 2, 0, 0.80000, 216, 32, 184, 
1940, Mississippi St., 10, 0, 1, 0.95455, 245, 58, 187, 
1941, Mississippi St., 8, 1, 1, 0.85000, 191, 55, 136, 
1942, Mississippi St., 8, 2, 0, 0.80000, 200, 77, 123, 
1944, Mississippi St., 6, 2, 0, 0.75000, 219, 79, 140, 
1945, Mississippi St., 6, 3, 0, 0.66667, 221, 108, 113, 
1946, Mississippi St., 8, 2, 0, 0.80000, 271, 71, 200, 
1947, Mississippi St., 7, 3, 0, 0.70000, 169, 89, 80, 
1948, Mississippi St., 4, 4, 1, 0.50000, 103, 87, 16, 
1944, Notre Dame (IN), 8, 2, 0, 0.80000, 272, 118, 154, 
1945, Cornell (NY), 5, 4, 0, 0.55556, 169, 166, 3, 
1946, Cornell (NY), 5, 3, 1, 0.61111, 135, 115, 20, 
1947, San Francisco (CA), 7, 3, 0, 0.70000, 275, 143, 132, 
1945, Boston (MA), 0, 5, 0, 0.00000, 3, 235, -232, 
1953, Virginia Military Institute, 5, 5, 0, 0.50000, 174, 196, -22, 
1954, Virginia Military Institute, 4, 6, 0, 0.40000, 132, 223, -91, 
1955, Virginia Military Institute, 1, 9, 0, 0.10000, 85, 259, -174, 
1956, Virginia Military Institute, 3, 6, 1, 0.35000, 167, 220, -53, 
1957, Virginia Military Institute, 9, 0, 1, 0.95000, 201, 101, 100, 
1958, Virginia Military Institute, 6, 2, 2, 0.70000, 214, 99, 115, 
1959, Virginia Military Institute, 8, 1, 1, 0.85000, 243, 93, 150, 
1960, Virginia Military Institute, 7, 2, 1, 0.75000, 218, 135, 83, 
1961, Virginia Military Institute, 6, 4, 0, 0.60000, 134, 105, 29, 
1962, Virginia Military Institute, 6, 4, 0, 0.60000, 119, 119, 0, 
1963, Virginia Military Institute, 3, 5, 2, 0.40000, 140, 134, 6, 
1964, Virginia Military Institute, 1, 9, 0, 0.10000, 123, 200, -77, 
1965, Virginia Military Institute, 3, 7, 0, 0.30000, 121, 200, -79, 
2013, Maine Maritime, 1, 8, 0, 0.11111, 240, 463, -223, 
1928, Boston College (MA), 9, 0, 0, 1.00000, 263, 39, 224, 
1929, Boston College (MA), 7, 2, 1, 0.75000, 202, 65, 137, 
1930, Boston College (MA), 5, 5, 0, 0.50000, 167, 70, 97, 
1931, Boston College (MA), 6, 4, 0, 0.60000, 115, 74, 41, 
1932, Boston College (MA), 4, 2, 2, 0.62500, 73, 59, 14, 
1933, Boston College (MA), 8, 1, 0, 0.88889, 169, 50, 119, 
1934, Boston College (MA), 5, 4, 0, 0.55556, 64, 72, -8, 
1997, Delaware St., 3, 8, 0, 0.27273, 235, 312, -77, 
1998, Delaware St., 0, 11, 0, 0.00000, 189, 482, -293, 
1999, Delaware St., 4, 7, 0, 0.36364, 261, 354, -93, 
1963, Adams St. (CO), 6, 4, 0, 0.60000, 199, 111, 88, 
1964, Adams St. (CO), 7, 2, 0, 0.77778, 165, 122, 43, 
1965, Adams St. (CO), 5, 4, 0, 0.55556, 185, 161, 24, 
1966, Adams St. (CO), 8, 2, 0, 0.80000, 232, 103, 129, 
1967, Adams St. (CO), 8, 1, 0, 0.88889, 305, 115, 190, 
1969, Adams St. (CO), 7, 3, 0, 0.70000, 216, 179, 37, 
1966, Idaho St., 3, 6, 0, 0.33333, 105, 201, -96, 
1967, Idaho St., 1, 9, 0, 0.10000, 66, 251, -185, 
1970, Saint Mary's (CA), 5, 4, 0, 0.55556, 125, 143, -18, 
1971, Saint Mary's (CA), 4, 5, 0, 0.44444, 164, 195, -31, 
1972, Saint Mary's (CA), 4, 4, 0, 0.50000, 243, 195, 48, 
1973, Saint Mary's (CA), 4, 4, 1, 0.50000, 206, 174, 32, 
1974, Central St. (OH), 6, 5, 0, 0.54545, 317, 209, 108, 
1975, Central St. (OH), 4, 6, 0, 0.40000, 201, 186, 15, 
1976, Central St. (OH), 6, 5, 0, 0.54545, 225, 233, -8, 
1977, North Carolina A&T;, 7, 4, 0, 0.63636, 272, 183, 89, 
1978, North Carolina A&T;, 6, 6, 0, 0.50000, 194, 195, -1, 
1979, North Carolina A&T;, 4, 6, 1, 0.40909, 175, 202, -27, 
1980, North Carolina A&T;, 9, 3, 0, 0.75000, 342, 212, 130, 
1981, North Carolina A&T;, 3, 8, 0, 0.27273, 154, 247, -93, 
1982, Prairie View A&M; (TX), 1, 10, 0, 0.09091, 80, 315, -235, 
1932, Delaware St., 2, 5, 0, 0.28571, 73, 85, -12, 
1909, Troy (AL), 1, 0, 2, 0.66667, 6, 0, 6, 
1921, Eureka (IL), 5, 1, 0, 0.83333, 116, 26, 90, 
1922, Eureka (IL), 5, 3, 0, 0.62500, 102, 76, 26, 
1923, Eureka (IL), 4, 4, 0, 0.50000, 91, 73, 18, 
1924, Eureka (IL), 3, 4, 1, 0.43750, 41, 60, -19, 
1925, Eureka (IL), 5, 4, 0, 0.55556, 73, 118, -45, 
1926, Eureka (IL), 0, 6, 1, 0.07143, 22, 106, -84, 
1927, Eureka (IL), 0, 9, 0, 0.00000, 2, 258, -256, 
1928, Eureka (IL), 3, 4, 1, 0.43750, 47, 98, -51, 
1929, Eureka (IL), 3, 3, 2, 0.50000, 65, 108, -43, 
1930, Eureka (IL), 2, 6, 0, 0.25000, 52, 128, -76, 
1931, Eureka (IL), 3, 4, 1, 0.43750, 74, 67, 7, 
1932, Eureka (IL), 1, 4, 1, 0.25000, 27, 80, -53, 
1933, Eureka (IL), 0, 7, 0, 0.00000, 8, 192, -184, 
1934, Eureka (IL), 0, 3, 2, 0.20000, 0, 98, -98, 
1935, Eureka (IL), 0, 6, 0, 0.00000, 13, 73, -60, 
1936, Eureka (IL), 2, 5, 1, 0.31250, 67, 119, -52, 
1937, Eureka (IL), 0, 6, 0, 0.00000, 0, 258, -258, 
1900, Monmouth (IL), 6, 6, 1, 0.50000, 242, 120, 122, 
1922, Texas Christian, 2, 5, 3, 0.35000, 91, 167, -76, 
1947, Indiana (PA), 1, 1, 1, 0.50000, 51, 44, 7, 
1948, Indiana (PA), 1, 8, 0, 0.11111, 83, 199, -116, 
1916, South Dakota, 1, 5, 2, 0.25000, 76, 155, -79, 
1917, South Dakota, 2, 3, 0, 0.40000, 33, 93, -60, 
1929, Samford (AL), 5, 4, 2, 0.54545, 160, 59, 101, 
1930, Samford (AL), 5, 5, 0, 0.50000, 147, 103, 44, 
1931, Samford (AL), 8, 2, 2, 0.75000, 206, 88, 118, 
1932, Samford (AL), 3, 7, 0, 0.30000, 61, 174, -113, 
1933, Samford (AL), 7, 1, 2, 0.80000, 201, 46, 155, 
1934, Louisiana Tech, 4, 6, 0, 0.40000, 89, 116, -27, 
1935, Louisiana Tech, 8, 1, 0, 0.88889, 255, 42, 213, 
1936, Louisiana Tech, 6, 2, 1, 0.72222, 153, 47, 106, 
1937, Louisiana Tech, 6, 3, 2, 0.63636, 120, 60, 60, 
1938, Louisiana Tech, 3, 7, 1, 0.31818, 98, 163, -65, 
1919, Emporia St. (KS), 1, 6, 2, 0.22222, 60, 101, -41, 
1920, Arkansas, 3, 2, 2, 0.57143, 42, 22, 20, 
1921, Arkansas, 5, 3, 1, 0.61111, 144, 48, 96, 
1922, Cincinnati (OH), 1, 7, 1, 0.16667, 35, 175, -140, 
1923, Cincinnati (OH), 6, 3, 0, 0.66667, 157, 71, 86, 
1924, Cincinnati (OH), 2, 6, 1, 0.27778, 54, 164, -110, 
1925, Cincinnati (OH), 4, 5, 0, 0.44444, 65, 122, -57, 
1926, Cincinnati (OH), 3, 5, 1, 0.38889, 96, 152, -56, 
1927, Wyoming, 4, 5, 0, 0.44444, 122, 105, 17, 
1928, Wyoming, 2, 7, 0, 0.22222, 106, 224, -118, 
1929, Wyoming, 1, 7, 0, 0.12500, 33, 160, -127, 
1897, Ohio, 1, 0, 0, 1.00000, 36, 6, 30, 
1898, Ohio, 1, 3, 0, 0.25000, 11, 45, -34, 
2013, Wayne St. (NE), 2, 9, 0, 0.18182, 241, 391, -150, 
1915, Saint Bonaventure (NY), 0, 4, 1, 0.10000, 6, 97, -91, 
1916, Saint Bonaventure (NY), 6, 1, 1, 0.81250, 123, 68, 55, 
1917, Saint Bonaventure (NY), 1, 4, 0, 0.20000, 26, 190, -164, 
1919, Saint Bonaventure (NY), 1, 4, 1, 0.25000, 25, 131, -106, 
1920, Saint Bonaventure (NY), 3, 5, 0, 0.37500, 56, 265, -209, 
1921, Saint Bonaventure (NY), 2, 5, 3, 0.35000, 25, 172, -147, 
1922, Amherst (MA), 2, 6, 0, 0.25000, 79, 136, -57, 
1923, Amherst (MA), 3, 3, 2, 0.50000, 74, 75, -1, 
1924, Amherst (MA), 3, 5, 0, 0.37500, 144, 136, 8, 
1925, Amherst (MA), 7, 1, 0, 0.87500, 198, 39, 159, 
1926, Brown (RI), 9, 0, 1, 0.95000, 223, 36, 187, 
1927, Brown (RI), 3, 6, 1, 0.35000, 109, 103, 6, 
1928, Brown (RI), 8, 1, 0, 0.88889, 167, 72, 95, 
1929, Brown (RI), 5, 5, 0, 0.50000, 140, 124, 16, 
1930, Brown (RI), 6, 3, 1, 0.65000, 135, 78, 57, 
1931, Brown (RI), 7, 3, 0, 0.70000, 189, 100, 89, 
1932, Brown (RI), 7, 1, 0, 0.87500, 81, 42, 39, 
1933, Brown (RI), 3, 5, 0, 0.37500, 68, 116, -48, 
1934, Brown (RI), 3, 6, 0, 0.33333, 64, 169, -105, 
1935, Brown (RI), 1, 8, 0, 0.11111, 21, 197, -176, 
1936, Brown (RI), 3, 7, 0, 0.30000, 76, 234, -158, 
1937, Brown (RI), 5, 4, 0, 0.55556, 73, 119, -46, 
1938, Brown (RI), 5, 3, 0, 0.62500, 203, 129, 74, 
1939, Brown (RI), 5, 3, 1, 0.61111, 188, 91, 97, 
1940, Brown (RI), 6, 3, 1, 0.65000, 124, 94, 30, 
1941, Dartmouth (NH), 5, 4, 0, 0.55556, 146, 104, 42, 
1942, Dartmouth (NH), 5, 4, 0, 0.55556, 193, 135, 58, 
1945, Dartmouth (NH), 1, 6, 1, 0.18750, 40, 119, -79, 
1946, Dartmouth (NH), 3, 6, 0, 0.33333, 91, 194, -103, 
1947, Dartmouth (NH), 4, 4, 1, 0.50000, 102, 127, -25, 
1948, Dartmouth (NH), 6, 2, 0, 0.75000, 213, 130, 83, 
1949, Dartmouth (NH), 6, 2, 0, 0.75000, 183, 107, 76, 
1950, Dartmouth (NH), 3, 5, 1, 0.38889, 123, 157, -34, 
1951, Dartmouth (NH), 4, 5, 0, 0.44444, 121, 152, -31, 
1952, Dartmouth (NH), 2, 7, 0, 0.22222, 116, 198, -82, 
1953, Dartmouth (NH), 2, 7, 0, 0.22222, 152, 219, -67, 
1954, Dartmouth (NH), 3, 6, 0, 0.33333, 121, 250, -129, 
1950, Amherst (MA), 4, 3, 1, 0.56250, 146, 151, -5, 
1951, Amherst (MA), 2, 5, 1, 0.31250, 157, 221, -64, 
1952, Amherst (MA), 4, 3, 1, 0.56250, 124, 113, 11, 
1953, Amherst (MA), 7, 0, 1, 0.93750, 158, 67, 91, 
1954, Amherst (MA), 6, 2, 0, 0.75000, 193, 100, 93, 
1955, Amherst (MA), 3, 4, 0, 0.42857, 112, 142, -30, 
1956, Amherst (MA), 5, 3, 0, 0.62500, 184, 139, 45, 
1957, Amherst (MA), 7, 1, 0, 0.87500, 278, 79, 199, 
1958, Amherst (MA), 6, 2, 0, 0.75000, 209, 72, 137, 
1959, Brown (RI), 2, 6, 1, 0.27778, 51, 139, -88, 
1960, Brown (RI), 3, 6, 0, 0.33333, 100, 212, -112, 
1961, Brown (RI), 0, 9, 0, 0.00000, 24, 245, -221, 
1962, Brown (RI), 1, 6, 2, 0.22222, 116, 188, -72, 
1963, Brown (RI), 3, 5, 0, 0.37500, 157, 168, -11, 
1964, Brown (RI), 5, 4, 0, 0.55556, 119, 117, 2, 
1965, Brown (RI), 2, 7, 0, 0.22222, 128, 169, -41, 
1966, Brown (RI), 1, 8, 0, 0.11111, 127, 266, -139, 
1903, Missouri, 1, 7, 1, 0.16667, 46, 83, -37, 
1904, Missouri, 3, 6, 0, 0.33333, 50, 130, -80, 
1905, Missouri, 5, 4, 0, 0.55556, 94, 79, 15, 
1909, Connecticut, 3, 5, 0, 0.37500, 104, 190, -86, 
1923, Southern Arkansas, 1, 7, 0, 0.12500, 60, 211, -151, 
1924, Southern Arkansas, 0, 6, 0, 0.00000, 0, 177, -177, 
1925, Southern Arkansas, 5, 2, 1, 0.68750, 161, 50, 111, 
1926, Southern Arkansas, 6, 1, 2, 0.77778, 138, 46, 92, 
1927, Southern Arkansas, 7, 2, 1, 0.75000, 111, 33, 78, 
1928, Southern Arkansas, 4, 4, 0, 0.50000, 116, 76, 40, 
1929, Southern Arkansas, 7, 0, 2, 0.88889, 174, 18, 156, 
1930, Southern Arkansas, 6, 3, 1, 0.65000, 193, 45, 148, 
1931, Southern Arkansas, 3, 5, 1, 0.38889, 79, 76, 3, 
1932, Southern Arkansas, 3, 4, 1, 0.43750, 32, 22, 10, 
1933, Southern Arkansas, 3, 3, 2, 0.50000, 44, 71, -27, 
1934, Southern Arkansas, 3, 4, 1, 0.43750, 39, 70, -31, 
1935, Southern Arkansas, 2, 5, 0, 0.28571, 28, 104, -76, 
1936, Southern Arkansas, 1, 8, 0, 0.11111, 70, 210, -140, 
1986, Tennessee-Martin, 3, 8, 0, 0.27273, 270, 346, -76, 
1987, Tennessee-Martin, 5, 6, 0, 0.45455, 202, 221, -19, 
1988, Tennessee-Martin, 11, 2, 0, 0.84615, 357, 197, 160, 
1989, Tennessee-Martin, 2, 9, 0, 0.18182, 123, 308, -185, 
1990, Tennessee-Martin, 4, 7, 0, 0.36364, 245, 315, -70, 
1991, Tennessee-Martin, 5, 6, 0, 0.45455, 280, 330, -50, 
1992, Tennessee-Martin, 3, 8, 0, 0.27273, 178, 251, -73, 
1993, Tennessee-Martin, 6, 5, 0, 0.54545, 169, 201, -32, 
1994, Tennessee-Martin, 5, 6, 0, 0.45455, 201, 220, -19, 
1995, Tennessee-Martin, 5, 6, 0, 0.45455, 335, 302, 33, 
1996, Tennessee-Martin, 1, 10, 0, 0.09091, 125, 357, -232, 
1908, Pittsburg St. (KS), 2, 2, 2, 0.50000, 14, 25, -11, 
1932, Furman (SC), 8, 1, 0, 0.88889, 169, 19, 150, 
1933, Furman (SC), 6, 1, 2, 0.77778, 118, 30, 88, 
1934, Furman (SC), 5, 4, 0, 0.55556, 40, 46, -6, 
1935, Furman (SC), 8, 1, 0, 0.88889, 232, 44, 188, 
1936, Furman (SC), 7, 2, 0, 0.77778, 127, 75, 52, 
1937, Furman (SC), 4, 3, 2, 0.55556, 164, 48, 116, 
1938, Furman (SC), 2, 7, 1, 0.25000, 82, 158, -76, 
1939, Furman (SC), 5, 4, 0, 0.55556, 124, 69, 55, 
1940, Furman (SC), 5, 4, 0, 0.55556, 195, 112, 83, 
1941, Furman (SC), 3, 4, 2, 0.44444, 129, 195, -66, 
1942, Furman (SC), 3, 6, 0, 0.33333, 78, 157, -79, 
1902, Kentucky, 3, 5, 1, 0.38889, 72, 83, -11, 
1927, Dickinson St. (ND), 1, 0, 1, 0.75000, 6, 2, 4, 
2008, Hawaii, 7, 7, 0, 0.50000, 345, 404, -59, 
2009, Hawaii, 6, 7, 0, 0.46154, 296, 383, -87, 
2010, Hawaii, 10, 4, 0, 0.71429, 554, 357, 197, 
2011, Hawaii, 6, 7, 0, 0.46154, 409, 378, 31, 
1902, Oklahoma, 6, 3, 0, 0.66667, 175, 60, 115, 
1903, Oklahoma, 5, 4, 3, 0.54167, 126, 85, 41, 
2013, Central (IA), 6, 4, 0, 0.60000, 248, 131, 117, 
1899, Wisconsin-Oshkosh, 1, 6, 1, 0.18750, 35, 123, -88, 
1911, Cedarville (OH), 0, 2, 0, 0.00000, 0, 91, -91, 
1945, South Carolina, 2, 4, 3, 0.38889, 113, 192, -79, 
1953, Citadel (SC), 2, 7, 0, 0.22222, 77, 264, -187, 
1954, Citadel (SC), 2, 8, 0, 0.20000, 94, 256, -162, 
1941, Presbyterian (SC), 6, 3, 0, 0.66667, 175, 114, 61, 
1942, Presbyterian (SC), 6, 4, 0, 0.60000, 206, 172, 34, 
1943, Presbyterian (SC), 6, 6, 0, 0.50000, 212, 238, -26, 
1944, Presbyterian (SC), 3, 6, 0, 0.33333, 79, 242, -163, 
1945, Presbyterian (SC), 1, 6, 0, 0.14286, 47, 288, -241, 
1946, Presbyterian (SC), 7, 2, 0, 0.77778, 154, 99, 55, 
1947, Presbyterian (SC), 4, 5, 1, 0.45000, 63, 88, -25, 
1948, Presbyterian (SC), 5, 4, 0, 0.55556, 111, 145, -34, 
1949, Presbyterian (SC), 5, 4, 0, 0.55556, 153, 188, -35, 
1950, Presbyterian (SC), 5, 5, 0, 0.50000, 125, 192, -67, 
1951, Presbyterian (SC), 5, 4, 0, 0.55556, 126, 185, -59, 
1952, Presbyterian (SC), 3, 6, 0, 0.33333, 151, 205, -54, 
1953, Presbyterian (SC), 5, 3, 1, 0.61111, 113, 136, -23, 
1907, Wisconsin-Oshkosh, 5, 2, 0, 0.71429, 154, 82, 72, 
1908, Wisconsin-Oshkosh, 1, 6, 0, 0.14286, 33, 137, -104, 
1909, Wisconsin-Oshkosh, 4, 3, 0, 0.57143, 150, 89, 61, 
1911, Monmouth (IL), 4, 5, 0, 0.44444, 64, 112, -48, 
1912, Monmouth (IL), 2, 6, 0, 0.25000, 66, 123, -57, 
1922, Centenary (LA), 8, 1, 0, 0.88889, 295, 41, 254, 
1923, Centenary (LA), 10, 2, 0, 0.83333, 371, 40, 331, 
1924, Centenary (LA), 8, 1, 0, 0.88889, 177, 59, 118, 
1928, Kansas St., 3, 5, 0, 0.37500, 94, 94, 0, 
1929, Kansas St., 3, 5, 0, 0.37500, 55, 102, -47, 
1930, Kansas St., 5, 3, 0, 0.62500, 91, 66, 25, 
1931, Kansas St., 8, 2, 0, 0.80000, 162, 39, 123, 
1932, Kansas St., 4, 4, 0, 0.50000, 160, 80, 80, 
1933, Kansas St., 6, 2, 1, 0.72222, 105, 29, 76, 
1934, Indiana, 3, 3, 2, 0.50000, 67, 110, -43, 
1935, Indiana, 4, 3, 1, 0.56250, 70, 55, 15, 
1936, Indiana, 5, 2, 1, 0.68750, 123, 63, 60, 
1937, Indiana, 5, 3, 0, 0.62500, 72, 32, 40, 
1938, Indiana, 1, 6, 1, 0.18750, 21, 67, -46, 
1939, Indiana, 2, 4, 2, 0.37500, 70, 96, -26, 
1940, Indiana, 3, 5, 0, 0.37500, 69, 100, -31, 
1941, Indiana, 2, 6, 0, 0.25000, 101, 126, -25, 
1942, Indiana, 7, 3, 0, 0.70000, 256, 79, 177, 
1943, Indiana, 4, 4, 2, 0.50000, 193, 106, 87, 
1944, Indiana, 7, 3, 0, 0.70000, 292, 79, 213, 
1945, Indiana, 9, 0, 1, 0.95000, 279, 56, 223, 
1946, Indiana, 6, 3, 0, 0.66667, 129, 95, 34, 
1947, Indiana, 5, 3, 1, 0.61111, 156, 102, 54, 
1972, James Madison (VA), 0, 4, 1, 0.10000, 0, 140, -140, 
1973, James Madison (VA), 4, 5, 0, 0.44444, 189, 176, 13, 
1974, James Madison (VA), 6, 4, 0, 0.60000, 264, 204, 60, 
1975, James Madison (VA), 9, 0, 1, 0.95000, 125, 75, 50, 
1976, James Madison (VA), 7, 4, 0, 0.63636, 249, 198, 51, 
1977, James Madison (VA), 5, 5, 0, 0.50000, 146, 172, -26, 
1978, James Madison (VA), 8, 2, 0, 0.80000, 236, 124, 112, 
1979, James Madison (VA), 4, 6, 0, 0.40000, 135, 206, -71, 
1980, James Madison (VA), 4, 6, 0, 0.40000, 142, 207, -65, 
1981, James Madison (VA), 3, 8, 0, 0.27273, 198, 265, -67, 
1982, James Madison (VA), 8, 3, 0, 0.72727, 283, 229, 54, 
1983, James Madison (VA), 3, 8, 0, 0.27273, 230, 266, -36, 
1984, James Madison (VA), 6, 5, 0, 0.54545, 220, 241, -21, 
1950, Stetson (FL), 8, 2, 0, 0.80000, 300, 133, 167, 
1951, Stetson (FL), 8, 1, 2, 0.81818, 340, 122, 218, 
1954, Akron (OH), 3, 5, 0, 0.37500, 169, 233, -64, 
1955, Akron (OH), 6, 2, 0, 0.75000, 245, 73, 172, 
1956, Akron (OH), 3, 5, 1, 0.38889, 216, 171, 45, 
1957, Akron (OH), 7, 1, 1, 0.83333, 208, 87, 121, 
1958, Akron (OH), 6, 2, 1, 0.72222, 166, 82, 84, 
1959, Akron (OH), 4, 5, 0, 0.44444, 111, 155, -44, 
1960, Akron (OH), 1, 8, 0, 0.11111, 70, 269, -199, 
1969, San Jose St. (CA), 2, 8, 0, 0.20000, 152, 346, -194, 
1970, San Jose St. (CA), 1, 2, 0, 0.33333, 60, 78, -18, 
1932, East Tennessee St., 3, 3, 1, 0.50000, 74, 56, 18, 
1933, East Tennessee St., 6, 1, 2, 0.77778, 131, 45, 86, 
1934, East Tennessee St., 4, 3, 1, 0.56250, 56, 47, 9, 
1935, East Tennessee St., 5, 3, 0, 0.62500, 80, 68, 12, 
1936, East Tennessee St., 5, 3, 0, 0.62500, 82, 32, 50, 
1937, East Tennessee St., 4, 5, 0, 0.44444, 63, 101, -38, 
1938, East Tennessee St., 6, 2, 0, 0.75000, 112, 75, 37, 
1939, East Tennessee St., 5, 3, 0, 0.62500, 61, 83, -22, 
1940, East Tennessee St., 4, 4, 0, 0.50000, 65, 61, 4, 
1941, East Tennessee St., 2, 5, 0, 0.28571, 21, 85, -64, 
1946, East Tennessee St., 7, 1, 0, 0.87500, 125, 56, 69, 
1900, Wyoming, 3, 3, 0, 0.50000, 105, 59, 46, 
1901, Wyoming, 1, 0, 0, 1.00000, 38, 0, 38, 
1902, Wyoming, 1, 0, 0, 1.00000, 18, 0, 18, 
1903, Wyoming, 3, 2, 0, 0.60000, 32, 63, -31, 
1904, Wyoming, 4, 1, 1, 0.75000, 97, 35, 62, 
1905, Wyoming, 3, 4, 0, 0.42857, 63, 162, -99, 
1906, Wyoming, 1, 1, 0, 0.50000, 12, 35, -23, 
1890, Fordham (NY), 1, 3, 1, 0.30000, 30, 96, -66, 
1950, Saint John's (MN), 4, 3, 0, 0.57143, 131, 91, 40, 
1951, Saint John's (MN), 4, 3, 0, 0.57143, 133, 100, 33, 
1952, Saint John's (MN), 5, 3, 0, 0.62500, 117, 93, 24, 
1935, Boston College (MA), 3, 1, 0, 0.75000, 50, 33, 17, 
1908, Louisiana-Lafayette, 6, 0, 0, 1.00000, 93, 16, 77, 
1909, Louisiana-Lafayette, 5, 2, 1, 0.68750, 200, 59, 141, 
1910, Louisiana-Lafayette, 6, 2, 1, 0.72222, 110, 123, -13, 
1911, Louisiana-Lafayette, 1, 4, 1, 0.25000, 35, 95, -60, 
1913, Louisiana-Lafayette, 4, 4, 0, 0.50000, 148, 155, -7, 
1917, Louisiana-Lafayette, 8, 2, 0, 0.80000, 336, 46, 290, 
1918, Louisiana-Lafayette, 4, 1, 0, 0.80000, 166, 100, 66, 
1927, Southern Oregon, 3, 0, 0, 1.00000, 73, 12, 61, 
1928, Southern Oregon, 1, 3, 2, 0.33333, 38, 75, -37, 
1929, Southern Oregon, 2, 4, 1, 0.35714, 84, 133, -49, 
1930, Southern Oregon, 4, 2, 0, 0.66667, 93, 46, 47, 
1931, Southern Oregon, 3, 0, 2, 0.80000, 49, 20, 29, 
1968, Idaho, 5, 5, 0, 0.50000, 246, 301, -55, 
1969, Idaho, 2, 8, 0, 0.20000, 206, 346, -140, 
1992, Idaho St., 3, 8, 0, 0.27273, 218, 316, -98, 
1993, Idaho St., 1, 10, 0, 0.09091, 264, 307, -43, 
1994, Idaho St., 6, 5, 0, 0.54545, 269, 369, -100, 
1995, Idaho St., 6, 5, 0, 0.54545, 307, 252, 55, 
1996, Idaho St., 4, 7, 0, 0.36364, 320, 316, 4, 
1995, Johnson C. Smith (NC), 2, 8, 0, 0.20000, 139, 338, -199, 
1996, Johnson C. Smith (NC), 7, 3, 0, 0.70000, 212, 122, 90, 
1997, Savannah St. (GA), 3, 8, 0, 0.27273, 199, 250, -51, 
1998, Savannah St. (GA), 7, 4, 0, 0.63636, 233, 143, 90, 
2005, Johnson C. Smith (NC), 0, 10, 0, 0.00000, 106, 262, -156, 
2006, Johnson C. Smith (NC), 7, 4, 0, 0.63636, 187, 189, -2, 
2007, Johnson C. Smith (NC), 3, 7, 0, 0.30000, 223, 269, -46, 
2008, Johnson C. Smith (NC), 3, 7, 0, 0.30000, 222, 375, -153, 
2009, Johnson C. Smith (NC), 3, 7, 0, 0.30000, 187, 323, -136, 
2010, Clark Atlanta (GA), 4, 6, 0, 0.40000, 175, 213, -38, 
2011, Clark Atlanta (GA), 2, 8, 0, 0.20000, 98, 182, -84, 
2012, Clark Atlanta (GA), 2, 8, 0, 0.20000, 98, 268, -170, 
2009, Texas Tech, 1, 0, 0, 1.00000, 41, 31, 10, 
2010, East Carolina (NC), 6, 7, 0, 0.46154, 478, 572, -94, 
2011, East Carolina (NC), 5, 7, 0, 0.41667, 315, 387, -72, 
2012, East Carolina (NC), 8, 5, 0, 0.61538, 409, 411, -2, 
2013, East Carolina (NC), 10, 3, 0, 0.76923, 522, 322, 200, 
1948, Virginia Tech, 0, 8, 1, 0.05556, 28, 209, -181, 
1949, Virginia Tech, 1, 7, 2, 0.20000, 130, 272, -142, 
1950, Virginia Tech, 0, 10, 0, 0.00000, 72, 430, -358, 
2007, Lake Erie College (OH), 8, 2, 0, 0.80000, 421, 155, 266, 
2008, Lake Erie College (OH), 3, 8, 0, 0.27273, 289, 444, -155, 
2009, Lake Erie College (OH), 7, 4, 0, 0.63636, 319, 273, 46, 
2010, Lake Erie College (OH), 3, 8, 0, 0.27273, 264, 440, -176, 
2011, Lake Erie College (OH), 3, 8, 0, 0.27273, 296, 422, -126, 
2012, Lake Erie College (OH), 3, 8, 0, 0.27273, 275, 437, -162, 
2013, Lake Erie College (OH), 4, 7, 0, 0.36364, 427, 481, -54, 
2003, Merchant Marine (NY), 6, 4, 0, 0.60000, 202, 186, 16, 
2004, Merchant Marine (NY), 3, 7, 0, 0.30000, 153, 254, -101, 
1930, Ball St. (IN), 6, 1, 0, 0.85714, 131, 37, 94, 
1931, Ball St. (IN), 2, 6, 0, 0.25000, 65, 161, -96, 
1932, Ball St. (IN), 4, 4, 0, 0.50000, 102, 90, 12, 
1933, Ball St. (IN), 1, 6, 1, 0.18750, 20, 90, -70, 
1934, Ball St. (IN), 2, 6, 0, 0.25000, 58, 100, -42, 
1902, Miami (OH), 5, 3, 1, 0.61111, 91, 44, 47, 
1903, Miami (OH), 1, 4, 0, 0.20000, 27, 110, -83, 
1954, Mississippi Valley St., 6, 3, 0, 0.66667, 195, 73, 122, 
1955, Mississippi Valley St., 7, 2, 0, 0.77778, 260, 63, 197, 
1956, Mississippi Valley St., 8, 1, 1, 0.85000, 412, 69, 343, 
1957, Mississippi Valley St., 5, 3, 1, 0.61111, 165, 135, 30, 
1969, Jackson St. (MS), 2, 6, 0, 0.25000, 166, 267, -101, 
1970, Jackson St. (MS), 4, 7, 0, 0.36364, 223, 247, -24, 
1923, Stetson (FL), 5, 2, 0, 0.71429, 185, 54, 131, 
1924, Stetson (FL), 6, 0, 0, 1.00000, 198, 20, 178, 
1925, Stetson (FL), 5, 3, 1, 0.61111, 96, 110, -14, 
1926, Stetson (FL), 5, 2, 1, 0.68750, 144, 45, 99, 
1927, Stetson (FL), 6, 0, 1, 0.92857, 192, 13, 179, 
1928, Stetson (FL), 4, 3, 0, 0.57143, 72, 72, 0, 
1929, Stetson (FL), 5, 1, 0, 0.83333, 121, 33, 88, 
1930, Stetson (FL), 5, 3, 0, 0.62500, 187, 55, 132, 
1931, Stetson (FL), 4, 5, 0, 0.44444, 118, 106, 12, 
1932, Stetson (FL), 3, 1, 1, 0.70000, 39, 41, -2, 
1933, Stetson (FL), 3, 3, 1, 0.50000, 112, 55, 57, 
1934, Stetson (FL), 3, 4, 1, 0.43750, 70, 93, -23, 
1955, Stetson (FL), 2, 4, 2, 0.37500, 82, 112, -30, 
1956, Stetson (FL), 2, 7, 1, 0.25000, 154, 243, -89, 
1890, Missouri, 2, 1, 0, 0.66667, 112, 34, 78, 
1965, Dayton (OH), 1, 8, 1, 0.15000, 26, 161, -135, 
1966, Dayton (OH), 8, 2, 0, 0.80000, 144, 108, 36, 
1967, Dayton (OH), 6, 3, 1, 0.65000, 171, 112, 59, 
1968, Dayton (OH), 5, 5, 0, 0.50000, 222, 165, 57, 
1969, Dayton (OH), 3, 7, 0, 0.30000, 172, 213, -41, 
1970, Dayton (OH), 5, 4, 1, 0.55000, 191, 151, 40, 
1971, Dayton (OH), 5, 6, 0, 0.45455, 165, 235, -70, 
1972, Dayton (OH), 4, 6, 1, 0.40909, 172, 181, -9, 
1899, Notre Dame (IN), 6, 3, 1, 0.65000, 169, 55, 114, 
1919, Arkansas Tech, 2, 2, 1, 0.50000, 90, 76, 14, 
1986, Texas Tech, 7, 4, 0, 0.63636, 254, 248, 6, 
1987, Texas, 7, 5, 0, 0.58333, 335, 324, 11, 
1988, Texas, 4, 7, 0, 0.36364, 252, 304, -52, 
1989, Texas, 5, 6, 0, 0.45455, 220, 289, -69, 
1990, Texas, 10, 2, 0, 0.83333, 358, 227, 131, 
1991, Texas, 5, 6, 0, 0.45455, 195, 145, 50, 
1914, Truman St. (MO), 0, 5, 0, 0.00000, 0, 173, -173, 
1915, Truman St. (MO), 1, 4, 0, 0.20000, 51, 105, -54, 
1916, Truman St. (MO), 7, 0, 1, 0.93750, 202, 31, 171, 
1917, Truman St. (MO), 1, 5, 0, 0.16667, 59, 123, -64, 
1919, Truman St. (MO), 3, 2, 2, 0.57143, 159, 39, 120, 
1920, Truman St. (MO), 8, 0, 0, 1.00000, 180, 24, 156, 
1921, Truman St. (MO), 7, 2, 0, 0.77778, 129, 57, 72, 
1922, Truman St. (MO), 6, 0, 2, 0.87500, 115, 33, 82, 
1923, Truman St. (MO), 5, 4, 0, 0.55556, 114, 82, 32, 
1924, Truman St. (MO), 4, 3, 2, 0.55556, 70, 59, 11, 
1925, Truman St. (MO), 6, 2, 1, 0.72222, 138, 35, 103, 
2001, Georgia Tech, 1, 0, 0, 1.00000, 24, 14, 10, 
1921, Bloomsburg (PA), 1, 5, 1, 0.21429, 32, 88, -56, 
1922, Bloomsburg (PA), 5, 4, 0, 0.55556, 120, 98, 22, 
1923, Bloomsburg (PA), 5, 3, 0, 0.62500, 100, 62, 38, 
1924, Bloomsburg (PA), 2, 5, 0, 0.28571, 61, 111, -50, 
1985, Swarthmore (PA), 4, 5, 0, 0.44444, 119, 151, -32, 
1986, Swarthmore (PA), 4, 5, 0, 0.44444, 113, 195, -82, 
1987, Swarthmore (PA), 2, 8, 0, 0.20000, 117, 238, -121, 
1988, Swarthmore (PA), 2, 8, 0, 0.20000, 127, 218, -91, 
1989, Swarthmore (PA), 5, 5, 0, 0.50000, 200, 222, -22, 
1929, Rice (TX), 2, 7, 0, 0.22222, 34, 208, -174, 
1930, Rice (TX), 8, 4, 0, 0.66667, 135, 91, 44, 
1931, Rice (TX), 6, 4, 0, 0.60000, 178, 66, 112, 
1932, Rice (TX), 7, 3, 0, 0.70000, 141, 77, 64, 
1933, Rice (TX), 3, 8, 0, 0.27273, 56, 137, -81, 
1934, Auburn (AL), 2, 8, 0, 0.20000, 58, 107, -49, 
1935, Auburn (AL), 8, 2, 0, 0.80000, 201, 46, 155, 
1936, Auburn (AL), 7, 2, 2, 0.72727, 160, 63, 97, 
1937, Auburn (AL), 6, 2, 3, 0.68182, 127, 36, 91, 
1938, Auburn (AL), 4, 5, 1, 0.45000, 110, 88, 22, 
1939, Auburn (AL), 5, 5, 1, 0.50000, 71, 69, 2, 
1940, Auburn (AL), 6, 4, 1, 0.59091, 170, 153, 17, 
1941, Auburn (AL), 4, 5, 1, 0.45000, 123, 115, 8, 
1942, Auburn (AL), 6, 4, 1, 0.59091, 174, 133, 41, 
1941, Beloit (WI), 2, 5, 0, 0.28571, 31, 68, -37, 
1942, Beloit (WI), 1, 5, 0, 0.16667, 19, 94, -75, 
1917, Tulsa (OK), 0, 8, 1, 0.05556, 61, 221, -160, 
1939, Southwestern (TX), 3, 5, 0, 0.37500, 59, 85, -26, 
1940, Southwestern (TX), 5, 6, 0, 0.45455, 93, 83, 10, 
1941, Southwestern (TX), 4, 4, 1, 0.50000, 114, 100, 14, 
1942, Southwestern (TX), 6, 4, 0, 0.60000, 245, 90, 155, 
1943, Southwestern (TX), 10, 1, 1, 0.87500, 266, 59, 207, 
1944, Southwestern (TX), 7, 5, 0, 0.58333, 221, 197, 24, 
1945, Southwestern (TX), 2, 6, 1, 0.27778, 85, 148, -63, 
1946, Southwestern (TX), 5, 4, 1, 0.55000, 243, 181, 62, 
1947, Southwestern (TX), 3, 6, 0, 0.33333, 79, 133, -54, 
1950, Southwestern (TX), 5, 5, 0, 0.50000, 139, 126, 13, 
1920, Syracuse (NY), 6, 2, 1, 0.72222, 201, 27, 174, 
1921, Syracuse (NY), 7, 2, 0, 0.77778, 194, 59, 135, 
1922, Syracuse (NY), 6, 1, 2, 0.77778, 176, 41, 135, 
1923, Syracuse (NY), 8, 1, 0, 0.88889, 237, 19, 218, 
1924, Syracuse (NY), 8, 2, 1, 0.77273, 154, 58, 96, 
1925, New York (NY), 6, 2, 1, 0.72222, 168, 45, 123, 
1926, New York (NY), 8, 1, 0, 0.88889, 172, 25, 147, 
1927, New York (NY), 7, 1, 2, 0.80000, 345, 65, 280, 
1928, New York (NY), 8, 2, 0, 0.80000, 316, 71, 245, 
1929, New York (NY), 7, 3, 0, 0.70000, 184, 92, 92, 
1930, New York (NY), 7, 3, 0, 0.70000, 201, 40, 161, 
1931, New York (NY), 6, 3, 1, 0.65000, 212, 47, 165, 
1932, Manhattan (NY), 6, 3, 2, 0.63636, 144, 53, 91, 
1933, Manhattan (NY), 5, 3, 1, 0.61111, 104, 107, -3, 
1934, Manhattan (NY), 3, 5, 1, 0.38889, 65, 150, -85, 
1935, Manhattan (NY), 5, 3, 1, 0.61111, 248, 117, 131, 
1936, Manhattan (NY), 6, 4, 0, 0.60000, 145, 92, 53, 
1937, Manhattan (NY), 6, 3, 1, 0.65000, 86, 84, 2, 
1951, Kansas St., 0, 9, 0, 0.00000, 73, 228, -155, 
1952, Kansas St., 1, 9, 0, 0.10000, 81, 255, -174, 
1953, Kansas St., 6, 3, 1, 0.65000, 198, 116, 82, 
1954, Kansas St., 7, 3, 0, 0.70000, 191, 154, 37, 
1955, Houston (TX), 6, 4, 0, 0.60000, 176, 139, 37, 
1956, Houston (TX), 7, 2, 1, 0.75000, 185, 90, 95, 
1957, Southern Methodist (TX), 4, 5, 1, 0.45000, 127, 175, -48, 
1958, Southern Methodist (TX), 6, 4, 0, 0.60000, 203, 134, 69, 
1959, Southern Methodist (TX), 5, 4, 1, 0.55000, 147, 133, 14, 
1960, Southern Methodist (TX), 0, 9, 1, 0.05000, 31, 221, -190, 
1961, Southern Methodist (TX), 2, 7, 1, 0.25000, 92, 191, -99, 
1968, Utah, 3, 7, 0, 0.30000, 162, 234, -72, 
1969, Utah, 8, 2, 0, 0.80000, 231, 107, 124, 
1970, Utah, 6, 4, 0, 0.60000, 208, 176, 32, 
1971, Utah, 3, 8, 0, 0.27273, 244, 315, -71, 
1972, Utah, 6, 5, 0, 0.54545, 354, 336, 18, 
1973, Utah, 7, 5, 0, 0.58333, 385, 344, 41, 
1927, Livingstone (NC), 3, 3, 1, 0.50000, 73, 92, -19, 
1928, Livingstone (NC), 3, 3, 1, 0.50000, 58, 78, -20, 
1929, Livingstone (NC), 3, 3, 3, 0.50000, 113, 45, 68, 
1930, Livingstone (NC), 0, 7, 2, 0.11111, 29, 145, -116, 
1928, Georgia, 4, 5, 0, 0.44444, 122, 113, 9, 
1929, Georgia, 6, 4, 0, 0.60000, 155, 97, 58, 
1930, Georgia, 7, 2, 1, 0.75000, 185, 71, 114, 
1931, Georgia, 8, 2, 0, 0.80000, 201, 118, 83, 
1932, Georgia, 2, 5, 2, 0.33333, 122, 116, 6, 
1933, Georgia, 8, 2, 0, 0.80000, 148, 86, 62, 
1934, Georgia, 7, 3, 0, 0.70000, 141, 56, 85, 
1935, Georgia, 6, 4, 0, 0.60000, 169, 88, 81, 
1936, Georgia, 5, 4, 1, 0.55000, 115, 159, -44, 
1937, Georgia, 6, 3, 2, 0.63636, 151, 64, 87, 
1938, Mississippi, 9, 2, 0, 0.81818, 232, 120, 112, 
1939, Mississippi, 7, 2, 0, 0.77778, 230, 64, 166, 
1940, Mississippi, 9, 2, 0, 0.81818, 251, 100, 151, 
1941, Mississippi, 6, 2, 1, 0.72222, 131, 67, 64, 
1942, Mississippi, 2, 7, 0, 0.22222, 132, 163, -31, 
1944, Mississippi, 2, 6, 0, 0.25000, 77, 178, -101, 
1945, Mississippi, 4, 5, 0, 0.44444, 100, 183, -83, 
1946, Adams St. (CO), 5, 1, 0, 0.83333, 125, 53, 72, 
1947, Adams St. (CO), 6, 3, 0, 0.66667, 165, 149, 16, 
2004, Southern Utah, 6, 5, 0, 0.54545, 294, 248, 46, 
2005, Southern Utah, 1, 9, 0, 0.10000, 126, 328, -202, 
2006, Southern Utah, 3, 8, 0, 0.27273, 215, 276, -61, 
2007, Southern Utah, 0, 11, 0, 0.00000, 178, 410, -232, 
2004, South Dakota, 9, 2, 0, 0.81818, 418, 207, 211, 
2005, South Dakota, 9, 2, 0, 0.81818, 547, 247, 300, 
2006, South Dakota, 9, 4, 0, 0.69231, 420, 253, 167, 
2007, South Dakota, 6, 5, 0, 0.54545, 345, 303, 42, 
2008, South Dakota, 6, 5, 0, 0.54545, 412, 205, 207, 
2009, South Dakota, 5, 5, 0, 0.50000, 325, 272, 53, 
2010, South Dakota, 4, 7, 0, 0.36364, 257, 280, -23, 
2011, South Dakota, 6, 5, 0, 0.54545, 301, 273, 28, 
1916, Massachusetts, 2, 4, 2, 0.37500, 25, 180, -155, 
1907, Maryland, 3, 5, 0, 0.37500, 45, 61, -16, 
1949, Utah St., 3, 7, 0, 0.30000, 105, 209, -104, 
1950, Utah St., 2, 9, 0, 0.18182, 107, 374, -267, 
2005, Brigham Young (UT), 6, 6, 0, 0.50000, 396, 351, 45, 
2006, Brigham Young (UT), 11, 2, 0, 0.84615, 478, 191, 287, 
2007, Brigham Young (UT), 11, 2, 0, 0.84615, 391, 241, 150, 
2008, Brigham Young (UT), 10, 3, 0, 0.76923, 445, 285, 160, 
2009, Brigham Young (UT), 11, 2, 0, 0.84615, 461, 280, 181, 
2010, Brigham Young (UT), 7, 6, 0, 0.53846, 340, 281, 59, 
2011, Brigham Young (UT), 10, 3, 0, 0.76923, 391, 265, 126, 
2012, Brigham Young (UT), 8, 5, 0, 0.61538, 373, 182, 191, 
2013, Brigham Young (UT), 8, 5, 0, 0.61538, 392, 287, 105, 
1921, Northern Iowa, 5, 1, 1, 0.78571, 180, 26, 154, 
1922, Northern Iowa, 5, 2, 0, 0.71429, 65, 27, 38, 
1923, Northern Iowa, 3, 5, 0, 0.37500, 58, 46, 12, 
1924, Northern Iowa, 2, 5, 0, 0.28571, 73, 39, 34, 
1899, Bridgewater (VA), 0, 1, 0, 0.00000, 0, 5, -5, 
1900, Bridgewater (VA), 1, 0, 0, 1.00000, 11, 7, 4, 
1926, Bemidji St. (MN), 1, 2, 1, 0.37500, 19, 46, -27, 
1927, Bemidji St. (MN), 4, 3, 1, 0.56250, 126, 129, -3, 
1965, Missouri St., 7, 3, 0, 0.70000, 217, 139, 78, 
1966, Missouri St., 7, 4, 0, 0.63636, 211, 138, 73, 
1967, Missouri St., 4, 6, 0, 0.40000, 115, 180, -65, 
1968, Missouri St., 2, 8, 0, 0.20000, 117, 310, -193, 
1917, Swarthmore (PA), 6, 2, 0, 0.75000, 238, 40, 198, 
1918, Swarthmore (PA), 4, 2, 0, 0.66667, 116, 38, 78, 
1919, Swarthmore (PA), 7, 1, 0, 0.87500, 145, 79, 66, 
1920, Swarthmore (PA), 4, 3, 1, 0.56250, 165, 65, 100, 
1921, Swarthmore (PA), 4, 2, 2, 0.62500, 130, 42, 88, 
1922, Swarthmore (PA), 3, 5, 0, 0.37500, 114, 101, 13, 
1923, Swarthmore (PA), 5, 2, 1, 0.68750, 107, 61, 46, 
1924, Swarthmore (PA), 4, 3, 1, 0.56250, 119, 61, 58, 
1925, Swarthmore (PA), 4, 3, 0, 0.57143, 129, 71, 58, 
1926, Swarthmore (PA), 5, 3, 0, 0.62500, 95, 122, -27, 
1927, Swarthmore (PA), 4, 3, 1, 0.56250, 64, 83, -19, 
1928, Swarthmore (PA), 6, 2, 0, 0.75000, 131, 103, 28, 
1929, Swarthmore (PA), 6, 3, 0, 0.66667, 129, 67, 62, 
1930, Swarthmore (PA), 1, 7, 1, 0.16667, 64, 168, -104, 
1939, Dubuque (IA), 4, 4, 0, 0.50000, 91, 87, 4, 
1940, Dubuque (IA), 7, 1, 0, 0.87500, 127, 58, 69, 
1941, Dubuque (IA), 6, 1, 1, 0.81250, 116, 29, 87, 
1942, Dubuque (IA), 8, 0, 0, 1.00000, 256, 25, 231, 
1945, Dubuque (IA), 4, 2, 0, 0.66667, 105, 39, 66, 
1946, Dubuque (IA), 5, 4, 0, 0.55556, 92, 76, 16, 
1947, Dubuque (IA), 5, 2, 0, 0.71429, 132, 88, 44, 
1948, Dubuque (IA), 7, 1, 0, 0.87500, 171, 79, 92, 
1949, Dubuque (IA), 6, 2, 0, 0.75000, 212, 106, 106, 
1950, Dubuque (IA), 3, 5, 0, 0.37500, 139, 138, 1, 
1951, Dubuque (IA), 3, 4, 0, 0.42857, 100, 165, -65, 
1952, Dubuque (IA), 4, 4, 0, 0.50000, 57, 73, -16, 
1953, Dubuque (IA), 4, 3, 0, 0.57143, 69, 98, -29, 
1954, Dubuque (IA), 4, 3, 1, 0.56250, 85, 87, -2, 
1955, Dubuque (IA), 2, 5, 0, 0.28571, 105, 150, -45, 
1956, Dubuque (IA), 3, 3, 2, 0.50000, 84, 93, -9, 
1957, Dubuque (IA), 1, 5, 2, 0.25000, 21, 107, -86, 
1958, Dubuque (IA), 5, 4, 0, 0.55556, 187, 179, 8, 
1959, Dubuque (IA), 5, 4, 0, 0.55556, 133, 143, -10, 
1960, Dubuque (IA), 4, 4, 0, 0.50000, 134, 109, 25, 
1961, Dubuque (IA), 5, 4, 0, 0.55556, 144, 99, 45, 
1924, Marshall (WV), 4, 3, 1, 0.56250, 48, 110, -62, 
1923, Ashland (OH), 4, 5, 1, 0.45000, 160, 76, 84, 
1924, Ashland (OH), 4, 4, 1, 0.50000, 118, 66, 52, 
1925, Ashland (OH), 0, 8, 0, 0.00000, 20, 133, -113, 
1908, Texas A&M;, 3, 5, 0, 0.37500, 76, 117, -41, 
1909, Texas A&M;, 1, 0, 1, 0.75000, 17, 0, 17, 
1951, Richmond (VA), 3, 8, 0, 0.27273, 120, 264, -144, 
1952, Richmond (VA), 1, 9, 0, 0.10000, 122, 301, -179, 
1953, Richmond (VA), 5, 3, 1, 0.61111, 125, 116, 9, 
1954, Richmond (VA), 5, 4, 0, 0.55556, 156, 54, 102, 
1955, Richmond (VA), 4, 3, 2, 0.55556, 131, 82, 49, 
1956, Richmond (VA), 4, 5, 0, 0.44444, 142, 160, -18, 
1957, Richmond (VA), 4, 6, 0, 0.40000, 157, 177, -20, 
1958, Richmond (VA), 3, 7, 0, 0.30000, 169, 200, -31, 
1959, Richmond (VA), 4, 5, 1, 0.45000, 181, 144, 37, 
1960, Richmond (VA), 3, 6, 1, 0.35000, 120, 171, -51, 
1961, Richmond (VA), 5, 5, 0, 0.50000, 143, 194, -51, 
1962, Richmond (VA), 6, 3, 0, 0.66667, 137, 153, -16, 
1963, Richmond (VA), 3, 6, 1, 0.35000, 117, 202, -85, 
1964, Richmond (VA), 3, 7, 0, 0.30000, 147, 224, -77, 
1965, Richmond (VA), 0, 10, 0, 0.00000, 48, 285, -237, 
1902, Lawrence (WI), 7, 2, 0, 0.77778, 153, 85, 68, 
1896, Miami (OH), 4, 2, 0, 0.66667, 58, 30, 28, 
1910, Broaddus College (WV), 1, 3, 0, 0.25000, 15, 61, -46, 
1930, Coast Guard (CT), 3, 5, 0, 0.37500, 99, 97, 2, 
1931, Coast Guard (CT), 3, 2, 1, 0.58333, 32, 54, -22, 
1932, Coast Guard (CT), 1, 3, 2, 0.33333, 21, 54, -33, 
1933, Coast Guard (CT), 3, 2, 1, 0.58333, 64, 47, 17, 
1934, Coast Guard (CT), 1, 6, 0, 0.14286, 40, 116, -76, 
1935, Coast Guard (CT), 2, 5, 0, 0.28571, 40, 65, -25, 
1936, Coast Guard (CT), 2, 2, 3, 0.50000, 58, 90, -32, 
1937, Coast Guard (CT), 3, 3, 1, 0.50000, 20, 85, -65, 
1938, Coast Guard (CT), 2, 6, 0, 0.25000, 38, 108, -70, 
1939, Coast Guard (CT), 0, 8, 0, 0.00000, 34, 101, -67, 
1940, Coast Guard (CT), 4, 4, 0, 0.50000, 135, 78, 57, 
1941, Coast Guard (CT), 6, 2, 0, 0.75000, 236, 48, 188, 
1942, Coast Guard (CT), 6, 2, 0, 0.75000, 194, 54, 140, 
1943, Coast Guard (CT), 3, 6, 0, 0.33333, 121, 184, -63, 
1944, Coast Guard (CT), 6, 3, 0, 0.66667, 206, 122, 84, 
1945, Coast Guard (CT), 0, 7, 1, 0.06250, 31, 209, -178, 
2005, Davidson (NC), 4, 6, 0, 0.40000, 201, 237, -36, 
2006, Davidson (NC), 6, 4, 0, 0.60000, 295, 228, 67, 
2007, Davidson (NC), 6, 4, 0, 0.60000, 312, 282, 30, 
2008, Davidson (NC), 4, 7, 0, 0.36364, 286, 280, 6, 
2009, Davidson (NC), 3, 7, 0, 0.30000, 124, 235, -111, 
2010, Davidson (NC), 3, 8, 0, 0.27273, 163, 335, -172, 
2011, Davidson (NC), 4, 7, 0, 0.36364, 186, 285, -99, 
2012, Davidson (NC), 2, 9, 0, 0.18182, 177, 334, -157, 
1952, Jackson St. (MS), 3, 5, 1, 0.38889, 109, 174, -65, 
1953, Jackson St. (MS), 5, 4, 0, 0.55556, 130, 158, -28, 
1954, Jackson St. (MS), 1, 7, 1, 0.16667, 133, 190, -57, 
1955, Jackson St. (MS), 5, 4, 0, 0.55556, 133, 156, -23, 
1956, Jackson St. (MS), 6, 2, 2, 0.70000, 276, 117, 159, 
1957, Jackson St. (MS), 6, 2, 0, 0.75000, 266, 86, 180, 
1958, Jackson St. (MS), 6, 2, 1, 0.72222, 234, 88, 146, 
1959, Jackson St. (MS), 6, 4, 0, 0.60000, 231, 189, 42, 
1960, Jackson St. (MS), 6, 4, 0, 0.60000, 265, 197, 68, 
1961, Jackson St. (MS), 9, 2, 0, 0.81818, 257, 97, 160, 
1962, Jackson St. (MS), 10, 1, 0, 0.90909, 411, 101, 310, 
1963, Tennessee St., 6, 3, 0, 0.66667, 161, 125, 36, 
1964, Tennessee St., 8, 2, 0, 0.80000, 386, 144, 242, 
1965, Tennessee St., 9, 0, 1, 0.95000, 333, 108, 225, 
1966, Tennessee St., 10, 0, 0, 1.00000, 410, 51, 359, 
1967, Tennessee St., 6, 3, 0, 0.66667, 250, 80, 170, 
1968, Tennessee St., 6, 2, 1, 0.72222, 241, 122, 119, 
1969, Tennessee St., 7, 1, 1, 0.83333, 335, 147, 188, 
1970, Tennessee St., 11, 0, 0, 1.00000, 396, 144, 252, 
1971, Tennessee St., 9, 1, 0, 0.90000, 403, 151, 252, 
1972, Tennessee St., 11, 1, 0, 0.91667, 431, 107, 324, 
1973, Tennessee St., 10, 0, 0, 1.00000, 333, 87, 246, 
1974, Tennessee St., 8, 2, 0, 0.80000, 265, 73, 192, 
1975, Tennessee St., 5, 4, 0, 0.55556, 139, 173, -34, 
1976, Tennessee St., 7, 2, 1, 0.75000, 225, 139, 86, 
1977, Tennessee St., 8, 1, 1, 0.85000, 229, 91, 138, 
1978, Tennessee St., 8, 3, 0, 0.72727, 237, 148, 89, 
1979, Tennessee St., 8, 3, 0, 0.72727, 321, 144, 177, 
1980, Tennessee St., 9, 1, 0, 0.90000, 312, 151, 161, 
1981, Tennessee St., 9, 3, 0, 0.75000, 346, 231, 115, 
1982, Tennessee St., 10, 1, 1, 0.87500, 359, 160, 199, 
1983, Tennessee St., 8, 2, 1, 0.77273, 393, 216, 177, 
1926, Allegheny (PA), 4, 5, 0, 0.44444, 80, 112, -32, 
1927, Allegheny (PA), 0, 7, 1, 0.06250, 20, 239, -219, 
1928, Allegheny (PA), 4, 3, 1, 0.56250, 103, 98, 5, 
1955, Kansas St., 4, 6, 0, 0.40000, 165, 191, -26, 
1956, Kansas St., 3, 7, 0, 0.30000, 143, 259, -116, 
1957, Kansas St., 3, 6, 1, 0.35000, 124, 166, -42, 
1958, Kansas St., 3, 7, 0, 0.30000, 110, 192, -82, 
1959, Kansas St., 2, 8, 0, 0.20000, 109, 266, -157, 
1960, Drake (IA), 4, 5, 0, 0.44444, 86, 169, -83, 
1961, Drake (IA), 5, 4, 0, 0.55556, 140, 119, 21, 
1962, Drake (IA), 8, 2, 0, 0.80000, 204, 108, 96, 
1963, Drake (IA), 4, 4, 0, 0.50000, 133, 121, 12, 
1964, Drake (IA), 6, 4, 0, 0.60000, 208, 186, 22, 
1990, Dubuque (IA), 2, 7, 0, 0.22222, 105, 335, -230, 
1991, Dubuque (IA), 1, 8, 0, 0.11111, 88, 278, -190, 
1992, Dubuque (IA), 1, 9, 0, 0.10000, 107, 322, -215, 
1993, Dubuque (IA), 2, 8, 0, 0.20000, 80, 334, -254, 
1965, Appalachian St. (NC), 5, 5, 0, 0.50000, 123, 172, -49, 
1966, Appalachian St. (NC), 3, 6, 1, 0.35000, 145, 180, -35, 
1967, Appalachian St. (NC), 7, 3, 0, 0.70000, 226, 212, 14, 
1968, Appalachian St. (NC), 8, 2, 0, 0.80000, 409, 221, 188, 
1969, Appalachian St. (NC), 6, 5, 0, 0.54545, 292, 250, 42, 
1970, Appalachian St. (NC), 5, 5, 0, 0.50000, 203, 223, -20, 
1890, Wisconsin, 1, 3, 0, 0.25000, 122, 101, 21, 
1915, Columbia (NY), 5, 0, 0, 1.00000, 126, 28, 98, 
1916, Columbia (NY), 1, 5, 2, 0.25000, 13, 84, -71, 
1917, Columbia (NY), 2, 4, 0, 0.33333, 110, 38, 72, 
1907, Texas, 6, 1, 1, 0.81250, 154, 53, 101, 
1908, Texas, 5, 4, 0, 0.55556, 135, 135, 0, 
1904, Baylor (TX), 2, 5, 1, 0.31250, 34, 106, -72, 
1908, Pennsylvania, 11, 0, 1, 0.95833, 215, 28, 187, 
1909, Oregon St., 4, 2, 1, 0.64286, 54, 41, 13, 
1914, West Virginia, 5, 4, 0, 0.55556, 159, 96, 63, 
1915, West Virginia, 5, 2, 1, 0.68750, 208, 20, 188, 
1920, South Carolina, 5, 4, 0, 0.55556, 82, 140, -58, 
1921, South Carolina, 5, 1, 2, 0.75000, 116, 28, 88, 
1922, South Carolina, 5, 4, 0, 0.55556, 93, 69, 24, 
1923, South Carolina, 4, 6, 0, 0.40000, 104, 77, 27, 
1924, South Carolina, 7, 3, 0, 0.70000, 120, 48, 72, 
1912, Wisconsin-Oshkosh, 5, 1, 0, 0.83333, 207, 40, 167, 
1913, Wisconsin-Oshkosh, 1, 5, 0, 0.16667, 26, 92, -66, 
1914, Wisconsin-Oshkosh, 2, 5, 0, 0.28571, 58, 183, -125, 
1915, Wisconsin-Oshkosh, 1, 5, 0, 0.16667, 16, 215, -199, 
1916, Wisconsin-Oshkosh, 0, 5, 0, 0.00000, 2, 147, -145, 
1917, Wisconsin-Oshkosh, 1, 4, 1, 0.25000, 12, 213, -201, 
1938, Cincinnati (OH), 4, 5, 0, 0.44444, 81, 128, -47, 
1939, Cincinnati (OH), 4, 3, 2, 0.55556, 87, 65, 22, 
1940, Cincinnati (OH), 5, 3, 1, 0.61111, 132, 48, 84, 
1941, Cincinnati (OH), 6, 3, 0, 0.66667, 194, 45, 149, 
1942, Cincinnati (OH), 8, 2, 0, 0.80000, 197, 95, 102, 
1934, Texas Christian, 8, 4, 0, 0.66667, 173, 116, 57, 
1935, Texas Christian, 12, 1, 0, 0.92308, 265, 73, 192, 
1936, Texas Christian, 9, 2, 2, 0.76923, 160, 58, 102, 
1937, Texas Christian, 4, 4, 2, 0.50000, 73, 66, 7, 
1938, Texas Christian, 11, 0, 0, 1.00000, 269, 60, 209, 
1939, Texas Christian, 3, 7, 0, 0.30000, 116, 119, -3, 
1940, Texas Christian, 3, 7, 0, 0.30000, 116, 121, -5, 
1941, Texas Christian, 7, 3, 1, 0.68182, 162, 135, 27, 
1942, Texas Christian, 7, 3, 0, 0.70000, 129, 82, 47, 
1943, Texas Christian, 2, 6, 0, 0.25000, 71, 146, -75, 
1944, Texas Christian, 7, 3, 1, 0.68182, 134, 109, 25, 
1945, Texas Christian, 5, 5, 0, 0.50000, 91, 156, -65, 
1946, Texas Christian, 2, 7, 1, 0.25000, 90, 148, -58, 
1947, Texas Christian, 4, 5, 2, 0.45455, 114, 99, 15, 
1948, Texas Christian, 4, 5, 1, 0.45000, 125, 143, -18, 
1949, Texas Christian, 6, 3, 1, 0.65000, 205, 185, 20, 
1950, Texas Christian, 5, 5, 0, 0.50000, 157, 161, -4, 
1951, Texas Christian, 6, 5, 0, 0.54545, 206, 183, 23, 
1952, Texas Christian, 4, 4, 2, 0.50000, 141, 103, 38, 
2000, Wisconsin-Oshkosh, 3, 7, 0, 0.30000, 238, 262, -24, 
2001, Wisconsin-Oshkosh, 3, 6, 0, 0.33333, 186, 293, -107, 
2002, Wisconsin-Oshkosh, 4, 6, 0, 0.40000, 205, 225, -20, 
2003, Wisconsin-Oshkosh, 4, 6, 0, 0.40000, 203, 235, -32, 
2004, Wisconsin-Oshkosh, 5, 5, 0, 0.50000, 311, 224, 87, 
2005, Wisconsin-Oshkosh, 7, 3, 0, 0.70000, 245, 230, 15, 
2006, Wisconsin-Oshkosh, 5, 5, 0, 0.50000, 243, 181, 62, 
1973, Nevada-Las Vegas, 8, 3, 0, 0.72727, 304, 151, 153, 
1974, Nevada-Las Vegas, 12, 1, 0, 0.92308, 444, 251, 193, 
1975, Nevada-Las Vegas, 7, 4, 0, 0.63636, 332, 212, 120, 
1976, Southern Methodist (TX), 3, 8, 0, 0.27273, 202, 339, -137, 
1977, Southern Methodist (TX), 4, 7, 0, 0.36364, 226, 319, -93, 
1978, Southern Methodist (TX), 4, 6, 1, 0.40909, 300, 251, 49, 
1979, Southern Methodist (TX), 5, 6, 0, 0.45455, 226, 236, -10, 
1980, Southern Methodist (TX), 8, 4, 0, 0.66667, 324, 192, 132, 
1981, Southern Methodist (TX), 10, 1, 0, 0.90909, 365, 137, 228, 
2001, Bowling Green (OH), 8, 3, 0, 0.72727, 333, 215, 118, 
2002, Bowling Green (OH), 9, 3, 0, 0.75000, 490, 304, 186, 
2003, Utah, 10, 2, 0, 0.83333, 344, 229, 115, 
2004, Utah, 11, 0, 0, 1.00000, 509, 227, 282, 
2005, Florida, 9, 3, 0, 0.75000, 343, 226, 117, 
2006, Florida, 13, 1, 0, 0.92857, 416, 189, 227, 
2007, Florida, 9, 4, 0, 0.69231, 552, 331, 221, 
2008, Florida, 13, 1, 0, 0.92857, 611, 181, 430, 
2009, Florida, 13, 1, 0, 0.92857, 502, 174, 328, 
2010, Florida, 8, 5, 0, 0.61538, 388, 277, 111, 
2012, Ohio St., 12, 0, 0, 1.00000, 446, 274, 172, 
2013, Ohio St., 12, 2, 0, 0.85714, 637, 317, 320, 
2004, Utah, 1, 0, 0, 1.00000, 35, 7, 28, 
1906, Western Michigan, 1, 3, 0, 0.25000, 26, 40, -14, 
1899, Iowa St., 5, 4, 1, 0.55000, 117, 38, 79, 
1999, Bryant (RI), 5, 4, 0, 0.55556, 186, 192, -6, 
2000, Bryant (RI), 4, 6, 0, 0.40000, 275, 227, 48, 
2001, Bryant (RI), 4, 5, 0, 0.44444, 180, 197, -17, 
2002, Bryant (RI), 5, 6, 0, 0.45455, 208, 238, -30, 
2003, Bryant (RI), 3, 7, 0, 0.30000, 209, 257, -48, 
1977, Texas-El Paso, 1, 10, 0, 0.09091, 151, 460, -309, 
1978, Texas-El Paso, 1, 11, 0, 0.08333, 151, 424, -273, 
1979, Texas-El Paso, 2, 9, 0, 0.18182, 106, 266, -160, 
1980, Texas-El Paso, 1, 11, 0, 0.08333, 143, 424, -281, 
1981, Texas-El Paso, 0, 2, 0, 0.00000, 22, 51, -29, 
2013, Colby (ME), 4, 4, 0, 0.50000, 168, 143, 25, 
1971, North Carolina St., 3, 8, 0, 0.27273, 147, 274, -127, 
1942, Iowa St., 2, 4, 0, 0.33333, 75, 117, -42, 
1943, Iowa St., 4, 4, 0, 0.50000, 147, 104, 43, 
1944, Iowa St., 6, 1, 1, 0.81250, 203, 39, 164, 
1945, Iowa St., 4, 3, 1, 0.56250, 156, 97, 59, 
1946, Iowa St., 2, 6, 1, 0.27778, 77, 239, -162, 
1955, Pittsburgh (PA), 7, 4, 0, 0.63636, 181, 122, 59, 
1956, Pittsburgh (PA), 7, 3, 1, 0.68182, 156, 119, 37, 
1957, Pittsburgh (PA), 4, 6, 0, 0.40000, 134, 157, -23, 
1958, Pittsburgh (PA), 5, 4, 1, 0.55000, 163, 138, 25, 
1959, Pittsburgh (PA), 6, 4, 0, 0.60000, 148, 164, -16, 
1960, Pittsburgh (PA), 4, 3, 3, 0.55000, 134, 77, 57, 
1961, Pittsburgh (PA), 3, 7, 0, 0.30000, 145, 209, -64, 
1962, Pittsburgh (PA), 5, 5, 0, 0.50000, 142, 185, -43, 
1963, Pittsburgh (PA), 9, 1, 0, 0.90000, 236, 130, 106, 
1964, Pittsburgh (PA), 3, 5, 2, 0.40000, 152, 154, -2, 
1965, Pittsburgh (PA), 3, 7, 0, 0.30000, 173, 311, -138, 
1890, Army (NY), 0, 1, 0, 0.00000, 0, 24, -24, 
1892, Army (NY), 3, 1, 1, 0.70000, 90, 18, 72, 
1907, Idaho, 4, 1, 2, 0.71429, 68, 25, 43, 
1908, Idaho, 2, 2, 2, 0.50000, 85, 42, 43, 
1940, Middle Tennessee St., 4, 4, 0, 0.50000, 107, 71, 36, 
1941, Middle Tennessee St., 4, 3, 1, 0.56250, 120, 87, 33, 
1942, Middle Tennessee St., 4, 2, 1, 0.64286, 106, 77, 29, 
1946, Middle Tennessee St., 6, 2, 1, 0.72222, 149, 75, 74, 
2013, Loras (IA), 1, 6, 0, 0.14286, 80, 261, -181, 
2013, Slippery Rock (PA), 9, 3, 0, 0.75000, 520, 312, 208, 
1926, Montana, 3, 5, 0, 0.37500, 128, 168, -40, 
1927, Montana, 3, 4, 1, 0.43750, 52, 142, -90, 
1928, Montana, 4, 5, 1, 0.45000, 72, 147, -75, 
1929, Montana, 3, 5, 1, 0.38889, 118, 121, -3, 
1930, Montana, 5, 3, 0, 0.62500, 122, 175, -53, 
1913, Middle Tennessee St., 5, 1, 1, 0.78571, 164, 48, 116, 
1914, Middle Tennessee St., 5, 0, 1, 0.91667, 132, 13, 119, 
1915, Middle Tennessee St., 2, 3, 1, 0.41667, 34, 92, -58, 
1916, Middle Tennessee St., 5, 2, 0, 0.71429, 116, 30, 86, 
1919, Middle Tennessee St., 4, 0, 0, 1.00000, 148, 6, 142, 
1920, Middle Tennessee St., 4, 1, 0, 0.80000, 133, 54, 79, 
1921, Middle Tennessee St., 3, 2, 1, 0.58333, 36, 74, -38, 
1922, Middle Tennessee St., 2, 6, 0, 0.25000, 20, 175, -155, 
1923, Middle Tennessee St., 4, 1, 0, 0.80000, 121, 39, 82, 
1905, Virginia Tech, 9, 1, 0, 0.90000, 305, 24, 281, 
1906, Virginia Tech, 5, 2, 2, 0.66667, 74, 15, 59, 
1917, Hanover (IN), 1, 4, 0, 0.20000, 44, 122, -78, 
2001, Oklahoma St., 4, 7, 0, 0.36364, 242, 281, -39, 
2002, Oklahoma St., 8, 5, 0, 0.61538, 446, 356, 90, 
2003, Oklahoma St., 9, 4, 0, 0.69231, 467, 326, 141, 
2004, Oklahoma St., 7, 5, 0, 0.58333, 387, 301, 86, 
2005, Louisiana St., 11, 2, 0, 0.84615, 383, 185, 198, 
2006, Louisiana St., 11, 2, 0, 0.84615, 438, 164, 274, 
2007, Louisiana St., 12, 2, 0, 0.85714, 541, 279, 262, 
2008, Louisiana St., 8, 5, 0, 0.61538, 402, 314, 88, 
2009, Louisiana St., 9, 4, 0, 0.69231, 323, 211, 112, 
2010, Louisiana St., 11, 2, 0, 0.84615, 386, 237, 149, 
2011, Louisiana St., 13, 1, 0, 0.92857, 500, 158, 342, 
2012, Louisiana St., 10, 3, 0, 0.76923, 387, 228, 159, 
2013, Louisiana St., 10, 3, 0, 0.76923, 465, 286, 179, 
2008, Indiana St., 0, 12, 0, 0.00000, 101, 508, -407, 
2009, Indiana St., 1, 10, 0, 0.09091, 99, 390, -291, 
2010, Indiana St., 6, 5, 0, 0.54545, 351, 328, 23, 
2011, Indiana St., 6, 5, 0, 0.54545, 315, 300, 15, 
2012, Indiana St., 7, 4, 0, 0.63636, 254, 157, 97, 
2013, Georgia St., 0, 12, 0, 0.00000, 225, 440, -215, 
1978, Azusa Pacific (CA), 3, 6, 0, 0.33333, 269, 225, 44, 
1979, Azusa Pacific (CA), 3, 4, 1, 0.43750, 132, 164, -32, 
1980, Azusa Pacific (CA), 8, 2, 0, 0.80000, 217, 107, 110, 
1981, Azusa Pacific (CA), 7, 3, 0, 0.70000, 223, 128, 95, 
1982, Azusa Pacific (CA), 5, 3, 0, 0.62500, 192, 103, 89, 
1983, Azusa Pacific (CA), 6, 3, 0, 0.66667, 190, 128, 62, 
1984, Azusa Pacific (CA), 7, 3, 0, 0.70000, 214, 159, 55, 
1985, Azusa Pacific (CA), 7, 1, 1, 0.83333, 310, 153, 157, 
1986, Azusa Pacific (CA), 0, 7, 2, 0.11111, 252, 154, 98, 
1987, Azusa Pacific (CA), 2, 8, 0, 0.20000, 143, 278, -135, 
1988, Azusa Pacific (CA), 7, 1, 0, 0.87500, 160, 99, 61, 
1989, Azusa Pacific (CA), 4, 5, 0, 0.44444, 215, 170, 45, 
1990, Azusa Pacific (CA), 6, 3, 0, 0.66667, 227, 164, 63, 
1991, Azusa Pacific (CA), 1, 8, 0, 0.11111, 146, 238, -92, 
1992, Azusa Pacific (CA), 4, 5, 0, 0.44444, 202, 289, -87, 
1993, Azusa Pacific (CA), 3, 6, 0, 0.33333, 193, 217, -24, 
1994, Azusa Pacific (CA), 3, 6, 0, 0.33333, 176, 323, -147, 
1921, Villanova (PA), 6, 1, 2, 0.77778, 113, 93, 20, 
1922, Villanova (PA), 5, 3, 1, 0.61111, 67, 56, 11, 
1965, Texas St., 8, 2, 0, 0.80000, 234, 74, 160, 
1966, Texas St., 7, 2, 1, 0.75000, 181, 93, 88, 
1967, Texas St., 9, 1, 0, 0.90000, 374, 108, 266, 
1968, Texas St., 5, 5, 0, 0.50000, 248, 195, 53, 
1969, Texas St., 3, 6, 1, 0.35000, 219, 241, -22, 
1970, Texas St., 6, 5, 0, 0.54545, 256, 220, 36, 
1971, Texas St., 8, 1, 1, 0.85000, 304, 133, 171, 
1972, Texas St., 7, 3, 0, 0.70000, 213, 145, 68, 
1973, Texas St., 4, 6, 0, 0.40000, 161, 198, -37, 
1974, Texas St., 6, 4, 0, 0.60000, 156, 153, 3, 
1975, Texas St., 7, 3, 0, 0.70000, 209, 169, 40, 
1976, Texas St., 5, 5, 0, 0.50000, 215, 204, 11, 
1977, Texas St., 5, 4, 0, 0.55556, 168, 164, 4, 
1978, Texas St., 6, 4, 0, 0.60000, 218, 124, 94, 
1916, Central Michigan, 1, 5, 0, 0.16667, 39, 139, -100, 
1909, Ouachita Baptist (AR), 3, 3, 0, 0.50000, 173, 115, 58, 
1910, Ouachita Baptist (AR), 5, 3, 0, 0.62500, 95, 33, 62, 
1911, Ouachita Baptist (AR), 2, 4, 0, 0.33333, 69, 44, 25, 
1909, Saint Francis (PA), 2, 2, 0, 0.50000, 30, 21, 9, 
1942, Eastern Illinois, 1, 7, 0, 0.12500, 20, 206, -186, 
1906, Kansas Wesleyan, 0, 1, 0, 0.00000, 0, 40, -40, 
1995, Missouri St., 4, 7, 0, 0.36364, 220, 204, 16, 
1996, Missouri St., 7, 4, 0, 0.63636, 285, 179, 106, 
1997, Missouri St., 5, 6, 0, 0.45455, 266, 282, -16, 
1998, Missouri St., 5, 6, 0, 0.45455, 318, 285, 33, 
2000, Wisconsin Lutheran, 3, 7, 0, 0.30000, 117, 245, -128, 
2001, Wisconsin Lutheran, 4, 5, 0, 0.44444, 190, 316, -126, 
2002, Wisconsin Lutheran, 3, 7, 0, 0.30000, 209, 318, -109, 
2003, Wisconsin Lutheran, 5, 5, 0, 0.50000, 256, 215, 41, 
2004, Wisconsin Lutheran, 2, 8, 0, 0.20000, 146, 325, -179, 
2005, Wisconsin Lutheran, 1, 9, 0, 0.10000, 122, 299, -177, 
2006, Wisconsin Lutheran, 0, 10, 0, 0.00000, 96, 368, -272, 
2007, Wisconsin Lutheran, 2, 8, 0, 0.20000, 135, 381, -246, 
2008, Wisconsin Lutheran, 4, 6, 0, 0.40000, 173, 243, -70, 
2009, Wisconsin Lutheran, 5, 5, 0, 0.50000, 248, 186, 62, 
2010, Wisconsin Lutheran, 6, 4, 0, 0.60000, 225, 180, 45, 
2011, Wisconsin Lutheran, 6, 4, 0, 0.60000, 288, 230, 58, 
2012, Wisconsin Lutheran, 7, 3, 0, 0.70000, 266, 130, 136, 
1931, Navy (MD), 5, 5, 1, 0.50000, 78, 95, -17, 
1932, Navy (MD), 2, 6, 1, 0.27778, 67, 80, -13, 
1933, Navy (MD), 5, 4, 0, 0.55556, 90, 86, 4, 
1927, Kentucky Wesleyan, 6, 3, 0, 0.66667, 143, 50, 93, 
1932, Western Kentucky, 7, 1, 0, 0.87500, 220, 40, 180, 
1929, Wake Forest (NC), 6, 5, 1, 0.54167, 108, 155, -47, 
1930, Wake Forest (NC), 5, 3, 1, 0.61111, 125, 77, 48, 
1931, Wake Forest (NC), 4, 4, 0, 0.50000, 44, 138, -94, 
1932, Wake Forest (NC), 3, 3, 2, 0.50000, 39, 36, 3, 
1927, Indiana (PA), 4, 4, 0, 0.50000, 94, 84, 10, 
1928, Indiana (PA), 3, 4, 0, 0.42857, 58, 102, -44, 
1929, Indiana (PA), 5, 3, 0, 0.62500, 86, 57, 29, 
1930, Indiana (PA), 3, 3, 1, 0.50000, 47, 76, -29, 
1931, Indiana (PA), 4, 2, 2, 0.62500, 70, 47, 23, 
1932, Indiana (PA), 5, 3, 0, 0.62500, 63, 41, 22, 
1933, Indiana (PA), 4, 3, 0, 0.57143, 79, 33, 46, 
1934, Indiana (PA), 6, 0, 0, 1.00000, 128, 17, 111, 
1935, Indiana (PA), 5, 3, 0, 0.62500, 118, 51, 67, 
1936, Indiana (PA), 4, 2, 1, 0.64286, 87, 37, 50, 
1937, Indiana (PA), 6, 1, 1, 0.81250, 163, 45, 118, 
1938, Indiana (PA), 3, 4, 0, 0.42857, 77, 83, -6, 
1939, Indiana (PA), 4, 2, 2, 0.62500, 102, 56, 46, 
1940, Indiana (PA), 7, 0, 1, 0.93750, 150, 24, 126, 
1941, Indiana (PA), 4, 2, 0, 0.66667, 84, 55, 29, 
1942, Indiana (PA), 5, 3, 0, 0.62500, 126, 75, 51, 
1945, Indiana (PA), 0, 2, 0, 0.00000, 0, 33, -33, 
1946, Indiana (PA), 5, 3, 0, 0.62500, 148, 85, 63, 
1947, Indiana (PA), 2, 2, 1, 0.50000, 53, 52, 1, 
1910, Creighton (NE), 4, 4, 1, 0.50000, 44, 41, 3, 
1911, Creighton (NE), 3, 4, 2, 0.44444, 124, 127, -3, 
1912, Creighton (NE), 5, 3, 0, 0.62500, 178, 136, 42, 
1913, Creighton (NE), 4, 3, 1, 0.56250, 239, 44, 195, 
1914, Creighton (NE), 5, 4, 0, 0.55556, 241, 71, 170, 
1925, Temple (PA), 5, 2, 2, 0.66667, 104, 39, 65, 
1926, Temple (PA), 5, 3, 0, 0.62500, 89, 93, -4, 
1927, Temple (PA), 7, 1, 0, 0.87500, 351, 60, 291, 
1928, Temple (PA), 7, 1, 2, 0.80000, 224, 23, 201, 
1929, Temple (PA), 6, 3, 1, 0.65000, 141, 65, 76, 
1930, Temple (PA), 7, 3, 0, 0.70000, 224, 110, 114, 
1931, Temple (PA), 8, 1, 1, 0.85000, 158, 42, 116, 
1932, Temple (PA), 5, 1, 2, 0.75000, 105, 53, 52, 
1959, Detroit (MI), 6, 4, 0, 0.60000, 199, 139, 60, 
1960, Detroit (MI), 7, 2, 0, 0.77778, 181, 136, 45, 
1961, Detroit (MI), 5, 4, 0, 0.55556, 181, 173, 8, 
1962, Boston College (MA), 8, 2, 0, 0.80000, 251, 123, 128, 
1963, Boston College (MA), 6, 3, 0, 0.66667, 168, 130, 38, 
1964, Boston College (MA), 6, 3, 0, 0.66667, 112, 110, 2, 
1965, Boston College (MA), 6, 4, 0, 0.60000, 209, 117, 92, 
1966, Boston College (MA), 4, 6, 0, 0.40000, 133, 202, -69, 
1967, Boston College (MA), 4, 6, 0, 0.40000, 227, 212, 15, 
1910, West Texas A&M;, 2, 2, 0, 0.50000, 48, 32, 16, 
1911, West Texas A&M;, 3, 3, 0, 0.50000, 26, 34, -8, 
1919, Missouri, 5, 1, 2, 0.75000, 91, 42, 49, 
1921, Albion (MI), 6, 2, 0, 0.75000, 166, 62, 104, 
1922, Albion (MI), 5, 2, 2, 0.66667, 113, 41, 72, 
1923, Albion (MI), 7, 2, 0, 0.77778, 133, 53, 80, 
1899, New Mexico St., 1, 0, 0, 1.00000, 38, 0, 38, 
1901, New Mexico St., 2, 1, 0, 0.66667, 38, 6, 32, 
1902, New Mexico St., 0, 1, 2, 0.33333, 0, 6, -6, 
1903, New Mexico St., 2, 0, 1, 0.83333, 34, 0, 34, 
1904, New Mexico St., 1, 2, 1, 0.37500, 42, 33, 9, 
1905, New Mexico St., 5, 0, 1, 0.91667, 128, 0, 128, 
1906, New Mexico St., 4, 0, 0, 1.00000, 71, 12, 59, 
1907, New Mexico St., 3, 0, 0, 1.00000, 88, 6, 82, 
1928, Franklin & Marshall (PA), 4, 5, 0, 0.44444, 63, 125, -62, 
1929, Franklin & Marshall (PA), 6, 3, 0, 0.66667, 130, 69, 61, 
1930, Franklin & Marshall (PA), 5, 3, 1, 0.61111, 96, 102, -6, 
1926, Bridgewater (VA), 1, 3, 0, 0.25000, 12, 100, -88, 
1928, Bridgewater (VA), 0, 6, 1, 0.07143, 12, 268, -256, 
1929, Bridgewater (VA), 0, 7, 0, 0.00000, 12, 218, -206, 
1974, West Liberty St. (WV), 5, 4, 0, 0.55556, 123, 122, 1, 
1975, West Liberty St. (WV), 3, 4, 2, 0.44444, 163, 207, -44, 
1976, West Liberty St. (WV), 5, 5, 0, 0.50000, 145, 139, 6, 
1977, West Liberty St. (WV), 3, 6, 1, 0.35000, 120, 172, -52, 
2013, McMurry (TX), 3, 8, 0, 0.27273, 424, 554, -130, 
2012, Minnesota-Crookston, 2, 9, 0, 0.18182, 187, 451, -264, 
1892, Kentucky, 2, 4, 1, 0.35714, 40, 74, -34, 
1949, North Dakota, 4, 3, 1, 0.56250, 72, 121, -49, 
1977, Morningside (IA), 2, 6, 1, 0.27778, 124, 274, -150, 
1978, Morningside (IA), 1, 8, 1, 0.15000, 150, 343, -193, 
1979, Morningside (IA), 0, 10, 0, 0.00000, 67, 292, -225, 
2006, La Salle (PA), 3, 7, 0, 0.30000, 146, 255, -109, 
2007, La Salle (PA), 0, 10, 0, 0.00000, 71, 344, -273, 
1942, West Texas A&M;, 7, 2, 0, 0.77778, 130, 112, 18, 
1944, West Texas A&M;, 4, 3, 0, 0.57143, 117, 152, -35, 
1945, West Texas A&M;, 2, 6, 0, 0.25000, 115, 135, -20, 
1946, West Texas A&M;, 3, 4, 0, 0.42857, 100, 98, 2, 
1942, Brigham Young (UT), 2, 5, 0, 0.28571, 55, 133, -78, 
1947, Pittsburgh (PA), 1, 8, 0, 0.11111, 26, 267, -241, 
1948, Pittsburgh (PA), 6, 3, 0, 0.66667, 119, 154, -35, 
1949, Pittsburgh (PA), 6, 3, 0, 0.66667, 156, 154, 2, 
1962, Indiana (PA), 5, 2, 1, 0.68750, 121, 56, 65, 
1963, Indiana (PA), 7, 1, 1, 0.83333, 207, 77, 130, 
1964, Merchant Marine (NY), 3, 7, 0, 0.30000, 107, 208, -101, 
1967, Utah St., 7, 2, 1, 0.75000, 205, 143, 62, 
1968, Utah St., 7, 3, 0, 0.70000, 247, 142, 105, 
1969, Utah St., 3, 7, 0, 0.30000, 134, 250, -116, 
1970, Utah St., 5, 5, 0, 0.50000, 217, 225, -8, 
1971, Utah St., 8, 3, 0, 0.72727, 243, 183, 60, 
1972, Utah St., 8, 3, 0, 0.72727, 329, 230, 99, 
1973, Wake Forest (NC), 1, 9, 1, 0.13636, 73, 326, -253, 
1974, Wake Forest (NC), 1, 10, 0, 0.09091, 74, 348, -274, 
1975, Wake Forest (NC), 3, 8, 0, 0.27273, 221, 264, -43, 
1976, Wake Forest (NC), 5, 6, 0, 0.45455, 177, 206, -29, 
1977, Wake Forest (NC), 1, 10, 0, 0.09091, 113, 270, -157, 
1980, Southern Oregon, 3, 7, 0, 0.30000, 138, 223, -85, 
1981, Southern Oregon, 6, 4, 0, 0.60000, 169, 182, -13, 
1982, Southern Oregon, 6, 4, 0, 0.60000, 234, 157, 77, 
1983, Southern Oregon, 9, 2, 0, 0.81818, 342, 204, 138, 
1984, Southern Oregon, 0, 10, 0, 0.00000, 226, 186, 40, 
1985, Southern Oregon, 3, 6, 1, 0.35000, 170, 238, -68, 
1986, Southern Oregon, 5, 5, 0, 0.50000, 129, 161, -32, 
1987, Southern Oregon, 7, 5, 0, 0.58333, 253, 258, -5, 
1988, Southern Oregon, 5, 4, 0, 0.55556, 223, 237, -14, 
1997, Coast Guard (CT), 9, 2, 0, 0.81818, 256, 169, 87, 
1997, Amherst (MA), 7, 1, 0, 0.87500, 256, 93, 163, 
1998, Amherst (MA), 5, 3, 0, 0.62500, 156, 141, 15, 
1999, Amherst (MA), 5, 3, 0, 0.62500, 126, 88, 38, 
2000, Amherst (MA), 7, 1, 0, 0.87500, 158, 70, 88, 
2001, Amherst (MA), 7, 1, 0, 0.87500, 165, 49, 116, 
2002, Amherst (MA), 6, 2, 0, 0.75000, 191, 124, 67, 
2003, Amherst (MA), 4, 4, 0, 0.50000, 182, 75, 107, 
2004, Amherst (MA), 6, 2, 0, 0.75000, 192, 125, 67, 
2005, Amherst (MA), 5, 3, 0, 0.62500, 201, 98, 103, 
2006, Amherst (MA), 5, 3, 0, 0.62500, 146, 90, 56, 
2007, Amherst (MA), 4, 4, 0, 0.50000, 145, 109, 36, 
2008, Amherst (MA), 5, 3, 0, 0.62500, 175, 144, 31, 
2009, Amherst (MA), 8, 0, 0, 1.00000, 162, 83, 79, 
2010, Amherst (MA), 6, 2, 0, 0.75000, 286, 159, 127, 
2011, Amherst (MA), 8, 0, 0, 1.00000, 239, 101, 138, 
2012, Amherst (MA), 6, 2, 0, 0.75000, 197, 119, 78, 
2013, Amherst (MA), 7, 1, 0, 0.87500, 169, 94, 75, 
1908, Baylor (TX), 3, 5, 0, 0.37500, 48, 164, -116, 
1909, Baylor (TX), 5, 3, 0, 0.62500, 112, 41, 71, 
1918, Colorado, 2, 3, 0, 0.40000, 43, 42, 1, 
1919, Colorado, 2, 3, 1, 0.41667, 87, 96, -9, 
2003, Charleston Southern (SC), 1, 11, 0, 0.08333, 148, 513, -365, 
2004, Charleston Southern (SC), 5, 5, 0, 0.50000, 268, 212, 56, 
2005, Charleston Southern (SC), 7, 4, 0, 0.63636, 313, 303, 10, 
2006, Charleston Southern (SC), 9, 2, 0, 0.81818, 300, 199, 101, 
2007, Charleston Southern (SC), 5, 6, 0, 0.45455, 266, 378, -112, 
2008, Charleston Southern (SC), 7, 5, 0, 0.58333, 277, 268, 9, 
2009, Charleston Southern (SC), 6, 5, 0, 0.54545, 268, 323, -55, 
2010, Charleston Southern (SC), 3, 8, 0, 0.27273, 247, 457, -210, 
2011, Charleston Southern (SC), 0, 11, 0, 0.00000, 186, 439, -253, 
2012, Charleston Southern (SC), 5, 6, 0, 0.45455, 219, 312, -93, 
1905, New York (NY), 3, 3, 1, 0.50000, 40, 74, -34, 
2006, Becker College (MA), 0, 9, 0, 0.00000, 108, 333, -225, 
2007, Becker College (MA), 2, 7, 0, 0.22222, 247, 401, -154, 
1915, Creighton (NE), 3, 3, 1, 0.50000, 138, 72, 66, 
1916, Creighton (NE), 4, 1, 2, 0.71429, 107, 38, 69, 
1917, Creighton (NE), 6, 2, 1, 0.72222, 207, 48, 159, 
1918, Creighton (NE), 3, 0, 0, 1.00000, 107, 7, 100, 
1919, Creighton (NE), 4, 0, 2, 0.83333, 113, 6, 107, 
1920, Beloit (WI), 4, 3, 0, 0.57143, 92, 48, 44, 
1921, Beloit (WI), 5, 2, 1, 0.68750, 71, 115, -44, 
1922, Beloit (WI), 3, 3, 1, 0.50000, 124, 53, 71, 
1923, Beloit (WI), 6, 1, 1, 0.81250, 139, 54, 85, 
1924, Beloit (WI), 4, 3, 1, 0.56250, 84, 81, 3, 
1925, Beloit (WI), 6, 2, 0, 0.75000, 124, 44, 80, 
1930, Georgetown (DC), 5, 5, 0, 0.50000, 138, 107, 31, 
1931, Georgetown (DC), 4, 5, 1, 0.45000, 78, 86, -8, 
1932, Georgetown (DC), 2, 3, 0, 0.40000, 46, 70, -24, 
1934, Arkansas St., 2, 5, 1, 0.31250, 31, 80, -49, 
1935, Arkansas St., 2, 7, 0, 0.22222, 38, 196, -158, 
1985, Howard Payne (TX), 2, 6, 2, 0.30000, 98, 219, -121, 
1986, Howard Payne (TX), 0, 10, 0, 0.00000, 113, 347, -234, 
1987, Howard Payne (TX), 5, 5, 0, 0.50000, 171, 234, -63, 
1942, Texas-El Paso, 5, 4, 0, 0.55556, 162, 111, 51, 
1898, Minnesota, 4, 5, 0, 0.44444, 92, 73, 19, 
2013, Campbell (NC), 3, 9, 0, 0.25000, 349, 451, -102, 
1994, Cincinnati (OH), 2, 8, 1, 0.22727, 159, 301, -142, 
1995, Cincinnati (OH), 6, 5, 0, 0.54545, 252, 197, 55, 
1996, Cincinnati (OH), 6, 5, 0, 0.54545, 228, 212, 16, 
1997, Cincinnati (OH), 8, 4, 0, 0.66667, 321, 252, 69, 
1998, Cincinnati (OH), 2, 9, 0, 0.18182, 259, 456, -197, 
1999, Cincinnati (OH), 3, 8, 0, 0.27273, 275, 289, -14, 
2000, Cincinnati (OH), 7, 5, 0, 0.58333, 289, 285, 4, 
2001, Cincinnati (OH), 7, 5, 0, 0.58333, 336, 290, 46, 
2002, Cincinnati (OH), 7, 7, 0, 0.50000, 409, 329, 80, 
2003, Cincinnati (OH), 5, 7, 0, 0.41667, 303, 319, -16, 
2009, Marshall (WV), 1, 0, 0, 1.00000, 21, 17, 4, 
1990, Swarthmore (PA), 7, 3, 0, 0.70000, 172, 187, -15, 
1991, Swarthmore (PA), 2, 7, 0, 0.22222, 124, 238, -114, 
1992, Swarthmore (PA), 5, 3, 1, 0.61111, 242, 230, 12, 
1993, Swarthmore (PA), 3, 6, 0, 0.33333, 148, 262, -114, 
1994, Swarthmore (PA), 3, 7, 0, 0.30000, 178, 220, -42, 
1995, Swarthmore (PA), 5, 5, 0, 0.50000, 131, 245, -114, 
1996, Swarthmore (PA), 0, 10, 0, 0.00000, 128, 387, -259, 
1997, Swarthmore (PA), 0, 10, 0, 0.00000, 54, 541, -487, 
2012, Concordia (MI), 0, 9, 0, 0.00000, 82, 423, -341, 
1983, Kentucky Wesleyan, 3, 5, 0, 0.37500, 102, 165, -63, 
1984, Kentucky Wesleyan, 3, 6, 1, 0.35000, 159, 260, -101, 
1985, Kentucky Wesleyan, 2, 6, 1, 0.27778, 161, 210, -49, 
1986, Kentucky Wesleyan, 4, 6, 0, 0.40000, 169, 239, -70, 
1987, Kentucky Wesleyan, 3, 6, 0, 0.33333, 98, 259, -161, 
1988, Kentucky Wesleyan, 4, 6, 0, 0.40000, 143, 206, -63, 
1989, Kentucky Wesleyan, 3, 6, 1, 0.35000, 175, 290, -115, 
1932, Nevada, 3, 3, 2, 0.50000, 41, 99, -58, 
1933, Nevada, 4, 4, 0, 0.50000, 60, 144, -84, 
1934, Nevada, 1, 7, 1, 0.16667, 15, 153, -138, 
1935, Nevada, 2, 6, 0, 0.25000, 57, 139, -82, 
1949, Livingstone (NC), 2, 4, 0, 0.33333, 14, 182, -168, 
1950, Livingstone (NC), 0, 6, 1, 0.07143, 26, 174, -148, 
1952, Livingstone (NC), 3, 4, 0, 0.42857, 59, 61, -2, 
1953, Livingstone (NC), 3, 4, 0, 0.42857, 103, 112, -9, 
1954, Livingstone (NC), 5, 2, 0, 0.71429, 132, 61, 71, 
1955, Livingstone (NC), 2, 6, 0, 0.25000, 66, 125, -59, 
1957, Livingstone (NC), 6, 2, 1, 0.72222, 152, 76, 76, 
1958, Livingstone (NC), 6, 2, 0, 0.75000, 163, 56, 107, 
1915, Eastern Michigan, 4, 2, 1, 0.64286, 154, 25, 129, 
1916, Eastern Michigan, 1, 2, 1, 0.37500, 18, 33, -15, 
1947, Louisiana-Lafayette, 6, 2, 0, 0.75000, 165, 58, 107, 
1948, Louisiana-Lafayette, 6, 3, 1, 0.65000, 179, 134, 45, 
1949, Louisiana-Lafayette, 6, 3, 0, 0.66667, 174, 145, 29, 
1961, Brigham Young (UT), 2, 8, 0, 0.20000, 130, 289, -159, 
1962, Brigham Young (UT), 4, 6, 0, 0.40000, 197, 170, 27, 
1963, Brigham Young (UT), 2, 8, 0, 0.20000, 91, 222, -131, 
1918, Army (NY), 1, 0, 0, 1.00000, 20, 0, 20, 
1953, Wichita St. (KS), 4, 4, 1, 0.50000, 172, 110, 62, 
1954, Wichita St. (KS), 9, 1, 0, 0.90000, 325, 86, 239, 
1955, Arkansas, 5, 4, 1, 0.55000, 126, 114, 12, 
1956, Arkansas, 6, 4, 0, 0.60000, 160, 155, 5, 
1957, Arkansas, 6, 4, 0, 0.60000, 187, 134, 53, 
1958, Kansas, 4, 5, 1, 0.45000, 87, 175, -88, 
1959, Kansas, 5, 5, 0, 0.50000, 163, 134, 29, 
1960, Kansas, 5, 4, 1, 0.55000, 219, 89, 130, 
1961, Kansas, 7, 3, 1, 0.68182, 269, 88, 181, 
1962, Kansas, 6, 3, 1, 0.65000, 214, 116, 98, 
1963, Kansas, 5, 5, 0, 0.50000, 207, 122, 85, 
1964, Kansas, 6, 4, 0, 0.60000, 136, 146, -10, 
1965, Kansas, 2, 8, 0, 0.20000, 119, 215, -96, 
1966, Kansas, 2, 7, 1, 0.25000, 106, 188, -82, 
1996, Morgan St. (MD), 4, 7, 0, 0.36364, 172, 365, -193, 
1997, Morgan St. (MD), 3, 7, 0, 0.30000, 149, 234, -85, 
1998, Morgan St. (MD), 1, 10, 0, 0.09091, 168, 370, -202, 
2010, Southern (LA), 2, 9, 0, 0.18182, 243, 372, -129, 
2011, Southern (LA), 4, 7, 0, 0.36364, 237, 273, -36, 
2012, Southern (LA), 0, 2, 0, 0.00000, 21, 72, -51, 
2010, Grand Valley St. (MI), 11, 2, 0, 0.84615, 469, 249, 220, 
2011, Grand Valley St. (MI), 8, 3, 0, 0.72727, 466, 223, 243, 
2012, Grand Valley St. (MI), 8, 3, 0, 0.72727, 461, 347, 114, 
2013, Grand Valley St. (MI), 12, 3, 0, 0.80000, 525, 364, 161, 
2002, Greensboro (NC), 4, 6, 0, 0.40000, 139, 170, -31, 
2003, Greensboro (NC), 3, 7, 0, 0.30000, 127, 209, -82, 
2004, Greensboro (NC), 2, 8, 0, 0.20000, 150, 261, -111, 
2005, Greensboro (NC), 2, 8, 0, 0.20000, 187, 342, -155, 
2006, Greensboro (NC), 3, 7, 0, 0.30000, 190, 342, -152, 
2007, Greensboro (NC), 2, 8, 0, 0.20000, 187, 291, -104, 
2008, Greensboro (NC), 2, 8, 0, 0.20000, 145, 255, -110, 
1946, North Texas, 7, 3, 1, 0.68182, 127, 102, 25, 
1947, North Texas, 10, 2, 0, 0.83333, 256, 77, 179, 
1948, North Texas, 6, 4, 0, 0.60000, 249, 133, 116, 
1949, North Texas, 8, 4, 0, 0.66667, 336, 192, 144, 
1950, North Texas, 7, 2, 1, 0.75000, 266, 174, 92, 
1951, North Texas, 8, 4, 0, 0.66667, 434, 132, 302, 
1952, North Texas, 7, 3, 0, 0.70000, 276, 137, 139, 
1953, North Texas, 3, 6, 1, 0.35000, 167, 167, 0, 
1954, North Texas, 4, 6, 0, 0.40000, 151, 176, -25, 
1955, North Texas, 5, 4, 1, 0.55000, 197, 159, 38, 
1956, North Texas, 7, 2, 1, 0.75000, 188, 131, 57, 
1957, North Texas, 5, 5, 0, 0.50000, 191, 150, 41, 
1958, North Texas, 7, 2, 1, 0.75000, 197, 93, 104, 
1959, North Texas, 9, 2, 0, 0.81818, 303, 103, 200, 
1960, North Texas, 2, 6, 1, 0.27778, 107, 208, -101, 
1961, North Texas, 5, 4, 1, 0.55000, 162, 206, -44, 
1962, North Texas, 6, 4, 0, 0.60000, 174, 182, -8, 
1963, North Texas, 3, 6, 0, 0.33333, 109, 195, -86, 
1964, North Texas, 2, 7, 1, 0.25000, 78, 172, -94, 
1965, North Texas, 3, 7, 0, 0.30000, 181, 312, -131, 
1966, North Texas, 8, 2, 0, 0.80000, 298, 141, 157, 
1960, Delaware St., 4, 4, 0, 0.50000, 134, 87, 47, 
1985, Alabama St., 3, 8, 0, 0.27273, 129, 255, -126, 
1999, Morgan St. (MD), 2, 8, 0, 0.20000, 191, 334, -143, 
2000, Morgan St. (MD), 1, 10, 0, 0.09091, 173, 403, -230, 
2001, Morgan St. (MD), 2, 9, 0, 0.18182, 251, 316, -65, 
1923, Susquehanna (PA), 3, 6, 0, 0.33333, 56, 192, -136, 
1926, East Stroudsburg (PA), 6, 1, 1, 0.81250, 203, 10, 193, 
1927, East Stroudsburg (PA), 6, 1, 1, 0.81250, 178, 40, 138, 
1928, East Stroudsburg (PA), 4, 5, 0, 0.44444, 75, 76, -1, 
1929, East Stroudsburg (PA), 3, 4, 1, 0.43750, 106, 84, 22, 
1930, East Stroudsburg (PA), 4, 4, 0, 0.50000, 71, 89, -18, 
1931, East Stroudsburg (PA), 3, 2, 2, 0.57143, 82, 62, 20, 
1932, East Stroudsburg (PA), 2, 5, 1, 0.31250, 64, 80, -16, 
1933, East Stroudsburg (PA), 4, 4, 0, 0.50000, 58, 95, -37, 
1934, East Stroudsburg (PA), 4, 2, 1, 0.64286, 61, 47, 14, 
1935, East Stroudsburg (PA), 3, 5, 0, 0.37500, 45, 115, -70, 
1975, North Park (IL), 1, 8, 0, 0.11111, 79, 268, -189, 
1976, North Park (IL), 1, 8, 0, 0.11111, 44, 287, -243, 
1977, North Park (IL), 0, 9, 0, 0.00000, 48, 299, -251, 
1997, Clark Atlanta (GA), 4, 7, 0, 0.36364, 168, 188, -20, 
1998, Clark Atlanta (GA), 3, 7, 0, 0.30000, 157, 271, -114, 
1916, Louisiana-Lafayette, 7, 1, 0, 0.87500, 240, 30, 210, 
1919, Louisiana-Lafayette, 2, 4, 2, 0.37500, 70, 146, -76, 
1921, Louisiana-Lafayette, 9, 2, 0, 0.81818, 217, 104, 113, 
1922, Louisiana-Lafayette, 3, 4, 2, 0.44444, 84, 54, 30, 
1923, Louisiana-Lafayette, 7, 3, 0, 0.70000, 240, 107, 133, 
1924, Louisiana-Lafayette, 6, 2, 1, 0.72222, 214, 93, 121, 
1925, Louisiana-Lafayette, 7, 2, 0, 0.77778, 176, 72, 104, 
1926, Louisiana-Lafayette, 6, 3, 1, 0.65000, 153, 98, 55, 
1927, Louisiana-Lafayette, 2, 7, 1, 0.25000, 30, 195, -165, 
1928, Louisiana-Lafayette, 4, 5, 0, 0.44444, 113, 174, -61, 
1929, Louisiana-Lafayette, 2, 7, 0, 0.22222, 52, 203, -151, 
1930, Louisiana-Lafayette, 2, 8, 0, 0.20000, 52, 257, -205, 
1970, North Alabama, 5, 5, 0, 0.50000, 219, 273, -54, 
1971, North Alabama, 1, 10, 0, 0.09091, 125, 316, -191, 
1972, North Alabama, 2, 9, 0, 0.18182, 116, 217, -101, 
1898, Wabash (IN), 2, 5, 1, 0.31250, 33, 136, -103, 
1899, Wabash (IN), 1, 0, 1, 0.75000, 29, 0, 29, 
1977, Illinois, 3, 8, 0, 0.27273, 141, 292, -151, 
1978, Illinois, 1, 8, 2, 0.18182, 103, 317, -214, 
1979, Illinois, 2, 8, 1, 0.22727, 156, 266, -110, 
1990, Michigan, 9, 3, 0, 0.75000, 389, 198, 191, 
1991, Michigan, 10, 2, 0, 0.83333, 420, 203, 217, 
1992, Michigan, 9, 0, 3, 0.87500, 431, 171, 260, 
1993, Michigan, 8, 4, 0, 0.66667, 342, 160, 182, 
1994, Michigan, 8, 4, 0, 0.66667, 330, 268, 62, 
1941, American International (MA), 5, 2, 0, 0.71429, 99, 29, 70, 
1942, American International (MA), 2, 1, 2, 0.60000, 19, 18, 1, 
2012, Coastal Carolina (SC), 8, 5, 0, 0.61538, 446, 369, 77, 
2013, Coastal Carolina (SC), 12, 3, 0, 0.80000, 615, 457, 158, 
2013, Trinity (TX), 5, 5, 0, 0.50000, 287, 232, 55, 
1917, Southwestern (TX), 2, 5, 1, 0.31250, 70, 139, -69, 
1918, Southwestern (TX), 6, 2, 0, 0.75000, 133, 27, 106, 
1980, Central Missouri St., 6, 3, 1, 0.65000, 203, 131, 72, 
1981, Central Missouri St., 4, 3, 3, 0.55000, 128, 102, 26, 
1982, Central Missouri St., 7, 3, 0, 0.70000, 237, 147, 90, 
1983, Eastern Illinois, 9, 3, 0, 0.75000, 265, 122, 143, 
1984, Eastern Illinois, 6, 5, 0, 0.54545, 326, 258, 68, 
1985, Eastern Illinois, 6, 5, 0, 0.54545, 261, 272, -11, 
1986, Eastern Illinois, 11, 2, 0, 0.84615, 459, 227, 232, 
1987, Western Michigan, 5, 6, 0, 0.45455, 218, 240, -22, 
1988, Western Michigan, 9, 3, 0, 0.75000, 354, 237, 117, 
1989, Western Michigan, 5, 6, 0, 0.45455, 210, 210, 0, 
1990, Western Michigan, 7, 4, 0, 0.63636, 249, 235, 14, 
1991, Western Michigan, 6, 5, 0, 0.54545, 218, 253, -35, 
1992, Western Michigan, 7, 3, 1, 0.68182, 197, 177, 20, 
1993, Western Michigan, 7, 3, 1, 0.68182, 236, 187, 49, 
1994, Western Michigan, 7, 4, 0, 0.63636, 274, 189, 85, 
1995, Western Michigan, 7, 4, 0, 0.63636, 253, 190, 63, 
1996, Western Michigan, 2, 9, 0, 0.18182, 208, 304, -96, 
1978, Susquehanna (PA), 1, 8, 0, 0.11111, 46, 230, -184, 
1979, Susquehanna (PA), 2, 7, 0, 0.22222, 69, 150, -81, 
1980, Susquehanna (PA), 2, 7, 0, 0.22222, 108, 208, -100, 
1981, Susquehanna (PA), 6, 3, 0, 0.66667, 193, 62, 131, 
1982, Susquehanna (PA), 7, 2, 0, 0.77778, 227, 67, 160, 
1983, Susquehanna (PA), 8, 0, 1, 0.94444, 278, 78, 200, 
1984, Susquehanna (PA), 6, 3, 0, 0.66667, 214, 134, 80, 
1926, Valparaiso (IN), 1, 4, 1, 0.25000, 28, 90, -62, 
1956, Purdue (IN), 3, 4, 2, 0.44444, 139, 122, 17, 
1957, Purdue (IN), 5, 4, 0, 0.55556, 178, 114, 64, 
1958, Purdue (IN), 6, 1, 2, 0.77778, 184, 102, 82, 
1959, Purdue (IN), 5, 2, 2, 0.66667, 109, 81, 28, 
1960, Purdue (IN), 4, 4, 1, 0.50000, 212, 163, 49, 
1961, Purdue (IN), 6, 3, 0, 0.66667, 146, 87, 59, 
1962, Purdue (IN), 4, 4, 1, 0.50000, 141, 68, 73, 
1963, Purdue (IN), 5, 4, 0, 0.55556, 119, 149, -30, 
1964, Purdue (IN), 6, 3, 0, 0.66667, 168, 146, 22, 
1965, Purdue (IN), 7, 2, 1, 0.75000, 227, 127, 100, 
1966, Purdue (IN), 9, 2, 0, 0.81818, 297, 154, 143, 
1967, Purdue (IN), 8, 2, 0, 0.80000, 291, 154, 137, 
1968, Purdue (IN), 8, 2, 0, 0.80000, 291, 167, 124, 
1969, Purdue (IN), 8, 2, 0, 0.80000, 354, 264, 90, 
2011, Minnesota-Crookston, 1, 10, 0, 0.09091, 171, 426, -255, 
1993, Augustana (SD), 4, 7, 0, 0.36364, 225, 247, -22, 
1994, Augustana (SD), 4, 6, 0, 0.40000, 229, 219, 10, 
1995, Augustana (SD), 3, 6, 1, 0.35000, 233, 314, -81, 
2012, Massachusetts, 1, 11, 0, 0.08333, 152, 482, -330, 
2013, Massachusetts, 1, 11, 0, 0.08333, 140, 396, -256, 
1972, Queens (NY), 0, 4, 0, 0.00000, 8, 96, -88, 
1974, New Mexico, 4, 6, 1, 0.40909, 192, 263, -71, 
1975, New Mexico, 6, 5, 0, 0.54545, 291, 232, 59, 
1976, New Mexico, 4, 7, 0, 0.36364, 229, 235, -6, 
1977, New Mexico, 5, 7, 0, 0.41667, 273, 339, -66, 
1978, New Mexico, 7, 5, 0, 0.58333, 284, 205, 79, 
1979, New Mexico, 5, 7, 0, 0.41667, 211, 229, -18, 
1983, Morningside (IA), 1, 10, 0, 0.09091, 114, 334, -220, 
1984, Morningside (IA), 6, 5, 0, 0.54545, 216, 238, -22, 
1985, Morningside (IA), 7, 3, 1, 0.68182, 352, 225, 127, 
1986, Morningside (IA), 1, 10, 0, 0.09091, 87, 277, -190, 
1987, Morningside (IA), 4, 7, 0, 0.36364, 122, 275, -153, 
1988, Morningside (IA), 0, 11, 0, 0.00000, 123, 464, -341, 
1927, Hanover (IN), 1, 6, 1, 0.18750, 30, 166, -136, 
1928, Hanover (IN), 3, 4, 0, 0.42857, 61, 50, 11, 
1929, Hanover (IN), 2, 3, 1, 0.41667, 45, 51, -6, 
1930, Hanover (IN), 1, 4, 2, 0.28571, 69, 86, -17, 
1931, Hanover (IN), 1, 7, 1, 0.16667, 26, 182, -156, 
1932, Louisville (KY), 0, 9, 0, 0.00000, 18, 392, -374, 
1940, Ferris St. (MI), 1, 7, 0, 0.12500, 21, 235, -214, 
1941, Ferris St. (MI), 1, 4, 1, 0.25000, 46, 73, -27, 
2013, Kenyon (OH), 4, 6, 0, 0.40000, 169, 260, -91, 
2013, Arkansas Tech, 5, 6, 0, 0.45455, 270, 294, -24, 
1903, Drake (IA), 5, 3, 0, 0.62500, 170, 93, 77, 
1904, Drake (IA), 5, 4, 0, 0.55556, 213, 165, 48, 
1906, Missouri, 5, 2, 1, 0.68750, 116, 44, 72, 
1907, Missouri, 7, 2, 0, 0.77778, 278, 41, 237, 
1908, Missouri, 6, 2, 0, 0.75000, 196, 45, 151, 
2010, Georgia Southern, 10, 5, 0, 0.66667, 413, 277, 136, 
2011, Georgia Southern, 11, 3, 0, 0.78571, 492, 330, 162, 
2012, Georgia Southern, 10, 4, 0, 0.71429, 483, 308, 175, 
2013, Georgia Southern, 7, 4, 0, 0.63636, 368, 255, 113, 
2013, Southern Mississippi, 1, 11, 0, 0.08333, 205, 503, -298, 
2013, Lebanon Valley (PA), 8, 3, 0, 0.72727, 314, 250, 64, 
1902, Ohio, 0, 6, 1, 0.07143, 0, 165, -165, 
1902, Hampton (VA), 1, 0, 0, 1.00000, 16, 0, 16, 
1903, Hampton (VA), 1, 0, 0, 1.00000, 21, 2, 19, 
1904, Hampton (VA), 0, 1, 0, 0.00000, 0, 6, -6, 
1905, Hampton (VA), 0, 2, 0, 0.00000, 0, 23, -23, 
1906, Hampton (VA), 4, 1, 0, 0.80000, 66, 15, 51, 
1907, Hampton (VA), 3, 1, 1, 0.70000, 28, 6, 22, 
1908, Hampton (VA), 4, 1, 1, 0.75000, 132, 7, 125, 
1909, Hampton (VA), 5, 3, 0, 0.62500, 86, 27, 59, 
1910, Hampton (VA), 3, 2, 0, 0.60000, 164, 56, 108, 
1911, Hampton (VA), 5, 1, 0, 0.83333, 62, 13, 49, 
1956, Maryland, 3, 6, 1, 0.35000, 68, 168, -100, 
1957, Maryland, 5, 5, 0, 0.50000, 119, 144, -25, 
1958, Maryland, 4, 6, 0, 0.40000, 132, 175, -43, 
1959, DePauw (IN), 1, 7, 1, 0.16667, 77, 160, -83, 
1960, DePauw (IN), 3, 5, 1, 0.38889, 98, 115, -17, 
1961, DePauw (IN), 5, 4, 0, 0.55556, 127, 99, 28, 
1962, DePauw (IN), 5, 4, 0, 0.55556, 108, 103, 5, 
1963, DePauw (IN), 5, 4, 0, 0.55556, 146, 78, 68, 
1964, DePauw (IN), 2, 7, 0, 0.22222, 117, 173, -56, 
1965, DePauw (IN), 2, 6, 1, 0.27778, 159, 190, -31, 
1966, DePauw (IN), 3, 6, 0, 0.33333, 127, 142, -15, 
1967, DePauw (IN), 6, 2, 1, 0.72222, 143, 99, 44, 
1968, DePauw (IN), 6, 3, 0, 0.66667, 149, 122, 27, 
1969, DePauw (IN), 2, 7, 0, 0.22222, 132, 233, -101, 
1970, DePauw (IN), 4, 5, 0, 0.44444, 94, 123, -29, 
1971, DePauw (IN), 1, 8, 0, 0.11111, 91, 207, -116, 
1972, DePauw (IN), 2, 7, 0, 0.22222, 76, 163, -87, 
1973, DePauw (IN), 6, 3, 0, 0.66667, 168, 149, 19, 
1974, DePauw (IN), 7, 3, 0, 0.70000, 159, 138, 21, 
1975, DePauw (IN), 5, 5, 0, 0.50000, 194, 211, -17, 
1976, DePauw (IN), 2, 8, 0, 0.20000, 144, 198, -54, 
1971, Florida A&M;, 6, 5, 0, 0.54545, 226, 251, -25, 
2013, Emory & Henry (VA), 5, 5, 0, 0.50000, 288, 259, 29, 
1947, Central Arkansas, 8, 1, 1, 0.85000, 266, 86, 180, 
1948, Central Arkansas, 5, 3, 1, 0.61111, 138, 103, 35, 
1949, Central Arkansas, 3, 5, 2, 0.40000, 132, 149, -17, 
1950, Central Arkansas, 7, 2, 1, 0.75000, 239, 118, 121, 
1951, Central Arkansas, 3, 6, 0, 0.33333, 138, 166, -28, 
1955, Cameron (OK), 9, 1, 0, 0.90000, 295, 75, 220, 
1956, Cameron (OK), 5, 5, 0, 0.50000, 318, 150, 168, 
1957, Cameron (OK), 8, 4, 0, 0.66667, 290, 142, 148, 
1958, Cameron (OK), 4, 6, 0, 0.40000, 209, 239, -30, 
1959, Cameron (OK), 4, 5, 0, 0.44444, 141, 152, -11, 
1960, Cameron (OK), 9, 1, 0, 0.90000, 354, 97, 257, 
1961, Cameron (OK), 11, 0, 0, 1.00000, 355, 149, 206, 
1962, Cameron (OK), 7, 2, 0, 0.77778, 342, 94, 248, 
1963, Cameron (OK), 8, 2, 0, 0.80000, 269, 135, 134, 
2005, Miami (OH), 7, 4, 0, 0.63636, 371, 258, 113, 
2006, Miami (OH), 2, 10, 0, 0.16667, 222, 304, -82, 
2007, Miami (OH), 6, 7, 0, 0.46154, 250, 333, -83, 
2008, Miami (OH), 2, 10, 0, 0.16667, 221, 392, -171, 
1927, South Dakota, 7, 2, 0, 0.77778, 143, 105, 38, 
1928, South Dakota, 3, 5, 0, 0.37500, 71, 77, -6, 
1929, South Dakota, 4, 4, 1, 0.50000, 146, 64, 82, 
1930, South Dakota, 1, 6, 2, 0.22222, 124, 156, -32, 
1926, Southwestern (KS), 2, 6, 0, 0.25000, 34, 110, -76, 
1927, Southwestern (KS), 6, 2, 0, 0.75000, 141, 86, 55, 
1928, Southwestern (KS), 4, 3, 2, 0.55556, 62, 46, 16, 
1929, Southwestern (KS), 2, 5, 1, 0.31250, 29, 63, -34, 
1930, Southwestern (KS), 2, 5, 1, 0.31250, 79, 124, -45, 
1931, Southwestern (KS), 3, 5, 1, 0.38889, 57, 41, 16, 
1932, Southwestern (KS), 3, 4, 2, 0.44444, 88, 71, 17, 
1933, Southwestern (KS), 2, 6, 1, 0.27778, 97, 137, -40, 
1934, Southwestern (KS), 5, 5, 0, 0.50000, 114, 93, 21, 
1935, Southwestern (KS), 4, 5, 0, 0.44444, 100, 130, -30, 
1936, Southwestern (KS), 1, 8, 0, 0.11111, 26, 141, -115, 
2003, West Virginia Tech, 3, 8, 0, 0.27273, 222, 368, -146, 
2004, West Virginia Tech, 2, 9, 0, 0.18182, 190, 433, -243, 
1994, Elizabeth City St. (NC), 5, 6, 0, 0.45455, 230, 295, -65, 
1995, Elizabeth City St. (NC), 7, 4, 0, 0.63636, 296, 310, -14, 
1996, Elizabeth City St. (NC), 4, 6, 0, 0.40000, 107, 199, -92, 
1997, Elizabeth City St. (NC), 2, 8, 0, 0.20000, 93, 293, -200, 
1998, Elizabeth City St. (NC), 2, 9, 0, 0.18182, 122, 319, -197, 
1999, Elizabeth City St. (NC), 1, 10, 0, 0.09091, 118, 327, -209, 
1923, Clarion (PA), 6, 6, 0, 0.50000, 256, 221, 35, 
2006, LaGrange (GA), 0, 10, 0, 0.00000, 93, 421, -328, 
2007, LaGrange (GA), 0, 10, 0, 0.00000, 126, 355, -229, 
2008, LaGrange (GA), 9, 2, 0, 0.81818, 437, 229, 208, 
2009, LaGrange (GA), 5, 5, 0, 0.50000, 235, 267, -32, 
2010, LaGrange (GA), 3, 7, 0, 0.30000, 219, 335, -116, 
2011, LaGrange (GA), 4, 6, 0, 0.40000, 188, 204, -16, 
2012, LaGrange (GA), 3, 7, 0, 0.30000, 196, 308, -112, 
2013, LaGrange (GA), 3, 4, 0, 0.42857, 267, 264, 3, 
1965, New Hampshire, 0, 8, 0, 0.00000, 58, 292, -234, 
1931, Tennessee-Chattanooga, 9, 2, 0, 0.81818, 229, 92, 137, 
1932, Tennessee-Chattanooga, 3, 6, 0, 0.33333, 102, 111, -9, 
1933, Tennessee-Chattanooga, 2, 3, 2, 0.42857, 68, 57, 11, 
1934, Tennessee-Chattanooga, 4, 3, 1, 0.56250, 62, 91, -29, 
1935, Tennessee-Chattanooga, 4, 3, 1, 0.56250, 88, 118, -30, 
1936, Tennessee-Chattanooga, 5, 2, 1, 0.68750, 59, 39, 20, 
1937, Tennessee-Chattanooga, 4, 3, 2, 0.55556, 114, 56, 58, 
1938, Tennessee-Chattanooga, 4, 5, 0, 0.44444, 109, 163, -54, 
1939, Tennessee-Chattanooga, 5, 2, 1, 0.68750, 90, 100, -10, 
1940, Tennessee-Chattanooga, 7, 1, 1, 0.83333, 179, 87, 92, 
1941, Tennessee-Chattanooga, 7, 1, 1, 0.83333, 209, 72, 137, 
1942, Tennessee-Chattanooga, 7, 4, 0, 0.63636, 274, 157, 117, 
1945, Tennessee-Chattanooga, 5, 3, 0, 0.62500, 153, 129, 24, 
1946, Tennessee-Chattanooga, 5, 5, 0, 0.50000, 254, 233, 21, 
1947, Tennessee-Chattanooga, 4, 6, 0, 0.40000, 112, 179, -67, 
1948, Tennessee-Chattanooga, 4, 5, 0, 0.44444, 115, 113, 2, 
1949, Tennessee-Chattanooga, 5, 4, 0, 0.55556, 182, 199, -17, 
1950, Tennessee-Chattanooga, 1, 9, 0, 0.10000, 90, 221, -131, 
1951, Tennessee-Chattanooga, 6, 5, 0, 0.54545, 290, 176, 114, 
1952, Tennessee-Chattanooga, 7, 3, 0, 0.70000, 341, 142, 199, 
1953, Tennessee-Chattanooga, 3, 7, 0, 0.30000, 164, 190, -26, 
1954, Tennessee-Chattanooga, 6, 4, 0, 0.60000, 198, 164, 34, 
1955, Tennessee-Chattanooga, 5, 4, 1, 0.55000, 95, 91, 4, 
1956, Tennessee-Chattanooga, 5, 4, 0, 0.55556, 154, 188, -34, 
1957, Tennessee-Chattanooga, 4, 5, 1, 0.45000, 114, 133, -19, 
1958, Tennessee-Chattanooga, 5, 5, 0, 0.50000, 194, 135, 59, 
1959, Tennessee-Chattanooga, 3, 7, 0, 0.30000, 59, 173, -114, 
1960, Tennessee-Chattanooga, 5, 5, 0, 0.50000, 139, 174, -35, 
1961, Tennessee-Chattanooga, 4, 6, 0, 0.40000, 127, 216, -89, 
1962, Tennessee-Chattanooga, 5, 5, 0, 0.50000, 172, 279, -107, 
1963, Tennessee-Chattanooga, 4, 6, 0, 0.40000, 89, 154, -65, 
1964, Tennessee-Chattanooga, 7, 3, 0, 0.70000, 159, 114, 45, 
1965, Tennessee-Chattanooga, 5, 4, 1, 0.55000, 130, 179, -49, 
1966, Tennessee-Chattanooga, 5, 5, 0, 0.50000, 156, 168, -12, 
1967, Tennessee-Chattanooga, 7, 3, 0, 0.70000, 246, 162, 84, 
1926, Mercer (GA), 4, 4, 2, 0.50000, 138, 98, 40, 
1927, Mercer (GA), 5, 4, 0, 0.55556, 191, 111, 80, 
1928, Mercer (GA), 3, 5, 1, 0.38889, 73, 231, -158, 
1935, Louisiana St., 9, 2, 0, 0.81818, 223, 41, 182, 
1936, Louisiana St., 9, 1, 1, 0.86364, 295, 54, 241, 
1937, Louisiana St., 9, 2, 0, 0.81818, 234, 33, 201, 
1938, Louisiana St., 6, 4, 0, 0.60000, 160, 89, 71, 
1939, Louisiana St., 4, 5, 0, 0.44444, 111, 116, -5, 
1940, Louisiana St., 6, 4, 0, 0.60000, 139, 112, 27, 
1941, Louisiana St., 4, 4, 2, 0.50000, 119, 93, 26, 
1942, Louisiana St., 7, 3, 0, 0.70000, 192, 117, 75, 
1943, Louisiana St., 6, 3, 0, 0.66667, 162, 158, 4, 
1944, Louisiana St., 2, 5, 1, 0.31250, 92, 101, -9, 
1945, Louisiana St., 7, 2, 0, 0.77778, 245, 92, 153, 
1946, Louisiana St., 9, 1, 1, 0.86364, 240, 123, 117, 
1947, Louisiana St., 5, 3, 1, 0.61111, 149, 161, -12, 
1948, Clarion (PA), 4, 4, 0, 0.50000, 140, 63, 77, 
1949, Clarion (PA), 6, 2, 0, 0.75000, 190, 47, 143, 
1975, Kansas, 7, 5, 0, 0.58333, 262, 180, 82, 
1976, Kansas, 6, 5, 0, 0.54545, 260, 251, 9, 
1977, Kansas, 4, 6, 1, 0.40909, 131, 269, -138, 
1978, Kansas, 1, 10, 0, 0.09091, 124, 345, -221, 
1973, Bethune-Cookman (FL), 9, 2, 0, 0.81818, 302, 165, 137, 
1974, Bethune-Cookman (FL), 8, 3, 1, 0.70833, 313, 126, 187, 
1975, Bethune-Cookman (FL), 10, 1, 0, 0.90909, 417, 97, 320, 
1994, Norfolk St. (VA), 7, 3, 0, 0.70000, 345, 310, 35, 
1995, Norfolk St. (VA), 7, 3, 0, 0.70000, 360, 259, 101, 
1996, Norfolk St. (VA), 7, 4, 0, 0.63636, 225, 203, 22, 
1997, Norfolk St. (VA), 3, 7, 0, 0.30000, 206, 200, 6, 
1998, Norfolk St. (VA), 2, 9, 0, 0.18182, 258, 494, -236, 
1978, Sewanee (TN), 4, 4, 0, 0.50000, 153, 129, 24, 
1979, Sewanee (TN), 7, 2, 0, 0.77778, 148, 104, 44, 
1980, Sewanee (TN), 4, 5, 0, 0.44444, 162, 179, -17, 
1981, Sewanee (TN), 5, 4, 0, 0.55556, 257, 161, 96, 
1982, Sewanee (TN), 7, 2, 0, 0.77778, 188, 152, 36, 
1983, Sewanee (TN), 5, 4, 0, 0.55556, 211, 212, -1, 
1984, Sewanee (TN), 0, 9, 0, 0.00000, 144, 301, -157, 
1985, Sewanee (TN), 4, 5, 0, 0.44444, 174, 209, -35, 
1986, Sewanee (TN), 2, 7, 0, 0.22222, 178, 256, -78, 
1979, North Texas, 5, 6, 0, 0.45455, 182, 235, -53, 
1980, North Texas, 6, 5, 0, 0.54545, 268, 252, 16, 
1981, Texas Tech, 1, 9, 1, 0.13636, 198, 298, -100, 
1982, Texas Tech, 4, 7, 0, 0.36364, 157, 234, -77, 
1983, Texas Tech, 3, 7, 1, 0.31818, 160, 253, -93, 
1984, Texas Tech, 4, 7, 0, 0.36364, 200, 212, -12, 
1985, Texas Tech, 4, 7, 0, 0.36364, 249, 240, 9, 
1989, Appalachian St. (NC), 9, 3, 0, 0.75000, 306, 177, 129, 
1990, Appalachian St. (NC), 6, 5, 0, 0.54545, 171, 266, -95, 
1991, Appalachian St. (NC), 8, 4, 0, 0.66667, 215, 202, 13, 
1992, Appalachian St. (NC), 7, 5, 0, 0.58333, 262, 237, 25, 
1993, Appalachian St. (NC), 4, 7, 0, 0.36364, 207, 252, -45, 
1994, Appalachian St. (NC), 9, 4, 0, 0.69231, 363, 209, 154, 
1995, Appalachian St. (NC), 12, 1, 0, 0.92308, 375, 251, 124, 
1996, Appalachian St. (NC), 7, 4, 0, 0.63636, 223, 196, 27, 
1997, Appalachian St. (NC), 7, 4, 0, 0.63636, 294, 215, 79, 
1998, Appalachian St. (NC), 10, 3, 0, 0.76923, 356, 222, 134, 
1999, Appalachian St. (NC), 9, 3, 0, 0.75000, 369, 219, 150, 
2000, Appalachian St. (NC), 10, 4, 0, 0.71429, 441, 278, 163, 
2001, Appalachian St. (NC), 9, 4, 0, 0.69231, 411, 278, 133, 
2002, Appalachian St. (NC), 8, 4, 0, 0.66667, 314, 273, 41, 
2003, Appalachian St. (NC), 7, 4, 0, 0.63636, 252, 219, 33, 
2004, Appalachian St. (NC), 6, 5, 0, 0.54545, 366, 358, 8, 
2005, Appalachian St. (NC), 12, 3, 0, 0.80000, 455, 282, 173, 
2006, Appalachian St. (NC), 14, 1, 0, 0.93333, 528, 223, 305, 
2007, Appalachian St. (NC), 13, 2, 0, 0.86667, 641, 400, 241, 
2008, Appalachian St. (NC), 11, 3, 0, 0.78571, 522, 303, 219, 
2009, Appalachian St. (NC), 11, 3, 0, 0.78571, 465, 313, 152, 
2010, Appalachian St. (NC), 10, 3, 0, 0.76923, 446, 307, 139, 
2011, Appalachian St. (NC), 8, 4, 0, 0.66667, 344, 286, 58, 
2012, Appalachian St. (NC), 8, 4, 0, 0.66667, 395, 352, 43, 
1941, Murray St. (KY), 4, 3, 2, 0.55556, 133, 58, 75, 
1946, Murray St. (KY), 5, 5, 0, 0.50000, 196, 227, -31, 
1947, Murray St. (KY), 6, 3, 0, 0.66667, 133, 117, 16, 
1953, Arkansas-Pine Bluff, 3, 5, 2, 0.40000, 125, 192, -67, 
1954, Arkansas-Pine Bluff, 2, 7, 2, 0.27273, 99, 199, -100, 
1955, Arkansas-Pine Bluff, 2, 8, 0, 0.20000, 72, 241, -169, 
1995, Lake Forest (IL), 0, 9, 0, 0.00000, 191, 316, -125, 
1996, Lake Forest (IL), 2, 7, 0, 0.22222, 223, 288, -65, 
1997, Lake Forest (IL), 2, 7, 0, 0.22222, 188, 261, -73, 
1998, Lake Forest (IL), 4, 6, 0, 0.40000, 250, 211, 39, 
1999, Lake Forest (IL), 5, 5, 0, 0.50000, 267, 255, 12, 
2013, Hiram (OH), 2, 8, 0, 0.20000, 143, 331, -188, 
1956, South Carolina St., 5, 4, 0, 0.55556, 169, 113, 56, 
1957, South Carolina St., 5, 2, 1, 0.68750, 158, 41, 117, 
1958, South Carolina St., 7, 2, 0, 0.77778, 235, 74, 161, 
1959, South Carolina St., 3, 5, 0, 0.37500, 88, 191, -103, 
1961, Delaware St., 6, 3, 0, 0.66667, 144, 117, 27, 
1962, Delaware St., 4, 5, 0, 0.44444, 112, 152, -40, 
1963, Delaware St., 2, 5, 1, 0.31250, 103, 204, -101, 
1964, Delaware St., 3, 7, 0, 0.30000, 126, 172, -46, 
1943, Hampton (VA), 4, 2, 0, 0.66667, 97, 22, 75, 
1944, Hampton (VA), 1, 5, 1, 0.21429, 25, 166, -141, 
1979, Gardner-Webb (NC), 2, 9, 0, 0.18182, 276, 314, -38, 
1980, Gardner-Webb (NC), 3, 7, 0, 0.30000, 125, 191, -66, 
1981, Gardner-Webb (NC), 5, 5, 0, 0.50000, 208, 262, -54, 
1982, Gardner-Webb (NC), 7, 3, 0, 0.70000, 311, 196, 115, 
1983, Citadel (SC), 3, 8, 0, 0.27273, 182, 336, -154, 
1984, Citadel (SC), 7, 4, 0, 0.63636, 240, 252, -12, 
1985, Citadel (SC), 5, 5, 1, 0.50000, 190, 236, -46, 
1986, Citadel (SC), 3, 8, 0, 0.27273, 155, 323, -168, 
1907, Kentucky Wesleyan, 1, 2, 0, 0.33333, 5, 24, -19, 
1908, Kentucky Wesleyan, 1, 1, 0, 0.50000, 17, 12, 5, 
1909, Kentucky Wesleyan, 4, 3, 2, 0.55556, 91, 84, 7, 
1901, Kansas St., 3, 4, 1, 0.43750, 65, 87, -22, 
1910, Hamilton (NY), 1, 4, 1, 0.25000, 22, 39, -17, 
1951, Shepherd (WV), 3, 5, 0, 0.37500, 89, 196, -107, 
1952, Shepherd (WV), 5, 3, 1, 0.61111, 86, 93, -7, 
1959, Central Connecticut St., 2, 4, 1, 0.35714, 58, 133, -75, 
1960, Central Connecticut St., 4, 5, 0, 0.44444, 108, 190, -82, 
1961, Central Connecticut St., 3, 6, 0, 0.33333, 109, 183, -74, 
1954, Allegheny (PA), 2, 6, 0, 0.25000, 90, 218, -128, 
1955, Allegheny (PA), 2, 6, 0, 0.25000, 79, 229, -150, 
1956, Allegheny (PA), 4, 3, 1, 0.56250, 142, 175, -33, 
1957, Allegheny (PA), 3, 4, 1, 0.43750, 101, 104, -3, 
2009, Kentucky Christian, 1, 10, 0, 0.09091, 167, 464, -297, 
2010, Kentucky Christian, 0, 11, 0, 0.00000, 199, 527, -328, 
1907, Pittsburgh (PA), 8, 2, 0, 0.80000, 147, 27, 120, 
2012, Fordham (NY), 6, 5, 0, 0.54545, 343, 309, 34, 
2013, Fordham (NY), 12, 2, 0, 0.85714, 526, 355, 171, 
2003, Cal St.-Sacramento, 2, 9, 0, 0.18182, 237, 332, -95, 
2004, Cal St.-Sacramento, 3, 8, 0, 0.27273, 190, 415, -225, 
2005, Cal St.-Sacramento, 2, 9, 0, 0.18182, 192, 352, -160, 
2006, Cal St.-Sacramento, 4, 7, 0, 0.36364, 168, 288, -120, 
2012, UCLA, 9, 5, 0, 0.64286, 482, 386, 96, 
2013, UCLA, 10, 3, 0, 0.76923, 480, 301, 179, 
1909, Texas A&M;, 6, 0, 0, 1.00000, 113, 14, 99, 
1910, Texas A&M;, 8, 1, 0, 0.88889, 203, 24, 179, 
1911, Texas A&M;, 6, 1, 0, 0.85714, 134, 17, 117, 
1912, Texas A&M;, 8, 1, 0, 0.88889, 366, 26, 340, 
1913, Texas A&M;, 3, 4, 2, 0.44444, 53, 76, -23, 
1914, Texas A&M;, 6, 1, 1, 0.81250, 205, 33, 172, 
1924, Bucknell (PA), 8, 2, 0, 0.80000, 168, 64, 104, 
1925, Bucknell (PA), 7, 3, 1, 0.68182, 138, 57, 81, 
1926, Bucknell (PA), 4, 5, 1, 0.45000, 114, 115, -1, 
1930, Catawba (NC), 8, 0, 1, 0.94444, 286, 19, 267, 
1931, Catawba (NC), 7, 3, 1, 0.68182, 153, 58, 95, 
1932, Catawba (NC), 6, 2, 1, 0.72222, 106, 49, 57, 
1933, Catawba (NC), 2, 5, 2, 0.33333, 73, 81, -8, 
1943, South Carolina, 5, 2, 0, 0.71429, 118, 56, 62, 
1922, Carson-Newman (TN), 7, 3, 0, 0.70000, 312, 124, 188, 
1923, Carson-Newman (TN), 3, 2, 2, 0.57143, 75, 20, 55, 
1921, Middlebury (VT), 4, 4, 0, 0.50000, 60, 86, -26, 
1922, Middlebury (VT), 2, 6, 0, 0.25000, 39, 137, -98, 
1923, Middlebury (VT), 3, 3, 2, 0.50000, 105, 55, 50, 
1924, Middlebury (VT), 7, 1, 0, 0.87500, 254, 44, 210, 
1925, Auburn (AL), 5, 3, 1, 0.61111, 81, 114, -33, 
1926, Auburn (AL), 5, 4, 0, 0.55556, 122, 85, 37, 
1927, Auburn (AL), 0, 3, 0, 0.00000, 6, 42, -36, 
1936, Pittsburg St. (KS), 3, 5, 0, 0.37500, 64, 124, -60, 
1938, Pittsburg St. (KS), 4, 4, 2, 0.50000, 74, 106, -32, 
1939, Pittsburg St. (KS), 3, 4, 2, 0.44444, 95, 87, 8, 
1940, Pittsburg St. (KS), 3, 7, 0, 0.30000, 119, 137, -18, 
1941, Pittsburg St. (KS), 5, 2, 3, 0.65000, 97, 64, 33, 
1942, Pittsburg St. (KS), 7, 1, 0, 0.87500, 115, 33, 82, 
1943, Pittsburg St. (KS), 6, 0, 0, 1.00000, 166, 28, 138, 
1944, Pittsburg St. (KS), 3, 3, 0, 0.50000, 73, 78, -5, 
1945, Pittsburg St. (KS), 2, 2, 2, 0.50000, 68, 109, -41, 
1946, Pittsburg St. (KS), 4, 2, 3, 0.61111, 72, 46, 26, 
1947, Pittsburg St. (KS), 2, 7, 1, 0.25000, 71, 120, -49, 
1948, Pittsburg St. (KS), 2, 6, 2, 0.30000, 137, 149, -12, 
1941, Texas Tech, 9, 2, 0, 0.81818, 226, 36, 190, 
1942, Texas Tech, 4, 5, 1, 0.45000, 111, 87, 24, 
1943, Texas Tech, 4, 6, 0, 0.40000, 128, 177, -49, 
1944, Texas Tech, 4, 7, 0, 0.36364, 134, 170, -36, 
1945, Texas Tech, 3, 5, 2, 0.40000, 63, 145, -82, 
1946, Texas Tech, 8, 3, 0, 0.72727, 148, 116, 32, 
1947, Texas Tech, 6, 5, 0, 0.54545, 184, 228, -44, 
1948, Texas Tech, 7, 3, 0, 0.70000, 212, 135, 77, 
1949, Texas Tech, 7, 5, 0, 0.58333, 187, 184, 3, 
1950, Texas Tech, 3, 8, 0, 0.27273, 222, 241, -19, 
2013, Trinity Bible (ND), 1, 11, 0, 0.08333, 148, 411, -263, 
2002, Fort Valley St. (GA), 7, 4, 0, 0.63636, 253, 183, 70, 
2003, Fort Valley St. (GA), 7, 4, 0, 0.63636, 280, 194, 86, 
2004, Fort Valley St. (GA), 8, 3, 0, 0.72727, 362, 190, 172, 
2005, Fort Valley St. (GA), 7, 3, 0, 0.70000, 223, 207, 16, 
2010, Mississippi Valley St., 0, 10, 0, 0.00000, 103, 363, -260, 
2011, Mississippi Valley St., 1, 10, 0, 0.09091, 150, 333, -183, 
2012, Mississippi Valley St., 5, 6, 0, 0.45455, 187, 207, -20, 
2013, Mississippi Valley St., 2, 9, 0, 0.18182, 203, 310, -107, 
1926, Susquehanna (PA), 4, 6, 0, 0.40000, 79, 209, -130, 
1927, Susquehanna (PA), 3, 6, 0, 0.33333, 71, 232, -161, 
1929, Lock Haven (PA), 2, 5, 0, 0.28571, 54, 81, -27, 
1930, Lock Haven (PA), 7, 1, 0, 0.87500, 217, 45, 172, 
1931, Lock Haven (PA), 12, 3, 3, 0.75000, 345, 106, 239, 
1894, Notre Dame (IN), 3, 1, 1, 0.70000, 80, 31, 49, 
1902, Columbia (NY), 6, 4, 1, 0.59091, 163, 101, 62, 
1903, Columbia (NY), 9, 1, 0, 0.90000, 148, 43, 105, 
1904, Columbia (NY), 7, 3, 0, 0.70000, 120, 68, 52, 
1905, Columbia (NY), 4, 3, 2, 0.55556, 77, 109, -32, 
2013, Montana Tech, 3, 7, 0, 0.30000, 210, 270, -60, 
1924, Abilene Christian (TX), 3, 4, 2, 0.44444, 82, 66, 16, 
1925, Abilene Christian (TX), 2, 5, 2, 0.33333, 65, 121, -56, 
1926, Abilene Christian (TX), 4, 4, 0, 0.50000, 81, 111, -30, 
1927, Abilene Christian (TX), 6, 1, 1, 0.81250, 101, 25, 76, 
1928, Abilene Christian (TX), 5, 4, 0, 0.55556, 90, 100, -10, 
1929, Abilene Christian (TX), 6, 1, 1, 0.81250, 104, 48, 56, 
1930, Abilene Christian (TX), 2, 7, 1, 0.25000, 93, 215, -122, 
1931, Abilene Christian (TX), 4, 5, 0, 0.44444, 99, 83, 16, 
1932, Abilene Christian (TX), 2, 6, 1, 0.27778, 37, 85, -48, 
1933, Abilene Christian (TX), 5, 3, 2, 0.60000, 62, 57, 5, 
1934, Abilene Christian (TX), 1, 7, 2, 0.20000, 52, 123, -71, 
1935, Abilene Christian (TX), 1, 6, 3, 0.25000, 52, 142, -90, 
1936, Abilene Christian (TX), 1, 7, 1, 0.16667, 39, 171, -132, 
1937, Abilene Christian (TX), 0, 9, 0, 0.00000, 39, 118, -79, 
1938, Abilene Christian (TX), 6, 2, 1, 0.72222, 102, 31, 71, 
1939, Abilene Christian (TX), 6, 2, 1, 0.72222, 106, 50, 56, 
1940, Abilene Christian (TX), 7, 2, 0, 0.77778, 112, 44, 68, 
1941, Abilene Christian (TX), 6, 3, 0, 0.66667, 139, 103, 36, 
1981, Cameron (OK), 5, 5, 0, 0.50000, 332, 153, 179, 
1982, Cameron (OK), 4, 5, 0, 0.44444, 152, 220, -68, 
1983, Cameron (OK), 3, 6, 0, 0.33333, 166, 201, -35, 
1893, Wisconsin-Oshkosh, 0, 1, 0, 0.00000, 0, 48, -48, 
1894, Wisconsin-Oshkosh, 1, 2, 0, 0.33333, 30, 98, -68, 
1895, Wisconsin-Oshkosh, 1, 1, 0, 0.50000, 24, 22, 2, 
1896, Wisconsin-Oshkosh, 2, 4, 0, 0.33333, 48, 88, -40, 
2013, Nebraska-Kearney, 3, 8, 0, 0.27273, 211, 387, -176, 
1907, Idaho St., 6, 3, 0, 0.66667, 187, 41, 146, 
1908, Idaho St., 2, 2, 0, 0.50000, 42, 26, 16, 
1993, Worcester Tech (MA), 5, 4, 0, 0.55556, 204, 227, -23, 
1994, Worcester Tech (MA), 5, 4, 0, 0.55556, 239, 191, 48, 
1995, Worcester Tech (MA), 4, 5, 0, 0.44444, 120, 172, -52, 
1996, Worcester Tech (MA), 2, 8, 0, 0.20000, 118, 287, -169, 
1997, Worcester Tech (MA), 4, 6, 0, 0.40000, 190, 257, -67, 
1998, Worcester Tech (MA), 4, 5, 0, 0.44444, 198, 229, -31, 
2009, Massachusetts, 5, 6, 0, 0.45455, 295, 244, 51, 
2010, Massachusetts, 6, 5, 0, 0.54545, 292, 277, 15, 
2011, Massachusetts, 5, 6, 0, 0.45455, 277, 307, -30, 
1896, Lehigh (PA), 2, 5, 0, 0.28571, 80, 130, -50, 
1981, Morgan St. (MD), 4, 5, 0, 0.44444, 165, 192, -27, 
1982, Morgan St. (MD), 4, 7, 0, 0.36364, 195, 267, -72, 
1918, Boston College (MA), 5, 2, 0, 0.71429, 142, 35, 107, 
1901, Virginia Tech, 6, 1, 0, 0.85714, 115, 33, 82, 
1898, South Dakota, 1, 1, 1, 0.50000, 27, 32, -5, 
1899, South Dakota, 4, 1, 1, 0.75000, 60, 18, 42, 
1898, Texas Christian, 1, 3, 1, 0.30000, 41, 61, -20, 
1899, Virginia Tech, 4, 1, 0, 0.80000, 106, 28, 78, 
1920, Howard (DC), 7, 0, 0, 1.00000, 132, 0, 132, 
1921, Howard (DC), 7, 1, 0, 0.87500, 165, 13, 152, 
1922, Howard (DC), 4, 2, 0, 0.66667, 121, 38, 83, 
1924, Howard (DC), 1, 2, 3, 0.41667, 14, 34, -20, 
1928, Howard (DC), 6, 1, 2, 0.77778, 97, 35, 62, 
1915, Southern Methodist (TX), 2, 5, 0, 0.28571, 20, 131, -111, 
1916, Southern Methodist (TX), 0, 8, 2, 0.10000, 27, 455, -428, 
1918, Vanderbilt (TN), 4, 2, 0, 0.66667, 176, 31, 145, 
1924, Southern Methodist (TX), 5, 1, 4, 0.70000, 92, 62, 30, 
1925, Southern Methodist (TX), 5, 2, 2, 0.66667, 148, 41, 107, 
1926, Southern Methodist (TX), 8, 0, 1, 0.94444, 229, 47, 182, 
1927, Southern Methodist (TX), 7, 2, 0, 0.77778, 267, 81, 186, 
1928, Southern Methodist (TX), 6, 3, 1, 0.65000, 254, 78, 176, 
1929, Southern Methodist (TX), 6, 0, 4, 0.80000, 172, 36, 136, 
1930, Southern Methodist (TX), 6, 3, 1, 0.65000, 187, 93, 94, 
1931, Southern Methodist (TX), 9, 1, 1, 0.86364, 160, 48, 112, 
1932, Southern Methodist (TX), 3, 7, 2, 0.33333, 82, 112, -30, 
1933, Southern Methodist (TX), 4, 7, 1, 0.37500, 99, 104, -5, 
1934, Southern Methodist (TX), 8, 2, 2, 0.75000, 224, 63, 161, 
1935, Vanderbilt (TN), 7, 3, 0, 0.70000, 179, 68, 111, 
1936, Vanderbilt (TN), 3, 5, 1, 0.38889, 115, 87, 28, 
1937, Vanderbilt (TN), 7, 2, 0, 0.77778, 121, 42, 79, 
1938, Vanderbilt (TN), 6, 3, 0, 0.66667, 86, 49, 37, 
1939, Vanderbilt (TN), 2, 7, 1, 0.25000, 96, 165, -69, 
1940, Temple (PA), 4, 4, 1, 0.50000, 155, 113, 42, 
1941, Temple (PA), 7, 2, 0, 0.77778, 176, 146, 30, 
1942, Temple (PA), 2, 5, 3, 0.35000, 48, 135, -87, 
1943, Temple (PA), 2, 6, 0, 0.25000, 65, 163, -98, 
1944, Temple (PA), 2, 4, 2, 0.37500, 93, 96, -3, 
1945, Temple (PA), 7, 1, 0, 0.87500, 198, 51, 147, 
1946, Temple (PA), 2, 4, 2, 0.37500, 61, 114, -53, 
1947, Temple (PA), 3, 6, 0, 0.33333, 91, 128, -37, 
1948, Temple (PA), 2, 6, 1, 0.27778, 95, 182, -87, 
1973, Tennessee-Chattanooga, 4, 7, 0, 0.36364, 131, 241, -110, 
1974, Tennessee-Chattanooga, 4, 7, 0, 0.36364, 181, 252, -71, 
1975, Tennessee-Chattanooga, 5, 5, 1, 0.50000, 176, 195, -19, 
1976, Tennessee-Chattanooga, 6, 4, 1, 0.59091, 232, 205, 27, 
1977, Tennessee-Chattanooga, 9, 1, 1, 0.86364, 265, 167, 98, 
1978, Tennessee-Chattanooga, 7, 3, 1, 0.68182, 306, 192, 114, 
1979, Tennessee-Chattanooga, 9, 2, 0, 0.81818, 349, 217, 132, 
1980, New Mexico, 4, 7, 0, 0.36364, 246, 364, -118, 
1981, New Mexico, 4, 7, 1, 0.37500, 225, 231, -6, 
1982, New Mexico, 10, 1, 0, 0.90909, 374, 225, 149, 
1983, South Carolina, 5, 6, 0, 0.45455, 231, 237, -6, 
1984, South Carolina, 10, 2, 0, 0.83333, 371, 258, 113, 
1985, South Carolina, 5, 6, 0, 0.45455, 269, 290, -21, 
1986, South Carolina, 3, 6, 2, 0.36364, 313, 286, 27, 
1987, South Carolina, 8, 4, 0, 0.66667, 341, 141, 200, 
1988, South Carolina, 8, 4, 0, 0.66667, 232, 224, 8, 
1901, South Dakota St., 3, 3, 0, 0.50000, 100, 50, 50, 
1962, Southwestern (KS), 5, 5, 0, 0.50000, 192, 172, 20, 
1963, Southwestern (KS), 6, 4, 0, 0.60000, 221, 119, 102, 
1897, Wichita St. (KS), 1, 0, 0, 1.00000, 12, 4, 8, 
2001, Kentucky, 2, 9, 0, 0.18182, 259, 367, -108, 
2002, Kentucky, 7, 5, 0, 0.58333, 385, 301, 84, 
2003, Baylor (TX), 3, 9, 0, 0.25000, 191, 455, -264, 
2004, Baylor (TX), 3, 8, 0, 0.27273, 224, 406, -182, 
2005, Baylor (TX), 5, 6, 0, 0.45455, 236, 291, -55, 
2006, Baylor (TX), 4, 8, 0, 0.33333, 283, 391, -108, 
2007, Baylor (TX), 3, 9, 0, 0.25000, 218, 444, -226, 
1920, George Washington (DC), 1, 6, 1, 0.18750, 37, 290, -253, 
1895, Willamette (OR), 2, 2, 0, 0.50000, 84, 26, 58, 
1899, Idaho, 0, 4, 0, 0.00000, 6, 29, -23, 
1974, Bemidji St. (MN), 2, 7, 0, 0.22222, 160, 290, -130, 
1900, Colorado, 6, 4, 0, 0.60000, 150, 78, 72, 
1901, Alma (MI), 3, 2, 0, 0.60000, 28, 33, -5, 
1942, Southeastern Louisiana, 5, 5, 0, 0.50000, 242, 152, 90, 
1947, Virginia Military Institute, 3, 5, 1, 0.38889, 120, 152, -32, 
1948, Virginia Military Institute, 6, 3, 0, 0.66667, 184, 116, 68, 
1949, Mississippi St., 0, 8, 1, 0.05556, 38, 224, -186, 
1950, Mississippi St., 4, 5, 0, 0.44444, 169, 137, 32, 
1951, Mississippi St., 4, 5, 0, 0.44444, 82, 127, -45, 
1979, North Dakota St., 6, 4, 0, 0.60000, 217, 164, 53, 
1980, North Dakota St., 6, 4, 0, 0.60000, 204, 163, 41, 
1981, North Dakota St., 10, 3, 0, 0.76923, 322, 185, 137, 
1982, North Dakota St., 12, 1, 0, 0.92308, 294, 130, 164, 
1983, North Dakota St., 12, 1, 0, 0.92308, 326, 171, 155, 
1984, North Dakota St., 11, 2, 0, 0.84615, 463, 225, 238, 
1985, Tulsa (OK), 6, 5, 0, 0.54545, 274, 328, -54, 
1986, Tulsa (OK), 7, 4, 0, 0.63636, 293, 186, 107, 
1987, Wisconsin, 3, 8, 0, 0.27273, 202, 299, -97, 
1988, Wisconsin, 1, 10, 0, 0.09091, 106, 314, -208, 
1989, Wisconsin, 2, 9, 0, 0.18182, 172, 341, -169, 
1956, Toledo (OH), 1, 7, 1, 0.16667, 118, 250, -132, 
1934, Alcorn St. (MS), 2, 2, 1, 0.50000, 13, 24, -11, 
1935, Alcorn St. (MS), 3, 5, 0, 0.37500, 65, 101, -36, 
2002, Fairleigh Dickinson-Madison (NJ), 2, 8, 0, 0.20000, 200, 334, -134, 
2003, Fairleigh Dickinson-Madison (NJ), 1, 9, 0, 0.10000, 92, 240, -148, 
2004, Fairleigh Dickinson-Madison (NJ), 4, 6, 0, 0.40000, 167, 257, -90, 
2005, Fairleigh Dickinson-Madison (NJ), 4, 6, 0, 0.40000, 235, 346, -111, 
2006, Fairleigh Dickinson-Madison (NJ), 2, 8, 0, 0.20000, 192, 260, -68, 
2007, Fairleigh Dickinson-Madison (NJ), 2, 8, 0, 0.20000, 124, 282, -158, 
2008, Fairleigh Dickinson-Madison (NJ), 3, 7, 0, 0.30000, 175, 274, -99, 
2009, Fairleigh Dickinson-Madison (NJ), 2, 8, 0, 0.20000, 233, 348, -115, 
2010, Fairleigh Dickinson-Madison (NJ), 3, 7, 0, 0.30000, 197, 314, -117, 
1951, Virginia Tech, 2, 8, 0, 0.20000, 105, 311, -206, 
1952, Virginia Tech, 5, 6, 0, 0.45455, 155, 221, -66, 
1953, Virginia Tech, 5, 5, 0, 0.50000, 142, 124, 18, 
1954, Virginia Tech, 8, 0, 1, 0.94444, 198, 75, 123, 
1955, Virginia Tech, 6, 3, 1, 0.65000, 191, 133, 58, 
1956, Virginia Tech, 7, 2, 1, 0.75000, 264, 98, 166, 
1957, Virginia Tech, 4, 6, 0, 0.40000, 114, 148, -34, 
1958, Virginia Tech, 5, 4, 1, 0.55000, 165, 196, -31, 
1959, Virginia Tech, 6, 4, 0, 0.60000, 222, 178, 44, 
1960, Virginia Tech, 6, 4, 0, 0.60000, 173, 103, 70, 
1916, Wofford (SC), 2, 7, 0, 0.22222, 63, 222, -159, 
1917, Wofford (SC), 5, 4, 0, 0.55556, 151, 114, 37, 
1902, Willamette (OR), 1, 4, 2, 0.28571, 18, 149, -131, 
1897, Monmouth (IL), 7, 4, 0, 0.63636, 166, 153, 13, 
1914, Baylor (TX), 3, 5, 2, 0.40000, 70, 159, -89, 
1915, Baylor (TX), 7, 1, 0, 0.87500, 188, 22, 166, 
1916, Baylor (TX), 9, 1, 0, 0.90000, 315, 27, 288, 
1917, Baylor (TX), 6, 2, 1, 0.72222, 221, 41, 180, 
1918, Baylor (TX), 0, 6, 0, 0.00000, 19, 92, -73, 
1919, Baylor (TX), 5, 3, 1, 0.61111, 146, 73, 73, 
1976, Texas Southern, 2, 9, 0, 0.18182, 184, 290, -106, 
1977, Texas Southern, 6, 4, 1, 0.59091, 292, 191, 101, 
1978, Texas Southern, 3, 7, 1, 0.31818, 131, 214, -83, 
1959, Florida St., 4, 6, 0, 0.40000, 149, 132, 17, 
1968, Marshall (WV), 0, 9, 1, 0.05000, 129, 358, -229, 
1899, Central Missouri St., 6, 1, 0, 0.85714, 130, 28, 102, 
1902, Central Missouri St., 6, 3, 0, 0.66667, 193, 55, 138, 
1903, Pittsburgh (PA), 0, 9, 1, 0.05000, 26, 271, -245, 
1904, Pittsburgh (PA), 10, 0, 0, 1.00000, 406, 5, 401, 
1905, Pittsburgh (PA), 10, 2, 0, 0.83333, 405, 36, 369, 
1912, Kansas, 4, 4, 0, 0.50000, 128, 45, 83, 
1913, Kansas, 5, 3, 0, 0.62500, 120, 40, 80, 
1940, Northern Arizona, 2, 6, 0, 0.25000, 92, 180, -88, 
1941, Northern Arizona, 3, 5, 0, 0.37500, 119, 143, -24, 
1942, Northern Arizona, 1, 5, 0, 0.16667, 18, 93, -75, 
1943, New Mexico St., 4, 0, 0, 1.00000, 107, 20, 87, 
1891, Minnesota, 3, 1, 1, 0.70000, 102, 46, 56, 
1900, Kansas St., 2, 4, 0, 0.33333, 47, 100, -53, 
1981, DePauw (IN), 9, 1, 0, 0.90000, 234, 111, 123, 
1982, DePauw (IN), 8, 2, 0, 0.80000, 330, 120, 210, 
1983, DePauw (IN), 7, 3, 0, 0.70000, 221, 113, 108, 
1984, DePauw (IN), 6, 4, 0, 0.60000, 267, 162, 105, 
1985, DePauw (IN), 8, 2, 0, 0.80000, 283, 133, 150, 
1986, DePauw (IN), 6, 4, 0, 0.60000, 234, 144, 90, 
1987, DePauw (IN), 7, 3, 0, 0.70000, 262, 204, 58, 
1988, DePauw (IN), 4, 5, 0, 0.44444, 228, 198, 30, 
1989, DePauw (IN), 6, 2, 2, 0.70000, 237, 166, 71, 
1990, DePauw (IN), 8, 2, 0, 0.80000, 311, 138, 173, 
1991, DePauw (IN), 6, 4, 0, 0.60000, 208, 154, 54, 
1992, DePauw (IN), 4, 4, 2, 0.50000, 209, 208, 1, 
1993, DePauw (IN), 2, 8, 0, 0.20000, 149, 302, -153, 
1994, DePauw (IN), 2, 8, 0, 0.20000, 148, 253, -105, 
1995, DePauw (IN), 3, 7, 0, 0.30000, 184, 188, -4, 
1996, DePauw (IN), 9, 1, 0, 0.90000, 288, 183, 105, 
1997, DePauw (IN), 8, 2, 0, 0.80000, 202, 129, 73, 
1998, DePauw (IN), 7, 3, 0, 0.70000, 259, 157, 102, 
1999, DePauw (IN), 5, 5, 0, 0.50000, 202, 208, -6, 
2000, DePauw (IN), 6, 4, 0, 0.60000, 231, 177, 54, 
2001, DePauw (IN), 5, 5, 0, 0.50000, 298, 256, 42, 
2002, DePauw (IN), 7, 3, 0, 0.70000, 307, 232, 75, 
2003, DePauw (IN), 5, 5, 0, 0.50000, 292, 235, 57, 
1890, Hamilton (NY), 4, 4, 0, 0.50000, 131, 84, 47, 
1903, Willamette (OR), 3, 2, 2, 0.57143, 85, 42, 43, 
1906, Franklin & Marshall (PA), 3, 5, 1, 0.38889, 40, 114, -74, 
1891, Lafayette (PA), 2, 9, 1, 0.20833, 86, 161, -75, 
1892, Lafayette (PA), 5, 7, 0, 0.41667, 126, 139, -13, 
1893, Dartmouth (NH), 5, 3, 0, 0.62500, 102, 90, 12, 
1894, Dartmouth (NH), 5, 4, 0, 0.55556, 114, 80, 34, 
1895, Brown (RI), 7, 6, 1, 0.53571, 150, 109, 41, 
1896, Brown (RI), 4, 5, 1, 0.45000, 126, 94, 32, 
1897, Brown (RI), 7, 4, 0, 0.63636, 180, 152, 28, 
1959, Adams St. (CO), 8, 1, 0, 0.88889, 217, 111, 106, 
1960, Adams St. (CO), 7, 0, 1, 0.93750, 233, 76, 157, 
1961, Adams St. (CO), 8, 2, 0, 0.80000, 203, 119, 84, 
1962, Adams St. (CO), 9, 1, 0, 0.90000, 207, 124, 83, 
1963, North Dakota St., 3, 5, 0, 0.37500, 174, 164, 10, 
1964, North Dakota St., 10, 1, 0, 0.90909, 252, 121, 131, 
1965, North Dakota St., 11, 0, 0, 1.00000, 383, 87, 296, 
1967, Arizona, 3, 6, 1, 0.35000, 162, 231, -69, 
1968, Arizona, 8, 3, 0, 0.72727, 186, 149, 37, 
1969, Western Illinois, 8, 2, 0, 0.80000, 311, 162, 149, 
1970, Western Illinois, 7, 3, 0, 0.70000, 308, 183, 125, 
1971, Western Illinois, 8, 2, 0, 0.80000, 213, 158, 55, 
1972, Western Illinois, 9, 2, 0, 0.81818, 272, 191, 81, 
1973, Western Illinois, 7, 4, 0, 0.63636, 258, 187, 71, 
1974, Florida St., 1, 10, 0, 0.09091, 130, 289, -159, 
1975, Florida St., 3, 8, 0, 0.27273, 187, 213, -26, 
1978, Eastern Illinois, 12, 2, 0, 0.85714, 454, 253, 201, 
1979, Eastern Illinois, 7, 4, 0, 0.63636, 302, 170, 132, 
1980, Eastern Illinois, 11, 3, 0, 0.78571, 441, 238, 203, 
1981, Eastern Illinois, 6, 5, 0, 0.54545, 250, 228, 22, 
1982, Eastern Illinois, 11, 1, 1, 0.88462, 338, 130, 208, 
1983, Northern Iowa, 6, 5, 0, 0.54545, 228, 248, -20, 
1984, Northern Iowa, 9, 2, 0, 0.81818, 366, 169, 197, 
1985, Northern Iowa, 11, 2, 0, 0.84615, 392, 212, 180, 
1986, Northern Iowa, 7, 3, 1, 0.68182, 347, 221, 126, 
1987, Northern Iowa, 10, 4, 0, 0.71429, 463, 305, 158, 
1923, Northern Illinois, 1, 4, 3, 0.31250, 73, 170, -97, 
1924, Northern Illinois, 4, 4, 0, 0.50000, 156, 85, 71, 
1925, Northern Illinois, 6, 1, 0, 0.85714, 52, 5, 47, 
1920, Creighton (NE), 1, 6, 1, 0.18750, 61, 83, -22, 
1919, Butler (IN), 0, 5, 1, 0.08333, 7, 184, -177, 
1951, Appalachian St. (NC), 6, 3, 0, 0.66667, 128, 87, 41, 
1959, Catawba (NC), 2, 7, 1, 0.25000, 98, 254, -156, 
1960, Catawba (NC), 2, 9, 0, 0.18182, 83, 270, -187, 
1961, Catawba (NC), 3, 7, 0, 0.30000, 98, 181, -83, 
1918, Gonzaga (WA), 0, 2, 1, 0.16667, 25, 40, -15, 
2009, Mississippi St., 5, 7, 0, 0.41667, 307, 321, -14, 
2010, Mississippi St., 9, 4, 0, 0.69231, 377, 258, 119, 
2011, Mississippi St., 7, 6, 0, 0.53846, 329, 256, 73, 
2012, Mississippi St., 8, 5, 0, 0.61538, 383, 303, 80, 
2013, Mississippi St., 7, 6, 0, 0.53846, 360, 299, 61, 
1899, Fordham (NY), 3, 1, 0, 0.75000, 57, 17, 40, 
1915, Davis & Elkins (WV), 8, 2, 0, 0.80000, 234, 96, 138, 
1908, Hardin-Simmons (TX), 5, 2, 0, 0.71429, 74, 53, 21, 
1909, Hardin-Simmons (TX), 7, 1, 0, 0.87500, 158, 31, 127, 
1997, Arkansas Tech, 4, 7, 0, 0.36364, 251, 409, -158, 
1998, Arkansas Tech, 5, 5, 0, 0.50000, 286, 261, 25, 
1999, Arkansas Tech, 9, 3, 0, 0.75000, 354, 248, 106, 
2000, Arkansas Tech, 7, 3, 0, 0.70000, 336, 256, 80, 
2001, Arkansas Tech, 8, 2, 0, 0.80000, 287, 189, 98, 
2002, Arkansas Tech, 4, 7, 0, 0.36364, 161, 253, -92, 
2003, Arkansas Tech, 5, 6, 0, 0.45455, 202, 270, -68, 
2004, Arkansas Tech, 10, 2, 0, 0.83333, 387, 272, 115, 
2005, Arkansas Tech, 7, 3, 0, 0.70000, 280, 295, -15, 
2006, Arkansas Tech, 7, 3, 0, 0.70000, 259, 267, -8, 
2007, Arkansas Tech, 5, 5, 0, 0.50000, 317, 317, 0, 
2008, Arkansas Tech, 5, 5, 0, 0.50000, 305, 336, -31, 
2009, Arkansas Tech, 9, 3, 0, 0.75000, 489, 309, 180, 
2010, Arkansas Tech, 4, 7, 0, 0.36364, 234, 317, -83, 
2011, Arkansas Tech, 2, 8, 0, 0.20000, 213, 327, -114, 
2012, Arkansas Tech, 5, 6, 0, 0.45455, 322, 425, -103, 
1956, Colorado St., 2, 7, 1, 0.25000, 156, 314, -158, 
1957, Colorado St., 3, 7, 0, 0.30000, 109, 224, -115, 
1958, Colorado St., 6, 4, 0, 0.60000, 178, 110, 68, 
1959, Colorado St., 6, 4, 0, 0.60000, 123, 147, -24, 
1960, Colorado St., 2, 8, 0, 0.20000, 92, 240, -148, 
1961, Colorado St., 0, 10, 0, 0.00000, 74, 249, -175, 
1936, Southern (LA), 3, 5, 1, 0.38889, 151, 73, 78, 
1937, Southern (LA), 4, 4, 1, 0.50000, 130, 47, 83, 
1938, Southern (LA), 7, 1, 1, 0.83333, 162, 58, 104, 
1939, Southern (LA), 4, 5, 1, 0.45000, 133, 104, 29, 
1940, Southern (LA), 8, 1, 0, 0.88889, 182, 35, 147, 
1941, Southern (LA), 5, 4, 1, 0.55000, 148, 141, 7, 
1942, Southern (LA), 4, 4, 1, 0.50000, 169, 84, 85, 
1944, Southern (LA), 4, 3, 0, 0.57143, 130, 92, 38, 
1945, Southern (LA), 6, 3, 1, 0.65000, 195, 111, 84, 
1946, Southern (LA), 9, 2, 1, 0.79167, 390, 88, 302, 
1947, Southern (LA), 10, 2, 0, 0.83333, 380, 53, 327, 
1948, Southern (LA), 12, 0, 0, 1.00000, 395, 33, 362, 
1949, Southern (LA), 10, 0, 1, 0.95455, 405, 65, 340, 
1950, Southern (LA), 10, 0, 1, 0.95455, 276, 26, 250, 
1951, Southern (LA), 5, 4, 2, 0.54545, 214, 118, 96, 
1952, Southern (LA), 9, 2, 0, 0.81818, 354, 133, 221, 
1953, Southern (LA), 9, 2, 0, 0.81818, 437, 106, 331, 
1954, Southern (LA), 10, 1, 0, 0.90909, 374, 124, 250, 
1955, Southern (LA), 6, 2, 2, 0.70000, 229, 137, 92, 
1956, Southern (LA), 5, 5, 0, 0.50000, 147, 191, -44, 
1957, Southern (LA), 6, 4, 0, 0.60000, 296, 148, 148, 
1958, Southern (LA), 8, 2, 0, 0.80000, 299, 71, 228, 
1959, Southern (LA), 8, 2, 0, 0.80000, 267, 93, 174, 
1960, Southern (LA), 9, 1, 0, 0.90000, 226, 79, 147, 
1961, Southern (LA), 7, 3, 0, 0.70000, 211, 118, 93, 
1990, Southeast Missouri St., 7, 3, 0, 0.70000, 201, 180, 21, 
1991, Southeast Missouri St., 3, 8, 0, 0.27273, 213, 374, -161, 
1992, Southeast Missouri St., 2, 9, 0, 0.18182, 246, 352, -106, 
1993, Southeast Missouri St., 3, 8, 0, 0.27273, 176, 245, -69, 
1994, Southeast Missouri St., 7, 5, 0, 0.58333, 218, 229, -11, 
1995, Southeast Missouri St., 5, 6, 0, 0.45455, 243, 309, -66, 
1996, Southeast Missouri St., 3, 8, 0, 0.27273, 130, 287, -157, 
1997, Southeast Missouri St., 4, 7, 0, 0.36364, 199, 244, -45, 
1998, Southeast Missouri St., 3, 8, 0, 0.27273, 204, 295, -91, 
1999, Southeast Missouri St., 3, 8, 0, 0.27273, 245, 359, -114, 
2003, Army (NY), 0, 7, 0, 0.00000, 121, 253, -132, 
1997, Kentucky, 5, 6, 0, 0.45455, 348, 362, -14, 
1998, Kentucky, 7, 5, 0, 0.58333, 431, 375, 56, 
1999, Kentucky, 6, 6, 0, 0.50000, 328, 343, -15, 
2000, Kentucky, 2, 9, 0, 0.18182, 254, 383, -129, 
2003, Southeastern Louisiana, 5, 7, 0, 0.41667, 369, 382, -13, 
2004, Southeastern Louisiana, 7, 4, 0, 0.63636, 425, 271, 154, 
2005, New Mexico St., 0, 12, 0, 0.00000, 198, 465, -267, 
2006, New Mexico St., 4, 8, 0, 0.33333, 374, 369, 5, 
2007, New Mexico St., 4, 9, 0, 0.30769, 312, 471, -159, 
2008, New Mexico St., 3, 9, 0, 0.25000, 266, 409, -143, 
2013, LaGrange (GA), 2, 1, 0, 0.66667, 57, 25, 32, 
1937, Tennessee St., 3, 1, 1, 0.70000, 73, 9, 64, 
1938, Tennessee St., 6, 1, 0, 0.85714, 90, 9, 81, 
1939, Tennessee St., 4, 3, 1, 0.56250, 140, 72, 68, 
1938, Pennsylvania, 3, 2, 3, 0.56250, 89, 58, 31, 
1939, Pennsylvania, 4, 4, 0, 0.50000, 70, 98, -28, 
1940, Pennsylvania, 6, 1, 1, 0.81250, 247, 79, 168, 
1941, Pennsylvania, 7, 1, 0, 0.87500, 180, 55, 125, 
1942, Pennsylvania, 5, 3, 1, 0.61111, 168, 72, 96, 
1943, Pennsylvania, 6, 2, 1, 0.72222, 248, 88, 160, 
1944, Pennsylvania, 5, 3, 0, 0.62500, 165, 149, 16, 
1945, Pennsylvania, 6, 2, 0, 0.75000, 237, 88, 149, 
1946, Pennsylvania, 6, 2, 0, 0.75000, 265, 102, 163, 
1947, Pennsylvania, 7, 0, 1, 0.93750, 219, 35, 184, 
1948, Pennsylvania, 5, 3, 0, 0.62500, 169, 117, 52, 
1949, Pennsylvania, 4, 4, 0, 0.50000, 159, 118, 41, 
1950, Pennsylvania, 6, 3, 0, 0.66667, 223, 95, 128, 
1951, Pennsylvania, 5, 4, 0, 0.55556, 121, 117, 4, 
1952, Pennsylvania, 4, 3, 2, 0.55556, 122, 107, 15, 
1953, Pennsylvania, 3, 5, 1, 0.38889, 96, 152, -56, 
1946, Syracuse (NY), 4, 5, 0, 0.44444, 146, 158, -12, 
1947, Michigan St., 7, 2, 0, 0.77778, 167, 101, 66, 
1948, Michigan St., 6, 2, 2, 0.70000, 359, 130, 229, 
1949, Michigan St., 6, 3, 0, 0.66667, 309, 107, 202, 
1950, Michigan St., 8, 1, 0, 0.88889, 243, 107, 136, 
1951, Michigan St., 9, 0, 0, 1.00000, 270, 114, 156, 
1952, Michigan St., 9, 0, 0, 1.00000, 312, 84, 228, 
1953, Michigan St., 9, 1, 0, 0.90000, 240, 110, 130, 
1975, Stephen F. Austin (TX), 2, 8, 1, 0.22727, 95, 216, -121, 
1986, Westfield St. (MA), 5, 4, 0, 0.55556, 146, 112, 34, 
1987, Westfield St. (MA), 6, 3, 0, 0.66667, 203, 145, 58, 
1988, Westfield St. (MA), 5, 4, 0, 0.55556, 108, 116, -8, 
1989, Westfield St. (MA), 3, 7, 0, 0.30000, 93, 190, -97, 
1954, Glenville St. (WV), 3, 3, 1, 0.50000, 85, 78, 7, 
1955, Glenville St. (WV), 1, 7, 0, 0.12500, 75, 140, -65, 
1956, Glenville St. (WV), 2, 6, 0, 0.25000, 93, 129, -36, 
1957, Glenville St. (WV), 3, 2, 1, 0.58333, 92, 89, 3, 
1958, Glenville St. (WV), 6, 0, 1, 0.92857, 102, 26, 76, 
1959, Glenville St. (WV), 4, 3, 0, 0.57143, 60, 54, 6, 
1960, Glenville St. (WV), 5, 2, 0, 0.71429, 107, 64, 43, 
1961, Glenville St. (WV), 5, 2, 0, 0.71429, 119, 87, 32, 
2013, Norwich (VT), 7, 4, 0, 0.63636, 287, 197, 90, 
2013, Wisconsin Lutheran, 4, 6, 0, 0.40000, 287, 258, 29, 
1958, Memphis (TN), 4, 5, 0, 0.44444, 142, 144, -2, 
1959, Memphis (TN), 6, 4, 0, 0.60000, 142, 132, 10, 
1960, Memphis (TN), 8, 2, 0, 0.80000, 303, 85, 218, 
1961, Memphis (TN), 8, 2, 0, 0.80000, 332, 75, 257, 
1962, Memphis (TN), 8, 1, 0, 0.88889, 261, 67, 194, 
1963, Memphis (TN), 9, 0, 1, 0.95000, 199, 52, 147, 
1964, Memphis (TN), 5, 4, 0, 0.55556, 173, 103, 70, 
1965, Memphis (TN), 5, 5, 0, 0.50000, 215, 153, 62, 
1966, Memphis (TN), 7, 2, 0, 0.77778, 121, 96, 25, 
1967, Memphis (TN), 6, 3, 0, 0.66667, 206, 150, 56, 
1968, Memphis (TN), 6, 4, 0, 0.60000, 258, 170, 88, 
1969, Memphis (TN), 8, 2, 0, 0.80000, 328, 191, 137, 
1970, Memphis (TN), 6, 4, 0, 0.60000, 227, 184, 43, 
1971, Memphis (TN), 5, 6, 0, 0.45455, 255, 202, 53, 
1947, Middle Tennessee St., 9, 1, 0, 0.90000, 226, 61, 165, 
1948, Middle Tennessee St., 5, 5, 0, 0.50000, 93, 116, -23, 
1949, Middle Tennessee St., 8, 0, 1, 0.94444, 252, 74, 178, 
1950, Middle Tennessee St., 9, 2, 0, 0.81818, 303, 139, 164, 
1951, Middle Tennessee St., 7, 2, 2, 0.72727, 318, 106, 212, 
1952, Middle Tennessee St., 6, 5, 0, 0.54545, 214, 194, 20, 
1953, Middle Tennessee St., 7, 4, 0, 0.63636, 186, 179, 7, 
1954, Middle Tennessee St., 4, 4, 2, 0.50000, 153, 156, -3, 
1955, Middle Tennessee St., 7, 2, 1, 0.75000, 187, 205, -18, 
1956, Middle Tennessee St., 7, 3, 0, 0.70000, 202, 132, 70, 
1957, Middle Tennessee St., 10, 0, 0, 1.00000, 241, 40, 201, 
1958, Middle Tennessee St., 8, 2, 0, 0.80000, 196, 77, 119, 
1959, Middle Tennessee St., 10, 0, 1, 0.95455, 324, 93, 231, 
1960, Middle Tennessee St., 5, 5, 0, 0.50000, 115, 126, -11, 
1961, Middle Tennessee St., 7, 4, 0, 0.63636, 201, 128, 73, 
1962, Middle Tennessee St., 6, 4, 0, 0.60000, 161, 104, 57, 
1963, Middle Tennessee St., 8, 2, 0, 0.80000, 213, 106, 107, 
1964, Middle Tennessee St., 8, 2, 1, 0.77273, 156, 65, 91, 
1965, Middle Tennessee St., 10, 0, 0, 1.00000, 286, 157, 129, 
1966, Middle Tennessee St., 7, 3, 0, 0.70000, 160, 95, 65, 
1967, Middle Tennessee St., 5, 5, 0, 0.50000, 236, 231, 5, 
1968, Middle Tennessee St., 2, 8, 0, 0.20000, 146, 279, -133, 
1914, Northwestern (IL), 1, 6, 0, 0.14286, 13, 176, -163, 
1915, Northwestern (IL), 2, 5, 0, 0.28571, 69, 112, -43, 
1916, Northwestern (IL), 6, 1, 0, 0.85714, 144, 55, 89, 
1917, Northwestern (IL), 5, 2, 0, 0.71429, 145, 85, 60, 
1918, Northwestern (IL), 2, 2, 1, 0.50000, 75, 61, 14, 
1920, Denver (CO), 2, 4, 0, 0.33333, 26, 82, -56, 
1921, Denver (CO), 4, 2, 1, 0.64286, 133, 78, 55, 
1922, Denver (CO), 6, 1, 1, 0.81250, 107, 48, 59, 
1924, Kentucky, 4, 5, 0, 0.44444, 129, 99, 30, 
1925, Kentucky, 6, 3, 0, 0.66667, 92, 97, -5, 
1926, Kentucky, 2, 6, 1, 0.27778, 84, 91, -7, 
1899, Massachusetts, 7, 3, 0, 0.70000, 136, 66, 70, 
1900, Massachusetts, 8, 9, 1, 0.47222, 165, 160, 5, 
1901, Missouri, 2, 6, 1, 0.27778, 30, 155, -125, 
1978, North Dakota, 5, 5, 0, 0.50000, 245, 202, 43, 
1979, North Dakota, 10, 2, 0, 0.83333, 261, 142, 119, 
1980, Cal St.-Fullerton, 4, 7, 0, 0.36364, 230, 283, -53, 
1981, Cal St.-Fullerton, 3, 8, 0, 0.27273, 199, 272, -73, 
1982, Cal St.-Fullerton, 3, 9, 0, 0.25000, 127, 255, -128, 
1983, Cal St.-Fullerton, 7, 5, 0, 0.58333, 199, 251, -52, 
1984, Cal St.-Fullerton, 11, 1, 0, 0.91667, 337, 211, 126, 
1985, Cal St.-Fullerton, 6, 5, 0, 0.54545, 230, 281, -51, 
1986, Cal St.-Fullerton, 3, 9, 0, 0.25000, 260, 355, -95, 
1987, Cal St.-Fullerton, 6, 6, 0, 0.50000, 263, 351, -88, 
1988, Cal St.-Fullerton, 5, 6, 0, 0.45455, 219, 215, 4, 
1989, Cal St.-Fullerton, 6, 4, 1, 0.59091, 314, 279, 35, 
1990, Cal St.-Fullerton, 1, 11, 0, 0.08333, 223, 485, -262, 
1991, Cal St.-Fullerton, 2, 9, 0, 0.18182, 138, 376, -238, 
1992, Cal St.-Fullerton, 2, 9, 0, 0.18182, 136, 333, -197, 
1983, Westfield St. (MA), 2, 7, 0, 0.22222, 107, 241, -134, 
1984, Westfield St. (MA), 4, 5, 0, 0.44444, 132, 144, -12, 
1985, Westfield St. (MA), 5, 5, 0, 0.50000, 184, 154, 30, 
2003, Merrimack (MA), 6, 3, 0, 0.66667, 233, 182, 51, 
2004, Merrimack (MA), 8, 2, 0, 0.80000, 306, 186, 120, 
2005, Merrimack (MA), 4, 6, 0, 0.40000, 259, 307, -48, 
2006, Merrimack (MA), 8, 4, 0, 0.66667, 275, 250, 25, 
2007, Merrimack (MA), 4, 6, 0, 0.40000, 277, 280, -3, 
1971, Toledo (OH), 12, 0, 0, 1.00000, 383, 96, 287, 
1972, Toledo (OH), 6, 5, 0, 0.54545, 196, 210, -14, 
1973, Toledo (OH), 3, 8, 0, 0.27273, 229, 288, -59, 
1974, Toledo (OH), 6, 5, 0, 0.54545, 262, 270, -8, 
1975, Toledo (OH), 5, 6, 0, 0.45455, 244, 277, -33, 
1976, Toledo (OH), 3, 8, 0, 0.27273, 185, 232, -47, 
1894, Villanova (PA), 1, 0, 0, 1.00000, 24, 0, 24, 
2008, Saint Anselm (NH), 2, 8, 0, 0.20000, 143, 316, -173, 
2009, Saint Anselm (NH), 2, 8, 0, 0.20000, 213, 341, -128, 
2010, Saint Anselm (NH), 2, 8, 0, 0.20000, 217, 415, -198, 
2011, Saint Anselm (NH), 1, 9, 0, 0.10000, 205, 445, -240, 
2012, Saint Anselm (NH), 2, 9, 0, 0.18182, 297, 491, -194, 
2013, Saint Anselm (NH), 1, 10, 0, 0.09091, 326, 501, -175, 
1915, Kentucky Wesleyan, 2, 2, 0, 0.50000, 47, 126, -79, 
1977, Kean (NJ), 3, 6, 1, 0.35000, 91, 225, -134, 
1978, Kean (NJ), 3, 7, 0, 0.30000, 117, 225, -108, 
1979, Kean (NJ), 4, 5, 1, 0.45000, 181, 198, -17, 
1917, Johns Hopkins (MD), 1, 6, 2, 0.22222, 29, 96, -67, 
1918, Johns Hopkins (MD), 1, 1, 1, 0.50000, 12, 34, -22, 
1919, Johns Hopkins (MD), 4, 4, 1, 0.50000, 115, 147, -32, 
2011, Husson College (ME), 0, 10, 0, 0.00000, 108, 463, -355, 
2012, Husson College (ME), 2, 8, 0, 0.20000, 141, 369, -228, 
1987, Maine, 8, 4, 0, 0.66667, 352, 294, 58, 
1988, Maine, 7, 4, 0, 0.63636, 319, 229, 90, 
1989, Cincinnati (OH), 1, 9, 1, 0.13636, 111, 379, -268, 
1990, Cincinnati (OH), 1, 10, 0, 0.09091, 172, 460, -288, 
1991, Cincinnati (OH), 4, 7, 0, 0.36364, 201, 323, -122, 
1992, Cincinnati (OH), 3, 8, 0, 0.27273, 199, 276, -77, 
1993, Cincinnati (OH), 8, 3, 0, 0.72727, 302, 197, 105, 
1994, Harvard (MA), 4, 6, 0, 0.40000, 209, 254, -45, 
1995, Harvard (MA), 2, 8, 0, 0.20000, 183, 258, -75, 
1996, Harvard (MA), 4, 6, 0, 0.40000, 163, 164, -1, 
1997, Harvard (MA), 9, 1, 0, 0.90000, 301, 123, 178, 
1998, Harvard (MA), 4, 6, 0, 0.40000, 136, 211, -75, 
1999, Harvard (MA), 5, 5, 0, 0.50000, 254, 191, 63, 
2000, Harvard (MA), 5, 5, 0, 0.50000, 327, 255, 72, 
2001, Harvard (MA), 9, 0, 0, 1.00000, 293, 184, 109, 
2002, Harvard (MA), 7, 3, 0, 0.70000, 267, 230, 37, 
2003, Harvard (MA), 7, 3, 0, 0.70000, 317, 221, 96, 
2004, Harvard (MA), 10, 0, 0, 1.00000, 339, 134, 205, 
2005, Harvard (MA), 7, 3, 0, 0.70000, 310, 224, 86, 
2006, Harvard (MA), 7, 3, 0, 0.70000, 267, 192, 75, 
2007, Harvard (MA), 8, 2, 0, 0.80000, 266, 156, 110, 
2008, Harvard (MA), 9, 1, 0, 0.90000, 274, 178, 96, 
2009, Harvard (MA), 7, 3, 0, 0.70000, 252, 172, 80, 
2010, Harvard (MA), 7, 3, 0, 0.70000, 273, 187, 86, 
2011, Harvard (MA), 9, 1, 0, 0.90000, 374, 171, 203, 
2012, Harvard (MA), 8, 2, 0, 0.80000, 394, 174, 220, 
2013, Harvard (MA), 9, 1, 0, 0.90000, 371, 227, 144, 
1940, Henderson St. (AR), 3, 6, 1, 0.35000, 102, 109, -7, 
1897, South Carolina, 0, 3, 0, 0.00000, 6, 30, -24, 
1902, Fordham (NY), 2, 4, 1, 0.35714, 39, 94, -55, 
1921, Ashland (OH), 4, 2, 0, 0.66667, 49, 71, -22, 
1922, Ashland (OH), 5, 1, 1, 0.78571, 117, 20, 97, 
2013, Alfred (NY), 8, 3, 0, 0.72727, 327, 261, 66, 
1922, Marquette (WI), 8, 0, 1, 0.94444, 213, 3, 210, 
1923, Marquette (WI), 8, 0, 0, 1.00000, 162, 12, 150, 
1924, Marquette (WI), 5, 2, 0, 0.71429, 158, 68, 90, 
1925, Marquette (WI), 7, 2, 0, 0.77778, 108, 21, 87, 
1926, Marquette (WI), 6, 3, 0, 0.66667, 146, 64, 82, 
1927, Marquette (WI), 6, 3, 0, 0.66667, 153, 49, 104, 
1928, Marquette (WI), 5, 3, 1, 0.61111, 121, 68, 53, 
1929, Marquette (WI), 4, 3, 1, 0.56250, 118, 53, 65, 
1930, Marquette (WI), 8, 0, 1, 0.94444, 155, 7, 148, 
1931, Marquette (WI), 8, 1, 0, 0.88889, 172, 25, 147, 
1932, Marquette (WI), 4, 3, 1, 0.56250, 98, 48, 50, 
1933, Marquette (WI), 3, 4, 1, 0.43750, 62, 82, -20, 
1934, Marquette (WI), 4, 5, 0, 0.44444, 129, 104, 25, 
1935, Marquette (WI), 7, 1, 0, 0.87500, 173, 65, 108, 
1936, Marquette (WI), 7, 2, 0, 0.77778, 136, 60, 76, 
1937, Virginia, 2, 7, 0, 0.22222, 52, 169, -117, 
1938, Virginia, 4, 4, 1, 0.50000, 113, 169, -56, 
1939, Virginia, 5, 4, 0, 0.55556, 143, 75, 68, 
1940, Virginia, 4, 5, 0, 0.44444, 117, 103, 14, 
1941, Virginia, 8, 1, 0, 0.88889, 279, 42, 237, 
1942, Virginia, 2, 6, 1, 0.27778, 123, 181, -58, 
1943, Virginia, 3, 4, 1, 0.43750, 106, 133, -27, 
1944, Virginia, 6, 1, 2, 0.77778, 197, 52, 145, 
1945, Virginia, 7, 2, 0, 0.77778, 265, 79, 186, 
1946, Marquette (WI), 4, 5, 0, 0.44444, 139, 148, -9, 
1947, Marquette (WI), 4, 5, 0, 0.44444, 185, 223, -38, 
1948, Marquette (WI), 2, 8, 0, 0.20000, 127, 212, -85, 
1949, Marquette (WI), 4, 5, 0, 0.44444, 257, 209, 48, 
1917, Rhode Island, 2, 4, 2, 0.37500, 48, 97, -49, 
1919, Rhode Island, 0, 7, 1, 0.06250, 31, 168, -137, 
1964, Georgetown (DC), 1, 0, 0, 1.00000, 28, 6, 22, 
1997, Dubuque (IA), 3, 7, 0, 0.30000, 242, 397, -155, 
1998, Dubuque (IA), 0, 10, 0, 0.00000, 197, 468, -271, 
1999, Dubuque (IA), 1, 9, 0, 0.10000, 178, 401, -223, 
2000, Dubuque (IA), 0, 10, 0, 0.00000, 34, 485, -451, 
1899, Texas A&M;, 4, 2, 0, 0.66667, 150, 16, 134, 
1900, Texas A&M;, 2, 2, 1, 0.50000, 61, 22, 39, 
1901, Texas A&M;, 1, 4, 0, 0.20000, 12, 112, -100, 
1940, Delaware, 5, 3, 0, 0.62500, 87, 54, 33, 
1941, Delaware, 7, 0, 1, 0.93750, 176, 26, 150, 
1942, Delaware, 8, 0, 0, 1.00000, 196, 28, 168, 
1946, Delaware, 10, 0, 0, 1.00000, 358, 45, 313, 
1947, Delaware, 4, 4, 0, 0.50000, 161, 113, 48, 
1948, Delaware, 5, 3, 0, 0.62500, 107, 95, 12, 
1949, Delaware, 8, 1, 0, 0.88889, 202, 67, 135, 
1950, Delaware, 2, 5, 1, 0.31250, 55, 147, -92, 
1951, Duke (NC), 5, 4, 1, 0.55000, 201, 157, 44, 
1952, Duke (NC), 8, 2, 0, 0.80000, 227, 72, 155, 
1953, Duke (NC), 7, 2, 1, 0.75000, 217, 81, 136, 
1954, Duke (NC), 8, 2, 1, 0.77273, 270, 161, 109, 
1955, Duke (NC), 7, 2, 1, 0.75000, 196, 95, 101, 
1956, Duke (NC), 5, 4, 1, 0.55000, 184, 100, 84, 
1957, Duke (NC), 6, 3, 2, 0.63636, 182, 135, 47, 
1958, Duke (NC), 5, 5, 0, 0.50000, 128, 131, -3, 
1959, Duke (NC), 4, 6, 0, 0.40000, 104, 159, -55, 
1960, Duke (NC), 8, 3, 0, 0.72727, 173, 114, 59, 
1961, Duke (NC), 7, 3, 0, 0.70000, 183, 106, 77, 
1962, Duke (NC), 8, 2, 0, 0.80000, 199, 105, 94, 
1963, Duke (NC), 5, 4, 1, 0.55000, 230, 198, 32, 
1964, Duke (NC), 4, 5, 1, 0.45000, 148, 135, 13, 
1965, Duke (NC), 6, 4, 0, 0.60000, 216, 157, 59, 
2011, Florida, 7, 6, 0, 0.53846, 331, 264, 67, 
2012, Florida, 11, 2, 0, 0.84615, 344, 188, 156, 
2013, Florida, 4, 8, 0, 0.33333, 226, 253, -27, 
1966, Cornell (NY), 6, 3, 0, 0.66667, 181, 157, 24, 
1967, Cornell (NY), 6, 2, 1, 0.72222, 210, 145, 65, 
1968, Cornell (NY), 3, 6, 0, 0.33333, 130, 163, -33, 
1969, Cornell (NY), 4, 5, 0, 0.44444, 148, 162, -14, 
1970, Cornell (NY), 6, 3, 0, 0.66667, 193, 185, 8, 
1971, Cornell (NY), 8, 1, 0, 0.88889, 240, 136, 104, 
1972, Cornell (NY), 6, 3, 0, 0.66667, 228, 183, 45, 
1973, Cornell (NY), 3, 5, 1, 0.38889, 170, 154, 16, 
1974, Cornell (NY), 3, 5, 1, 0.38889, 183, 193, -10, 
1965, Idaho, 5, 5, 0, 0.50000, 201, 125, 76, 
1966, Idaho, 4, 6, 0, 0.40000, 182, 165, 17, 
1967, Idaho, 4, 6, 0, 0.40000, 156, 332, -176, 
2008, North Dakota, 6, 4, 0, 0.60000, 321, 263, 58, 
2009, North Dakota, 6, 5, 0, 0.54545, 250, 307, -57, 
2010, North Dakota, 3, 8, 0, 0.27273, 244, 275, -31, 
2011, North Dakota, 8, 3, 0, 0.72727, 286, 224, 62, 
2012, North Dakota, 5, 6, 0, 0.45455, 369, 380, -11, 
2013, North Dakota, 3, 8, 0, 0.27273, 262, 371, -109, 
1909, Wake Forest (NC), 2, 4, 0, 0.33333, 11, 45, -34, 
1941, Boston College (MA), 7, 3, 0, 0.70000, 235, 106, 129, 
1942, Boston College (MA), 8, 2, 0, 0.80000, 282, 111, 171, 
1946, Boston College (MA), 6, 3, 0, 0.66667, 234, 123, 111, 
1947, Boston College (MA), 5, 4, 0, 0.55556, 184, 134, 50, 
1948, Boston College (MA), 5, 2, 2, 0.66667, 152, 134, 18, 
1949, Boston College (MA), 4, 4, 1, 0.50000, 209, 187, 22, 
1950, Boston College (MA), 0, 9, 1, 0.05000, 78, 270, -192, 
1946, Johns Hopkins (MD), 5, 3, 0, 0.62500, 90, 117, -27, 
1947, Johns Hopkins (MD), 5, 2, 1, 0.68750, 216, 75, 141, 
1948, Johns Hopkins (MD), 7, 1, 0, 0.87500, 125, 43, 82, 
1949, Johns Hopkins (MD), 4, 4, 0, 0.50000, 144, 174, -30, 
1950, Hofstra (NY), 2, 6, 0, 0.25000, 157, 171, -14, 
1951, Hofstra (NY), 6, 2, 1, 0.72222, 179, 63, 116, 
1952, Hofstra (NY), 8, 1, 0, 0.88889, 283, 101, 182, 
1953, Hofstra (NY), 6, 3, 0, 0.66667, 171, 103, 68, 
1954, Hofstra (NY), 7, 2, 0, 0.77778, 257, 130, 127, 
1955, Hofstra (NY), 3, 6, 0, 0.33333, 83, 152, -69, 
1956, Hofstra (NY), 7, 3, 0, 0.70000, 210, 135, 75, 
1957, Hofstra (NY), 9, 1, 0, 0.90000, 218, 64, 154, 
1958, Hofstra (NY), 6, 4, 0, 0.60000, 186, 91, 95, 
1959, Hofstra (NY), 9, 0, 0, 1.00000, 275, 44, 231, 
1960, Hofstra (NY), 7, 1, 1, 0.83333, 158, 78, 80, 
1961, Hofstra (NY), 7, 2, 0, 0.77778, 168, 41, 127, 
1962, Hofstra (NY), 8, 2, 0, 0.80000, 187, 129, 58, 
1963, Hofstra (NY), 3, 6, 0, 0.33333, 219, 234, -15, 
1964, Hofstra (NY), 6, 3, 1, 0.65000, 180, 135, 45, 
1965, Hofstra (NY), 8, 2, 0, 0.80000, 293, 187, 106, 
1966, Hofstra (NY), 2, 8, 0, 0.20000, 133, 175, -42, 
1967, Hofstra (NY), 8, 2, 0, 0.80000, 241, 78, 163, 
1968, Hofstra (NY), 5, 5, 0, 0.50000, 155, 171, -16, 
1969, Hofstra (NY), 0, 10, 0, 0.00000, 175, 283, -108, 
1970, Hofstra (NY), 5, 5, 0, 0.50000, 239, 262, -23, 
1971, Hofstra (NY), 5, 6, 0, 0.45455, 137, 188, -51, 
1972, Hofstra (NY), 5, 6, 0, 0.45455, 159, 200, -41, 
1973, Hofstra (NY), 8, 3, 0, 0.72727, 194, 193, 1, 
1974, Hofstra (NY), 1, 9, 1, 0.13636, 113, 298, -185, 
1979, Johns Hopkins (MD), 5, 4, 0, 0.55556, 123, 175, -52, 
1953, Pacific (CA), 4, 4, 2, 0.50000, 191, 172, 19, 
1954, Pacific (CA), 4, 5, 0, 0.44444, 99, 118, -19, 
1955, Pacific (CA), 5, 4, 0, 0.55556, 132, 121, 11, 
1956, Pacific (CA), 6, 3, 1, 0.65000, 241, 148, 93, 
1957, Pacific (CA), 5, 3, 2, 0.60000, 145, 127, 18, 
1958, Pacific (CA), 6, 4, 0, 0.60000, 266, 178, 88, 
1959, Pacific (CA), 5, 4, 0, 0.55556, 132, 117, 15, 
1960, Pacific (CA), 4, 6, 0, 0.40000, 140, 278, -138, 
1957, Iowa St., 4, 5, 1, 0.45000, 142, 160, -18, 
1958, Texas A&M;, 4, 6, 0, 0.40000, 124, 217, -93, 
1959, Texas A&M;, 3, 7, 0, 0.30000, 101, 141, -40, 
1960, Texas A&M;, 1, 6, 3, 0.25000, 73, 117, -44, 
1961, Texas A&M;, 4, 5, 1, 0.45000, 184, 118, 66, 
1920, Central Oklahoma, 4, 3, 1, 0.56250, 219, 66, 153, 
1968, Ball St. (IN), 5, 4, 0, 0.55556, 189, 218, -29, 
1969, Ball St. (IN), 5, 5, 0, 0.50000, 178, 201, -23, 
1970, Ball St. (IN), 5, 5, 0, 0.50000, 146, 226, -80, 
1969, Savannah St. (GA), 3, 5, 0, 0.37500, 114, 143, -29, 
1970, Savannah St. (GA), 3, 5, 0, 0.37500, 94, 136, -42, 
1971, Savannah St. (GA), 5, 4, 1, 0.55000, 129, 123, 6, 
1972, Savannah St. (GA), 6, 3, 0, 0.66667, 212, 111, 101, 
1973, Savannah St. (GA), 3, 6, 0, 0.33333, 128, 208, -80, 
1974, Savannah St. (GA), 3, 6, 1, 0.35000, 128, 159, -31, 
1975, Savannah St. (GA), 3, 7, 0, 0.30000, 160, 214, -54, 
1976, Savannah St. (GA), 0, 9, 0, 0.00000, 72, 180, -108, 
1942, Savannah St. (GA), 5, 2, 1, 0.68750, 158, 32, 126, 
1946, Savannah St. (GA), 4, 2, 2, 0.62500, 100, 84, 16, 
1934, Bucknell (PA), 7, 2, 2, 0.72727, 108, 38, 70, 
1935, Bucknell (PA), 6, 3, 0, 0.66667, 45, 98, -53, 
1936, Bucknell (PA), 4, 4, 1, 0.50000, 65, 78, -13, 
1937, Lafayette (PA), 8, 0, 0, 1.00000, 103, 6, 97, 
1938, Lafayette (PA), 5, 3, 0, 0.62500, 92, 66, 26, 
1939, Lafayette (PA), 4, 5, 0, 0.44444, 127, 67, 60, 
1940, Lafayette (PA), 9, 0, 0, 1.00000, 238, 33, 205, 
1941, Lafayette (PA), 5, 4, 0, 0.55556, 148, 98, 50, 
1942, Lafayette (PA), 3, 5, 1, 0.38889, 75, 104, -29, 
1946, Lafayette (PA), 2, 7, 0, 0.22222, 56, 286, -230, 
1947, New York (NY), 2, 5, 1, 0.31250, 65, 194, -129, 
1948, New York (NY), 3, 6, 0, 0.33333, 96, 190, -94, 
1949, New York (NY), 3, 6, 0, 0.33333, 146, 181, -35, 
2003, Pikeville (KY), 4, 6, 0, 0.40000, 251, 198, 53, 
2004, Pikeville (KY), 8, 3, 0, 0.72727, 262, 177, 85, 
2005, Pikeville (KY), 8, 3, 0, 0.72727, 360, 261, 99, 
1992, Canisius (NY), 3, 6, 1, 0.35000, 150, 210, -60, 
1993, Canisius (NY), 5, 5, 0, 0.50000, 186, 165, 21, 
1994, Canisius (NY), 2, 8, 0, 0.20000, 132, 183, -51, 
1981, Doane (NE), 2, 7, 0, 0.22222, 82, 208, -126, 
1982, Doane (NE), 7, 4, 0, 0.63636, 182, 132, 50, 
1983, Doane (NE), 7, 3, 0, 0.70000, 220, 119, 101, 
1984, Cameron (OK), 5, 5, 0, 0.50000, 179, 183, -4, 
1985, Cameron (OK), 3, 7, 0, 0.30000, 99, 183, -84, 
1986, Cameron (OK), 11, 2, 1, 0.82143, 370, 155, 215, 
1987, Cameron (OK), 11, 2, 0, 0.84615, 349, 142, 207, 
1988, Cameron (OK), 5, 3, 1, 0.61111, 177, 170, 7, 
1989, Cameron (OK), 3, 7, 0, 0.30000, 174, 291, -117, 
1959, Parsons (IA), 3, 7, 0, 0.30000, 143, 148, -5, 
1960, Parsons (IA), 8, 1, 0, 0.88889, 209, 82, 127, 
1961, Parsons (IA), 9, 1, 0, 0.90000, 259, 50, 209, 
1977, Connecticut, 1, 10, 0, 0.09091, 84, 290, -206, 
1978, Connecticut, 4, 7, 0, 0.36364, 181, 202, -21, 
1979, Connecticut, 3, 6, 2, 0.36364, 144, 173, -29, 
1980, Connecticut, 7, 3, 0, 0.70000, 259, 191, 68, 
1981, Connecticut, 4, 7, 0, 0.36364, 291, 255, 36, 
1982, Connecticut, 5, 6, 0, 0.45455, 164, 193, -29, 
1958, Utah, 4, 7, 0, 0.36364, 161, 187, -26, 
1959, Utah, 5, 5, 0, 0.50000, 224, 195, 29, 
1960, Utah, 7, 3, 0, 0.70000, 194, 90, 104, 
1961, Utah, 6, 4, 0, 0.60000, 176, 134, 42, 
1962, Utah, 4, 5, 1, 0.45000, 169, 196, -27, 
1963, Utah, 4, 6, 0, 0.40000, 204, 187, 17, 
1964, Utah, 9, 2, 0, 0.81818, 234, 68, 166, 
1965, Utah, 3, 7, 0, 0.30000, 177, 164, 13, 
1966, Iowa, 2, 8, 0, 0.20000, 86, 253, -167, 
1967, Iowa, 1, 8, 1, 0.15000, 161, 277, -116, 
1968, Iowa, 5, 5, 0, 0.50000, 322, 289, 33, 
1969, Iowa, 5, 5, 0, 0.50000, 255, 275, -20, 
1970, Iowa, 3, 6, 1, 0.35000, 129, 259, -130, 
1953, Doane (NE), 4, 3, 2, 0.55556, 127, 137, -10, 
1954, Doane (NE), 3, 6, 0, 0.33333, 103, 203, -100, 
1894, Boston College (MA), 1, 6, 0, 0.14286, 20, 116, -96, 
1962, Weber St. (UT), 5, 4, 0, 0.55556, 186, 152, 34, 
1963, Weber St. (UT), 6, 3, 0, 0.66667, 217, 161, 56, 
1964, Weber St. (UT), 2, 6, 0, 0.25000, 67, 155, -88, 
1898, Georgia Tech, 0, 3, 0, 0.00000, 6, 67, -61, 
1899, Villanova (PA), 7, 2, 1, 0.75000, 94, 46, 48, 
1901, Washington St., 5, 1, 0, 0.83333, 71, 7, 64, 
1901, New Mexico, 0, 3, 1, 0.12500, 7, 54, -47, 
1975, Youngstown St. (OH), 5, 4, 0, 0.55556, 139, 110, 29, 
1976, Youngstown St. (OH), 4, 6, 0, 0.40000, 191, 217, -26, 
1977, Youngstown St. (OH), 7, 3, 0, 0.70000, 275, 205, 70, 
1978, Youngstown St. (OH), 10, 2, 0, 0.83333, 402, 182, 220, 
1979, Youngstown St. (OH), 11, 2, 0, 0.84615, 416, 209, 207, 
1980, Youngstown St. (OH), 2, 8, 1, 0.22727, 144, 251, -107, 
1981, Youngstown St. (OH), 7, 4, 0, 0.63636, 282, 215, 67, 
1982, Youngstown St. (OH), 6, 5, 0, 0.54545, 246, 243, 3, 
1983, Youngstown St. (OH), 4, 7, 0, 0.36364, 269, 270, -1, 
1984, Youngstown St. (OH), 7, 4, 0, 0.63636, 231, 210, 21, 
1985, Youngstown St. (OH), 5, 6, 0, 0.45455, 259, 286, -27, 
1965, Georgetown (DC), 1, 1, 0, 0.50000, 78, 48, 30, 
1980, Columbia (NY), 1, 9, 0, 0.10000, 89, 275, -186, 
1981, Columbia (NY), 1, 9, 0, 0.10000, 116, 243, -127, 
1982, Columbia (NY), 1, 9, 0, 0.10000, 236, 390, -154, 
1983, Columbia (NY), 1, 7, 2, 0.20000, 218, 363, -145, 
1984, Columbia (NY), 0, 9, 0, 0.00000, 117, 282, -165, 
1973, California (PA), 3, 6, 0, 0.33333, 106, 244, -138, 
1974, California (PA), 1, 7, 0, 0.12500, 70, 200, -130, 
1975, California (PA), 0, 8, 0, 0.00000, 86, 215, -129, 
1976, California (PA), 2, 7, 0, 0.22222, 69, 230, -161, 
1968, Columbia (NY), 2, 7, 0, 0.22222, 174, 247, -73, 
1969, Columbia (NY), 1, 8, 0, 0.11111, 84, 237, -153, 
1970, Columbia (NY), 3, 6, 0, 0.33333, 164, 224, -60, 
1971, Columbia (NY), 6, 3, 0, 0.66667, 166, 136, 30, 
1972, Columbia (NY), 3, 5, 1, 0.38889, 143, 124, 19, 
1973, Columbia (NY), 1, 7, 1, 0.16667, 58, 274, -216, 
1974, Wabash (IN), 5, 5, 0, 0.50000, 162, 129, 33, 
1975, Wabash (IN), 3, 7, 0, 0.30000, 153, 166, -13, 
1976, Wabash (IN), 7, 3, 0, 0.70000, 162, 173, -11, 
1977, Wabash (IN), 11, 2, 0, 0.84615, 333, 162, 171, 
1978, Princeton (NJ), 2, 5, 2, 0.33333, 126, 183, -57, 
1979, Princeton (NJ), 5, 4, 0, 0.55556, 166, 159, 7, 
1980, Princeton (NJ), 6, 4, 0, 0.60000, 175, 198, -23, 
1981, Princeton (NJ), 5, 4, 1, 0.55000, 233, 305, -72, 
1982, Princeton (NJ), 3, 7, 0, 0.30000, 222, 317, -95, 
1983, Princeton (NJ), 4, 6, 0, 0.40000, 285, 277, 8, 
1984, Princeton (NJ), 4, 5, 0, 0.44444, 185, 192, -7, 
1969, Boston (MA), 9, 2, 0, 0.81818, 233, 131, 102, 
1970, Boston (MA), 5, 4, 0, 0.55556, 199, 141, 58, 
1971, Boston (MA), 3, 7, 0, 0.30000, 200, 284, -84, 
1972, Boston (MA), 2, 8, 0, 0.20000, 117, 281, -164, 
1973, Connecticut, 8, 2, 1, 0.77273, 208, 141, 67, 
1974, Connecticut, 4, 6, 0, 0.40000, 153, 168, -15, 
1975, Connecticut, 4, 7, 0, 0.36364, 178, 244, -66, 
1976, Connecticut, 2, 9, 0, 0.18182, 182, 246, -64, 
1970, Indiana (PA), 5, 4, 0, 0.55556, 171, 185, -14, 
1971, Indiana (PA), 7, 2, 0, 0.77778, 237, 121, 116, 
1972, Indiana (PA), 8, 1, 0, 0.88889, 163, 93, 70, 
1973, Indiana (PA), 4, 5, 0, 0.44444, 122, 193, -71, 
1974, Indiana (PA), 6, 4, 0, 0.60000, 210, 116, 94, 
1975, Indiana (PA), 8, 1, 1, 0.85000, 272, 131, 141, 
1976, Indiana (PA), 4, 5, 0, 0.44444, 107, 115, -8, 
1977, Indiana (PA), 4, 4, 1, 0.50000, 147, 119, 28, 
1978, Indiana (PA), 4, 5, 1, 0.45000, 150, 168, -18, 
1930, DePauw (IN), 6, 1, 0, 0.85714, 150, 66, 84, 
1931, DePauw (IN), 7, 1, 0, 0.87500, 153, 72, 81, 
1932, DePauw (IN), 3, 4, 1, 0.43750, 109, 91, 18, 
1933, DePauw (IN), 7, 0, 0, 1.00000, 136, 0, 136, 
1934, DePauw (IN), 7, 1, 0, 0.87500, 175, 13, 162, 
1935, DePauw (IN), 5, 1, 2, 0.75000, 121, 46, 75, 
1936, DePauw (IN), 3, 3, 2, 0.50000, 83, 59, 24, 
1937, DePauw (IN), 7, 1, 0, 0.87500, 159, 19, 140, 
1938, DePauw (IN), 5, 3, 0, 0.62500, 151, 59, 92, 
1939, DePauw (IN), 4, 3, 1, 0.56250, 159, 79, 80, 
1940, DePauw (IN), 3, 4, 0, 0.42857, 156, 107, 49, 
1941, DePauw (IN), 6, 2, 0, 0.75000, 122, 65, 57, 
1942, DePauw (IN), 5, 3, 0, 0.62500, 141, 106, 35, 
1943, DePauw (IN), 5, 0, 1, 0.91667, 206, 6, 200, 
1944, DePauw (IN), 3, 5, 0, 0.37500, 48, 168, -120, 
1945, DePauw (IN), 3, 2, 0, 0.60000, 86, 40, 46, 
1916, West Virginia Wesleyan, 5, 6, 0, 0.45455, 233, 199, 34, 
1917, West Virginia Wesleyan, 5, 2, 0, 0.71429, 141, 30, 111, 
1923, Virginia, 3, 5, 1, 0.38889, 87, 81, 6, 
1924, Virginia, 5, 4, 0, 0.55556, 72, 83, -11, 
1925, Virginia, 7, 1, 1, 0.83333, 144, 31, 113, 
1926, Virginia, 6, 2, 2, 0.70000, 161, 53, 108, 
1927, Virginia, 5, 4, 0, 0.55556, 117, 122, -5, 
1928, Virginia, 2, 6, 1, 0.27778, 121, 142, -21, 
1931, West Virginia, 4, 6, 0, 0.40000, 91, 122, -31, 
1932, West Virginia, 5, 5, 0, 0.50000, 137, 115, 22, 
1933, West Virginia, 3, 5, 3, 0.40909, 87, 145, -58, 
1930, Virginia Tech, 5, 3, 1, 0.61111, 122, 130, -8, 
1931, Virginia Tech, 3, 4, 2, 0.44444, 76, 104, -28, 
1908, Saint Bonaventure (NY), 3, 1, 1, 0.70000, 50, 14, 36, 
1909, Saint Bonaventure (NY), 4, 0, 2, 0.83333, 44, 0, 44, 
1910, Saint Bonaventure (NY), 1, 4, 1, 0.25000, 27, 100, -73, 
1924, San Francisco (CA), 0, 5, 0, 0.00000, 19, 83, -64, 
1925, San Francisco (CA), 2, 4, 1, 0.35714, 45, 59, -14, 
1926, San Francisco (CA), 2, 3, 3, 0.43750, 32, 95, -63, 
1927, San Francisco (CA), 3, 5, 1, 0.38889, 83, 117, -34, 
1928, San Francisco (CA), 4, 4, 0, 0.50000, 63, 99, -36, 
1929, San Francisco (CA), 4, 3, 1, 0.56250, 62, 79, -17, 
1930, San Francisco (CA), 6, 3, 0, 0.66667, 114, 86, 28, 
1931, San Francisco (CA), 4, 4, 2, 0.50000, 155, 87, 68, 
1931, Clemson (SC), 1, 6, 2, 0.22222, 19, 164, -145, 
1932, Clemson (SC), 3, 5, 1, 0.38889, 89, 111, -22, 
1933, Clemson (SC), 3, 6, 2, 0.36364, 50, 98, -48, 
1934, Clemson (SC), 5, 4, 0, 0.55556, 89, 85, 4, 
1935, Clemson (SC), 6, 3, 0, 0.66667, 147, 99, 48, 
1936, Clemson (SC), 5, 5, 0, 0.50000, 98, 95, 3, 
1937, Clemson (SC), 4, 4, 1, 0.50000, 128, 64, 64, 
1938, Clemson (SC), 7, 1, 1, 0.83333, 145, 56, 89, 
1939, Clemson (SC), 9, 1, 0, 0.90000, 165, 45, 120, 
1940, Rice (TX), 7, 3, 0, 0.70000, 131, 78, 53, 
1941, Rice (TX), 6, 3, 1, 0.65000, 167, 121, 46, 
1942, Rice (TX), 7, 2, 1, 0.75000, 177, 74, 103, 
1943, Rice (TX), 3, 7, 0, 0.30000, 60, 183, -123, 
1944, Rice (TX), 5, 6, 0, 0.45455, 143, 163, -20, 
1945, Rice (TX), 5, 6, 0, 0.45455, 130, 153, -23, 
1946, Rice (TX), 9, 2, 0, 0.81818, 245, 62, 183, 
1947, Rice (TX), 6, 3, 1, 0.65000, 202, 74, 128, 
1948, Rice (TX), 5, 4, 1, 0.55000, 168, 119, 49, 
1949, Rice (TX), 10, 1, 0, 0.90909, 276, 97, 179, 
1950, Rice (TX), 6, 4, 0, 0.60000, 168, 196, -28, 
1951, Rice (TX), 5, 5, 0, 0.50000, 149, 144, 5, 
1952, Rice (TX), 5, 5, 0, 0.50000, 152, 175, -23, 
1953, Rice (TX), 9, 2, 0, 0.81818, 295, 105, 190, 
1954, Rice (TX), 7, 3, 0, 0.70000, 205, 148, 57, 
1955, Rice (TX), 2, 7, 1, 0.25000, 110, 179, -69, 
1956, Rice (TX), 4, 6, 0, 0.40000, 160, 169, -9, 
1957, Rice (TX), 7, 4, 0, 0.63636, 175, 121, 54, 
1958, Rice (TX), 5, 5, 0, 0.50000, 178, 156, 22, 
1959, Rice (TX), 1, 7, 2, 0.20000, 86, 197, -111, 
1960, Rice (TX), 7, 4, 0, 0.63636, 174, 72, 102, 
1961, Rice (TX), 7, 4, 0, 0.63636, 183, 158, 25, 
1962, Rice (TX), 2, 6, 2, 0.30000, 119, 173, -54, 
1963, Rice (TX), 6, 4, 0, 0.60000, 145, 114, 31, 
1964, Rice (TX), 4, 5, 1, 0.45000, 117, 111, 6, 
1965, Rice (TX), 2, 8, 0, 0.20000, 123, 248, -125, 
1966, Rice (TX), 2, 8, 0, 0.20000, 154, 211, -57, 
1909, Virginia, 7, 1, 0, 0.87500, 155, 11, 144, 
1910, South Carolina, 4, 4, 0, 0.50000, 67, 109, -42, 
1911, South Carolina, 1, 4, 2, 0.28571, 22, 102, -80, 
1968, Bowling Green (OH), 6, 3, 1, 0.65000, 267, 147, 120, 
1969, Bowling Green (OH), 6, 4, 0, 0.60000, 179, 146, 33, 
1970, Bowling Green (OH), 2, 6, 1, 0.27778, 118, 178, -60, 
1971, Bowling Green (OH), 6, 4, 0, 0.60000, 263, 207, 56, 
1972, Bowling Green (OH), 6, 3, 1, 0.65000, 184, 127, 57, 
1973, Bowling Green (OH), 7, 3, 0, 0.70000, 266, 209, 57, 
1974, Bowling Green (OH), 6, 4, 1, 0.59091, 249, 203, 46, 
1975, Bowling Green (OH), 8, 3, 0, 0.72727, 278, 166, 112, 
1976, Bowling Green (OH), 6, 5, 0, 0.54545, 292, 249, 43, 
1980, West Virginia, 6, 6, 0, 0.50000, 305, 289, 16, 
1981, West Virginia, 9, 3, 0, 0.75000, 284, 155, 129, 
1982, West Virginia, 9, 3, 0, 0.75000, 284, 182, 102, 
1983, West Virginia, 9, 3, 0, 0.75000, 322, 189, 133, 
1984, West Virginia, 8, 4, 0, 0.66667, 259, 170, 89, 
1985, West Virginia, 7, 3, 1, 0.68182, 189, 158, 31, 
1986, West Virginia, 4, 7, 0, 0.36364, 210, 286, -76, 
1987, West Virginia, 6, 6, 0, 0.50000, 330, 212, 118, 
1988, West Virginia, 11, 1, 0, 0.91667, 493, 208, 285, 
1989, West Virginia, 8, 3, 1, 0.70833, 339, 221, 118, 
1990, West Virginia, 4, 7, 0, 0.36364, 217, 238, -21, 
1991, West Virginia, 6, 5, 0, 0.54545, 187, 224, -37, 
1992, West Virginia, 5, 4, 2, 0.54545, 286, 238, 48, 
1993, West Virginia, 11, 1, 0, 0.91667, 408, 212, 196, 
1994, West Virginia, 7, 6, 0, 0.53846, 296, 286, 10, 
1995, West Virginia, 5, 6, 0, 0.45455, 253, 210, 43, 
1996, West Virginia, 8, 4, 0, 0.66667, 271, 156, 115, 
1997, West Virginia, 7, 5, 0, 0.58333, 360, 285, 75, 
1998, West Virginia, 8, 4, 0, 0.66667, 410, 267, 143, 
1999, West Virginia, 4, 7, 0, 0.36364, 292, 289, 3, 
2000, West Virginia, 7, 5, 0, 0.58333, 356, 363, -7, 
1905, Maryland, 6, 4, 0, 0.60000, 131, 66, 65, 
1906, Maryland, 5, 3, 0, 0.62500, 98, 73, 25, 
1907, George Washington (DC), 2, 5, 1, 0.31250, 33, 104, -71, 
1908, George Washington (DC), 9, 1, 1, 0.86364, 327, 28, 299, 
1910, Georgetown (DC), 7, 1, 1, 0.83333, 181, 26, 155, 
1911, Georgetown (DC), 7, 1, 1, 0.83333, 257, 31, 226, 
1943, Florida A&M;, 1, 4, 2, 0.28571, 32, 142, -110, 
1944, Florida A&M;, 7, 3, 0, 0.70000, 194, 78, 116, 
1945, Hampton (VA), 2, 6, 0, 0.25000, 50, 123, -73, 
1946, Hampton (VA), 4, 4, 0, 0.50000, 97, 53, 44, 
1908, Army (NY), 6, 1, 2, 0.77778, 87, 21, 66, 
1909, Army (NY), 3, 2, 0, 0.60000, 57, 32, 25, 
1910, Army (NY), 6, 2, 0, 0.75000, 96, 12, 84, 
1950, Beloit (WI), 5, 2, 1, 0.68750, 146, 97, 49, 
1951, Beloit (WI), 7, 1, 0, 0.87500, 278, 113, 165, 
1952, Beloit (WI), 8, 0, 0, 1.00000, 200, 18, 182, 
1953, Beloit (WI), 6, 2, 0, 0.75000, 175, 68, 107, 
1954, Beloit (WI), 2, 6, 0, 0.25000, 83, 136, -53, 
1955, Beloit (WI), 7, 1, 0, 0.87500, 182, 120, 62, 
1956, Beloit (WI), 6, 2, 0, 0.75000, 112, 70, 42, 
1957, Beloit (WI), 3, 4, 0, 0.42857, 85, 100, -15, 
1958, Beloit (WI), 2, 6, 0, 0.25000, 62, 143, -81, 
1959, Beloit (WI), 4, 4, 0, 0.50000, 71, 150, -79, 
1960, Beloit (WI), 1, 7, 0, 0.12500, 61, 135, -74, 
1961, Beloit (WI), 2, 6, 0, 0.25000, 81, 162, -81, 
1982, North Texas, 2, 9, 0, 0.18182, 179, 283, -104, 
1983, North Texas, 8, 4, 0, 0.66667, 276, 137, 139, 
1984, North Texas, 2, 9, 0, 0.18182, 86, 211, -125, 
1985, North Texas, 4, 6, 1, 0.40909, 150, 203, -53, 
1986, North Texas, 6, 4, 0, 0.60000, 222, 204, 18, 
1987, North Texas, 7, 5, 0, 0.58333, 242, 247, -5, 
1988, North Texas, 8, 4, 0, 0.66667, 330, 174, 156, 
1989, North Texas, 5, 6, 0, 0.45455, 217, 253, -36, 
1990, North Texas, 6, 5, 0, 0.54545, 223, 211, 12, 
1949, Maine, 2, 4, 1, 0.35714, 69, 104, -35, 
1950, Maine, 5, 1, 1, 0.78571, 95, 52, 43, 
1951, Delaware, 5, 3, 0, 0.62500, 173, 109, 64, 
1952, Delaware, 4, 4, 0, 0.50000, 134, 122, 12, 
1953, Delaware, 7, 1, 0, 0.87500, 201, 80, 121, 
1954, Delaware, 8, 2, 0, 0.80000, 265, 81, 184, 
1955, Delaware, 8, 1, 0, 0.88889, 261, 82, 179, 
1956, Delaware, 5, 3, 1, 0.61111, 151, 108, 43, 
1957, Delaware, 4, 3, 0, 0.57143, 210, 84, 126, 
1958, Delaware, 5, 3, 0, 0.62500, 188, 102, 86, 
1959, Delaware, 8, 1, 0, 0.88889, 286, 95, 191, 
1960, Delaware, 2, 6, 1, 0.27778, 92, 141, -49, 
1961, Delaware, 4, 4, 0, 0.50000, 161, 98, 63, 
1962, Delaware, 7, 2, 0, 0.77778, 219, 76, 143, 
1963, Delaware, 8, 0, 0, 1.00000, 290, 76, 214, 
1964, Delaware, 4, 5, 0, 0.44444, 170, 168, 2, 
1965, Delaware, 5, 4, 0, 0.55556, 213, 152, 61, 
1947, Augsburg (MN), 0, 7, 0, 0.00000, 38, 97, -59, 
1948, Augsburg (MN), 1, 3, 2, 0.33333, 54, 119, -65, 
1949, Augsburg (MN), 2, 3, 2, 0.42857, 82, 77, 5, 
1950, Augsburg (MN), 1, 5, 1, 0.21429, 43, 143, -100, 
1951, Augsburg (MN), 0, 7, 0, 0.00000, 47, 152, -105, 
1952, Augsburg (MN), 3, 5, 0, 0.37500, 105, 165, -60, 
1953, Augsburg (MN), 3, 5, 0, 0.37500, 92, 142, -50, 
1954, Augsburg (MN), 1, 7, 0, 0.12500, 138, 165, -27, 
1955, Augsburg (MN), 4, 4, 0, 0.50000, 58, 79, -21, 
1956, Augsburg (MN), 2, 5, 1, 0.31250, 92, 147, -55, 
1957, Augsburg (MN), 4, 4, 0, 0.50000, 66, 114, -48, 
1958, Augsburg (MN), 0, 8, 0, 0.00000, 74, 214, -140, 
1959, Augsburg (MN), 3, 5, 0, 0.37500, 119, 228, -109, 
1960, Augsburg (MN), 5, 3, 0, 0.62500, 152, 138, 14, 
1961, Augsburg (MN), 4, 4, 0, 0.50000, 182, 183, -1, 
1962, Augsburg (MN), 3, 5, 0, 0.37500, 135, 207, -72, 
1963, Augsburg (MN), 4, 3, 1, 0.56250, 146, 123, 23, 
1964, Augsburg (MN), 6, 3, 0, 0.66667, 138, 118, 20, 
1965, Augsburg (MN), 3, 5, 1, 0.38889, 163, 149, 14, 
1966, Augsburg (MN), 4, 4, 1, 0.50000, 134, 157, -23, 
1967, Augsburg (MN), 1, 8, 0, 0.11111, 88, 193, -105, 
1968, Augsburg (MN), 1, 8, 0, 0.11111, 127, 199, -72, 
1969, Augsburg (MN), 1, 8, 0, 0.11111, 90, 276, -186, 
1938, Mississippi St., 4, 6, 0, 0.40000, 123, 131, -8, 
1941, Yale (CT), 1, 7, 0, 0.12500, 54, 136, -82, 
1901, Richmond (VA), 1, 6, 0, 0.14286, 27, 232, -205, 
2009, Husson College (ME), 4, 5, 0, 0.44444, 275, 201, 74, 
2010, Husson College (ME), 1, 9, 0, 0.10000, 191, 430, -239, 
1949, Parsons (IA), 3, 5, 0, 0.37500, 123, 136, -13, 
1950, Parsons (IA), 6, 2, 0, 0.75000, 191, 110, 81, 
1951, Parsons (IA), 4, 4, 0, 0.50000, 128, 147, -19, 
1952, Parsons (IA), 4, 4, 0, 0.50000, 133, 118, 15, 
1953, Parsons (IA), 3, 5, 0, 0.37500, 124, 198, -74, 
1954, Parsons (IA), 2, 4, 2, 0.37500, 79, 110, -31, 
1955, Parsons (IA), 8, 0, 0, 1.00000, 215, 64, 151, 
1956, Parsons (IA), 5, 5, 0, 0.50000, 194, 129, 65, 
1957, Parsons (IA), 7, 2, 1, 0.75000, 167, 99, 68, 
1965, Azusa Pacific (CA), 1, 6, 0, 0.14286, 60, 181, -121, 
1939, Rensselaer Tech (NY), 4, 2, 2, 0.62500, 115, 91, 24, 
1940, Rensselaer Tech (NY), 7, 1, 0, 0.87500, 140, 34, 106, 
1941, Rensselaer Tech (NY), 4, 3, 0, 0.57143, 121, 77, 44, 
1946, Middlebury (VT), 2, 4, 1, 0.35714, 68, 111, -43, 
1947, Middlebury (VT), 6, 1, 1, 0.81250, 116, 70, 46, 
1948, Middlebury (VT), 7, 1, 0, 0.87500, 180, 59, 121, 
1949, Middlebury (VT), 4, 2, 1, 0.64286, 99, 129, -30, 
1950, Middlebury (VT), 3, 4, 1, 0.43750, 112, 142, -30, 
1951, Middlebury (VT), 4, 4, 0, 0.50000, 220, 182, 38, 
1952, Middlebury (VT), 2, 5, 0, 0.28571, 93, 161, -68, 
1953, Middlebury (VT), 2, 5, 0, 0.28571, 59, 145, -86, 
1954, Middlebury (VT), 4, 2, 1, 0.64286, 151, 108, 43, 
1955, Middlebury (VT), 3, 4, 0, 0.42857, 55, 77, -22, 
1956, Middlebury (VT), 4, 3, 0, 0.57143, 97, 101, -4, 
1957, Middlebury (VT), 5, 2, 0, 0.71429, 154, 73, 81, 
1958, Middlebury (VT), 4, 3, 0, 0.57143, 58, 90, -32, 
1959, Middlebury (VT), 5, 1, 1, 0.78571, 94, 47, 47, 
1960, Middlebury (VT), 5, 1, 1, 0.78571, 115, 69, 46, 
1961, Middlebury (VT), 5, 1, 1, 0.78571, 106, 72, 34, 
1962, Middlebury (VT), 5, 2, 0, 0.71429, 145, 34, 111, 
1963, Middlebury (VT), 2, 5, 0, 0.28571, 83, 81, 2, 
1964, Middlebury (VT), 3, 3, 1, 0.50000, 71, 60, 11, 
1965, Middlebury (VT), 2, 5, 0, 0.28571, 62, 126, -64, 
1966, Middlebury (VT), 3, 5, 0, 0.37500, 77, 155, -78, 
1967, Middlebury (VT), 2, 6, 0, 0.25000, 119, 211, -92, 
1968, Middlebury (VT), 1, 6, 1, 0.18750, 165, 220, -55, 
1950, California (PA), 3, 3, 0, 0.50000, 50, 67, -17, 
1951, California (PA), 7, 2, 0, 0.77778, 202, 83, 119, 
1952, California (PA), 3, 4, 1, 0.43750, 93, 143, -50, 
1953, California (PA), 3, 5, 0, 0.37500, 104, 127, -23, 
1954, California (PA), 4, 3, 0, 0.57143, 118, 99, 19, 
1955, California (PA), 4, 4, 0, 0.50000, 98, 80, 18, 
1956, California (PA), 2, 7, 0, 0.22222, 85, 155, -70, 
1957, California (PA), 2, 5, 0, 0.28571, 103, 162, -59, 
1958, California (PA), 8, 0, 0, 1.00000, 202, 31, 171, 
1959, California (PA), 6, 2, 0, 0.75000, 148, 51, 97, 
1960, California (PA), 7, 1, 0, 0.87500, 153, 74, 79, 
1961, California (PA), 5, 2, 1, 0.68750, 156, 111, 45, 
2010, Truman St. (MO), 4, 7, 0, 0.36364, 243, 352, -109, 
2011, Truman St. (MO), 4, 7, 0, 0.36364, 253, 358, -105, 
2012, Truman St. (MO), 4, 7, 0, 0.36364, 264, 308, -44, 
2013, Truman St. (MO), 7, 4, 0, 0.63636, 287, 224, 63, 
2013, West Texas A&M;, 11, 3, 0, 0.78571, 645, 355, 290, 
1995, Colorado, 10, 2, 0, 0.83333, 444, 240, 204, 
1996, Colorado, 10, 2, 0, 0.83333, 352, 220, 132, 
1997, Colorado, 5, 6, 0, 0.45455, 300, 295, 5, 
1998, Colorado, 8, 4, 0, 0.66667, 302, 253, 49, 
1999, Washington, 7, 5, 0, 0.58333, 331, 302, 29, 
2000, Washington, 11, 1, 0, 0.91667, 387, 270, 117, 
2001, Washington, 8, 4, 0, 0.66667, 353, 370, -17, 
2002, Washington, 7, 6, 0, 0.53846, 398, 342, 56, 
2008, UCLA, 4, 8, 0, 0.33333, 212, 348, -136, 
2009, UCLA, 7, 6, 0, 0.53846, 286, 276, 10, 
2010, UCLA, 4, 8, 0, 0.33333, 242, 364, -122, 
2011, UCLA, 6, 7, 0, 0.46154, 309, 419, -110, 
1936, Lafayette (PA), 1, 8, 0, 0.11111, 26, 220, -194, 
1919, Central Michigan, 2, 2, 3, 0.50000, 88, 89, -1, 
1978, Tennessee-Martin, 2, 8, 0, 0.20000, 145, 241, -96, 
1979, Tennessee-Martin, 5, 5, 0, 0.50000, 133, 182, -49, 
1925, Shepherd (WV), 4, 2, 1, 0.64286, 117, 43, 74, 
1926, Shepherd (WV), 2, 4, 0, 0.33333, 39, 161, -122, 
1927, Shepherd (WV), 4, 3, 0, 0.57143, 70, 46, 24, 
1928, Shepherd (WV), 4, 4, 0, 0.50000, 113, 136, -23, 
1929, Shepherd (WV), 2, 6, 0, 0.25000, 87, 160, -73, 
1930, Shepherd (WV), 2, 3, 1, 0.41667, 28, 65, -37, 
1931, Shepherd (WV), 4, 3, 1, 0.56250, 106, 92, 14, 
1932, Shepherd (WV), 4, 3, 0, 0.57143, 98, 71, 27, 
1933, Shepherd (WV), 5, 2, 0, 0.71429, 105, 86, 19, 
1934, Shepherd (WV), 1, 5, 0, 0.16667, 39, 108, -69, 
1935, Shepherd (WV), 1, 6, 1, 0.18750, 31, 131, -100, 
1936, Shepherd (WV), 1, 5, 1, 0.21429, 46, 153, -107, 
1937, Shepherd (WV), 2, 4, 1, 0.35714, 55, 61, -6, 
1938, Shepherd (WV), 1, 4, 2, 0.28571, 28, 53, -25, 
1939, Shepherd (WV), 1, 6, 0, 0.14286, 20, 91, -71, 
1940, Shepherd (WV), 1, 5, 0, 0.16667, 21, 197, -176, 
1941, Shepherd (WV), 0, 5, 0, 0.00000, 12, 129, -117, 
1894, Cornell (NY), 6, 4, 1, 0.59091, 178, 58, 120, 
1895, Cornell (NY), 3, 4, 1, 0.43750, 28, 91, -63, 
1909, Georgetown (DC), 3, 2, 1, 0.58333, 59, 31, 28, 
1896, Penn St., 3, 4, 0, 0.42857, 63, 128, -65, 
1897, Penn St., 3, 6, 0, 0.33333, 69, 141, -72, 
1898, Penn St., 6, 4, 0, 0.60000, 174, 91, 83, 
1899, Lafayette (PA), 12, 1, 0, 0.92308, 253, 23, 230, 
1900, Lafayette (PA), 9, 2, 0, 0.81818, 214, 25, 189, 
1901, Lafayette (PA), 9, 3, 0, 0.75000, 240, 94, 146, 
1902, Lehigh (PA), 7, 3, 1, 0.68182, 246, 57, 189, 
1903, Lehigh (PA), 9, 2, 1, 0.79167, 331, 45, 286, 
1904, Lehigh (PA), 1, 8, 0, 0.11111, 52, 236, -184, 
1905, Lehigh (PA), 6, 7, 0, 0.46154, 154, 201, -47, 
1932, Davidson (NC), 4, 4, 1, 0.50000, 82, 52, 30, 
1933, Davidson (NC), 6, 2, 1, 0.72222, 109, 70, 39, 
1934, Davidson (NC), 4, 4, 1, 0.50000, 105, 123, -18, 
1935, Davidson (NC), 4, 3, 2, 0.55556, 69, 80, -11, 
1937, North Carolina St., 5, 3, 1, 0.61111, 91, 92, -1, 
1938, North Carolina St., 3, 7, 1, 0.31818, 59, 100, -41, 
1939, North Carolina St., 2, 8, 0, 0.20000, 49, 191, -142, 
1940, North Carolina St., 3, 6, 0, 0.33333, 120, 161, -41, 
1941, North Carolina St., 4, 5, 2, 0.45455, 122, 143, -21, 
1942, North Carolina St., 4, 4, 2, 0.50000, 70, 142, -72, 
1943, North Carolina St., 3, 6, 0, 0.33333, 78, 227, -149, 
1944, South Carolina, 3, 4, 2, 0.44444, 135, 106, 29, 
1926, Tennessee, 8, 1, 0, 0.88889, 151, 34, 117, 
1927, Tennessee, 8, 0, 1, 0.94444, 245, 26, 219, 
1928, Tennessee, 9, 0, 1, 0.95000, 249, 51, 198, 
1929, Tennessee, 9, 0, 1, 0.95000, 330, 19, 311, 
1930, Tennessee, 9, 1, 0, 0.90000, 209, 31, 178, 
1931, Tennessee, 9, 0, 1, 0.95000, 243, 15, 228, 
1932, Tennessee, 9, 0, 1, 0.95000, 238, 36, 202, 
1933, Tennessee, 7, 3, 0, 0.70000, 176, 47, 129, 
1934, Tennessee, 8, 2, 0, 0.80000, 175, 58, 117, 
1936, Tennessee, 6, 2, 2, 0.70000, 147, 52, 95, 
1937, Tennessee, 6, 3, 1, 0.65000, 189, 47, 142, 
1938, Tennessee, 11, 0, 0, 1.00000, 293, 16, 277, 
1939, Tennessee, 10, 1, 0, 0.90909, 212, 14, 198, 
1940, Tennessee, 10, 1, 0, 0.90909, 331, 45, 286, 
1946, Tennessee, 9, 2, 0, 0.81818, 175, 97, 78, 
1947, Tennessee, 5, 5, 0, 0.50000, 164, 152, 12, 
1948, Tennessee, 4, 4, 2, 0.50000, 140, 98, 42, 
1949, Tennessee, 7, 2, 1, 0.75000, 214, 104, 110, 
1950, Tennessee, 11, 1, 0, 0.91667, 335, 71, 264, 
1951, Tennessee, 10, 1, 0, 0.90909, 386, 116, 270, 
1952, Tennessee, 8, 2, 1, 0.77273, 259, 79, 180, 
1914, Temple (PA), 5, 5, 1, 0.50000, 163, 92, 71, 
1915, Temple (PA), 3, 1, 1, 0.70000, 32, 40, -8, 
1916, Temple (PA), 4, 1, 2, 0.71429, 67, 14, 53, 
1976, Beloit (WI), 2, 7, 0, 0.22222, 71, 296, -225, 
1896, George Washington (DC), 2, 1, 0, 0.66667, 70, 10, 60, 
1897, George Washington (DC), 4, 5, 1, 0.45000, 68, 50, 18, 
1898, George Washington (DC), 2, 6, 0, 0.25000, 44, 182, -138, 
1902, George Washington (DC), 1, 5, 0, 0.16667, 15, 91, -76, 
2009, Presbyterian (SC), 0, 11, 0, 0.00000, 214, 441, -227, 
2010, Presbyterian (SC), 2, 9, 0, 0.18182, 223, 373, -150, 
2011, Presbyterian (SC), 4, 7, 0, 0.36364, 276, 347, -71, 
2012, Presbyterian (SC), 2, 9, 0, 0.18182, 171, 417, -246, 
2013, Presbyterian (SC), 3, 8, 0, 0.27273, 258, 358, -100, 
2007, Faulkner (AL), 1, 9, 0, 0.10000, 134, 332, -198, 
2008, Faulkner (AL), 2, 9, 0, 0.18182, 145, 422, -277, 
2013, Davidson (NC), 0, 11, 0, 0.00000, 154, 445, -291, 
1895, Washington, 4, 0, 1, 0.90000, 98, 8, 90, 
1896, Washington, 2, 3, 0, 0.40000, 20, 40, -20, 
1898, Washington, 1, 1, 0, 0.50000, 24, 18, 6, 
1930, Toledo (OH), 2, 5, 1, 0.31250, 50, 138, -88, 
1932, Toledo (OH), 3, 4, 0, 0.42857, 42, 40, 2, 
1933, Toledo (OH), 4, 2, 2, 0.62500, 100, 66, 34, 
1934, Toledo (OH), 5, 3, 0, 0.62500, 123, 55, 68, 
1935, Toledo (OH), 6, 2, 1, 0.72222, 185, 32, 153, 
1921, Sewanee (TN), 6, 2, 0, 0.75000, 221, 30, 191, 
1922, Sewanee (TN), 3, 4, 1, 0.43750, 61, 91, -30, 
1956, Abilene Christian (TX), 4, 6, 0, 0.40000, 123, 200, -77, 
1957, Abilene Christian (TX), 5, 3, 1, 0.61111, 183, 103, 80, 
1958, Abilene Christian (TX), 5, 5, 0, 0.50000, 202, 200, 2, 
1959, Abilene Christian (TX), 5, 5, 0, 0.50000, 109, 147, -38, 
1960, Abilene Christian (TX), 5, 5, 0, 0.50000, 134, 178, -44, 
1961, Abilene Christian (TX), 4, 6, 0, 0.40000, 153, 200, -47, 
2004, Kalamazoo (MI), 1, 9, 0, 0.10000, 153, 277, -124, 
1939, Oklahoma Baptist University, 8, 2, 0, 0.80000, 196, 38, 158, 
1940, Oklahoma Baptist University, 8, 2, 1, 0.77273, 173, 75, 98, 
1946, West Texas A&M;, 2, 1, 0, 0.66667, 21, 34, -13, 
1945, Prairie View A&M; (TX), 3, 5, 1, 0.38889, 82, 145, -63, 
1946, Prairie View A&M; (TX), 6, 2, 2, 0.70000, 153, 85, 68, 
1947, Prairie View A&M; (TX), 5, 6, 0, 0.45455, 82, 137, -55, 
1952, Prairie View A&M; (TX), 7, 2, 0, 0.77778, 287, 67, 220, 
1953, Prairie View A&M; (TX), 12, 0, 0, 1.00000, 387, 88, 299, 
1954, Prairie View A&M; (TX), 10, 1, 0, 0.90909, 255, 116, 139, 
1955, Prairie View A&M; (TX), 8, 2, 1, 0.77273, 335, 117, 218, 
1956, Prairie View A&M; (TX), 5, 5, 0, 0.50000, 151, 181, -30, 
1957, Prairie View A&M; (TX), 6, 3, 1, 0.65000, 153, 110, 43, 
1958, Prairie View A&M; (TX), 10, 0, 1, 0.95455, 369, 101, 268, 
1959, Prairie View A&M; (TX), 9, 2, 0, 0.81818, 357, 120, 237, 
1960, Prairie View A&M; (TX), 10, 1, 0, 0.90909, 266, 139, 127, 
1961, Prairie View A&M; (TX), 5, 4, 1, 0.55000, 241, 156, 85, 
1962, Prairie View A&M; (TX), 6, 3, 0, 0.66667, 240, 139, 101, 
1963, Prairie View A&M; (TX), 10, 1, 0, 0.90909, 364, 144, 220, 
1964, Prairie View A&M; (TX), 9, 0, 0, 1.00000, 303, 110, 193, 
1965, Prairie View A&M; (TX), 5, 3, 1, 0.61111, 121, 141, -20, 
1969, Duquesne (PA), 2, 4, 0, 0.33333, 65, 130, -65, 
1947, Indianapolis (IN), 7, 1, 0, 0.87500, 168, 71, 97, 
1948, Indianapolis (IN), 4, 4, 0, 0.50000, 104, 212, -108, 
1949, Indianapolis (IN), 4, 4, 0, 0.50000, 139, 116, 23, 
1954, Indianapolis (IN), 6, 3, 0, 0.66667, 216, 110, 106, 
2013, Western Illinois, 4, 8, 0, 0.33333, 257, 303, -46, 
1897, Albion (MI), 4, 3, 1, 0.56250, 95, 115, -20, 
1946, DePauw (IN), 1, 5, 2, 0.25000, 58, 195, -137, 
1915, Montana, 2, 2, 2, 0.50000, 95, 56, 39, 
1916, Montana, 4, 1, 1, 0.75000, 74, 46, 28, 
1917, Montana, 1, 4, 0, 0.20000, 21, 84, -63, 
1946, Coast Guard (CT), 3, 5, 0, 0.37500, 112, 220, -108, 
1947, Coast Guard (CT), 2, 3, 2, 0.42857, 66, 94, -28, 
1948, Coast Guard (CT), 4, 3, 0, 0.57143, 90, 98, -8, 
1949, Coast Guard (CT), 5, 3, 0, 0.62500, 161, 138, 23, 
1950, Coast Guard (CT), 3, 4, 0, 0.42857, 123, 118, 5, 
1951, Coast Guard (CT), 6, 0, 1, 0.92857, 178, 93, 85, 
1952, Coast Guard (CT), 5, 2, 0, 0.71429, 174, 112, 62, 
1953, Coast Guard (CT), 4, 2, 1, 0.64286, 70, 62, 8, 
1954, Coast Guard (CT), 3, 4, 0, 0.42857, 79, 126, -47, 
1955, Coast Guard (CT), 4, 3, 0, 0.57143, 94, 97, -3, 
1956, Coast Guard (CT), 2, 5, 0, 0.28571, 101, 128, -27, 
1957, Coast Guard (CT), 2, 5, 0, 0.28571, 74, 134, -60, 
1958, Coast Guard (CT), 2, 4, 1, 0.35714, 98, 168, -70, 
2007, Navy (MD), 0, 1, 0, 0.00000, 32, 35, -3, 
2008, Navy (MD), 8, 5, 0, 0.61538, 353, 286, 67, 
2009, Navy (MD), 10, 4, 0, 0.71429, 392, 272, 120, 
2010, Navy (MD), 9, 4, 0, 0.69231, 386, 303, 83, 
2011, Navy (MD), 5, 7, 0, 0.41667, 356, 347, 9, 
2012, Navy (MD), 8, 5, 0, 0.61538, 325, 334, -9, 
2013, Navy (MD), 9, 4, 0, 0.69231, 436, 317, 119, 
1984, Tennessee-Chattanooga, 6, 5, 0, 0.54545, 140, 186, -46, 
1985, Tennessee-Chattanooga, 6, 5, 0, 0.54545, 209, 155, 54, 
1986, Tennessee-Chattanooga, 4, 7, 0, 0.36364, 223, 233, -10, 
1987, Tennessee-Chattanooga, 6, 5, 0, 0.54545, 185, 181, 4, 
1988, Tennessee-Chattanooga, 4, 7, 0, 0.36364, 213, 220, -7, 
1989, Tennessee-Chattanooga, 3, 7, 1, 0.31818, 161, 234, -73, 
1990, Tennessee-Chattanooga, 6, 5, 0, 0.54545, 227, 243, -16, 
1991, Tennessee-Chattanooga, 7, 4, 0, 0.63636, 305, 293, 12, 
1992, Tennessee-Chattanooga, 2, 9, 0, 0.18182, 223, 391, -168, 
1999, Henderson St. (AR), 2, 9, 0, 0.18182, 135, 347, -212, 
2000, Henderson St. (AR), 1, 10, 0, 0.09091, 219, 442, -223, 
1911, Central Arkansas, 3, 3, 0, 0.50000, 36, 112, -76, 
1912, Central Arkansas, 4, 0, 0, 1.00000, 43, 7, 36, 
1869, Rutgers (NJ), 2, 2, 0, 0.50000, 18, 18, 0, 
1870, Rutgers (NJ), 2, 2, 0, 0.50000, 17, 17, 0, 
1872, Columbia (NY), 5, 4, 0, 0.55556, 22, 16, 6, 
1873, Rutgers (NJ), 7, 4, 1, 0.62500, 31, 26, 5, 
1874, Harvard (MA), 9, 7, 0, 0.56250, 54, 41, 13, 
1875, Harvard (MA), 12, 6, 2, 0.65000, 52, 29, 23, 
1876, Harvard (MA), 13, 8, 1, 0.61364, 45, 29, 16, 
1877, Harvard (MA), 9, 7, 3, 0.55263, 31, 21, 10, 
1878, Pennsylvania, 14, 9, 5, 0.58929, 42, 24, 18, 
1879, Harvard (MA), 13, 9, 12, 0.55882, 46, 27, 19, 
1880, Harvard (MA), 18, 11, 4, 0.60606, 75, 53, 22, 
1881, Rutgers (NJ), 22, 18, 8, 0.54167, 70, 47, 23, 
1882, Rutgers (NJ), 41, 28, 2, 0.59155, 176, 111, 65, 
1883, Rutgers (NJ), 38, 32, 1, 0.54225, 1288, 965, 323, 
1884, Pennsylvania, 47, 29, 5, 0.61111, 1728, 1184, 544, 
1885, Michigan, 34, 17, 4, 0.65455, 1437, 612, 825, 
1886, Lehigh (PA), 48, 21, 4, 0.68493, 1850, 637, 1213, 
1887, California, 67, 35, 3, 0.65238, 2660, 935, 1725, 
1888, Princeton (NJ), 70, 56, 6, 0.55303, 2468, 1899, 569, 
1889, Brown (RI), 83, 51, 11, 0.61034, 2907, 1796, 1111, 
1890, Brown (RI), 77, 76, 9, 0.50309, 3002, 2455, 547, 
1891, Southern California, 95, 76, 12, 0.55191, 2817, 2189, 628, 
1892, Minnesota, 94, 80, 9, 0.53825, 2988, 2394, 594, 
1893, Duke (NC), 79, 94, 9, 0.45879, 2176, 2912, -736, 
1894, Worcester Tech (MA), 52, 64, 5, 0.45041, 1199, 1528, -329, 
1895, Boston (MA), 32, 44, 11, 0.43103, 696, 1031, -335, 
1896, Rhode Island, 54, 63, 12, 0.46512, 1126, 1223, -97, 
1897, Boston (MA), 32, 40, 6, 0.44872, 792, 785, 7, 
1898, Miami (OH), 47, 23, 4, 0.66216, 921, 644, 277, 
1899, New Hampshire, 34, 32, 6, 0.51389, 599, 522, 77, 
1900, Akron (OH), 23, 36, 11, 0.40714, 464, 703, -239, 
1901, Marshall (WV), 18, 34, 3, 0.35455, 302, 917, -615, 
1902, Southern California, 10, 22, 4, 0.33333, 179, 460, -281, 
1903, Texas Christian, 15, 25, 2, 0.38095, 400, 546, -146, 
1904, Oklahoma St., 11, 14, 1, 0.44231, 194, 395, -201, 
1905, Miami (OH), 7, 25, 5, 0.25676, 245, 494, -249, 
1906, Worcester Tech (MA), 3, 7, 4, 0.35714, 92, 107, -15, 
1907, Worcester Tech (MA), 5, 10, 2, 0.35294, 71, 238, -167, 
1908, Worcester Tech (MA), 5, 6, 1, 0.45833, 56, 91, -35, 
1909, Fort Hays St. (KS), 1, 3, 1, 0.30000, 12, 68, -56, 
1910, Texas St., 0, 1, 0, 0.00000, 0, 19, -19, 
1912, Fort Hays St. (KS), 1, 2, 0, 0.33333, 20, 132, -112, 
1913, Eureka (IL), 1, 6, 0, 0.14286, 39, 203, -164, 
1914, Eureka (IL), 3, 4, 0, 0.42857, 57, 201, -144, 
1915, Texas St., 1, 1, 1, 0.50000, 13, 20, -7, 
1916, Texas St., 0, 2, 1, 0.16667, 0, 106, -106, 
1917, Boston (MA), 4, 4, 0, 0.50000, 73, 136, -63, 
1918, Canisius (NY), 1, 7, 0, 0.12500, 26, 137, -111, 
1930, Troy (AL), 1, 2, 0, 0.33333, 7, 73, -66, 
2013, Grambling St. (LA), 0, 1, 0, 0.00000, 0, 0, 0, 
1885, Minnesota, 0, 2, 0, 0.00000, 13, 27, -14, 
1890, Kentucky, 1, 0, 0, 1.00000, 8, 2, 6, 
1896, Saint John's (NY), 4, 3, 1, 0.56250, 150, 38, 112, 
1897, Saint John's (NY), 2, 1, 1, 0.62500, 32, 16, 16, 
1898, Saint John's (NY), 1, 4, 0, 0.20000, 27, 98, -71, 
1899, Saint John's (NY), 2, 1, 0, 0.66667, 112, 40, 72, 
1900, Boston College (MA), 1, 0, 0, 1.00000, 5, 0, 5, 
1901, Saint John's (NY), 1, 1, 0, 0.50000, 11, 61, -50, 
1902, La Salle (PA), 1, 7, 0, 0.12500, 24, 98, -74, 
1903, Saint John's (NY), 0, 3, 0, 0.00000, 0, 28, -28, 
1904, Louisiana-Lafayette, 4, 0, 1, 0.90000, 70, 29, 41, 
1906, Saint John's (NY), 0, 1, 0, 0.00000, 5, 37, -32, 
1907, Saint John's (NY), 0, 1, 0, 0.00000, 0, 12, -12, 
1908, Saint John's (NY), 0, 3, 0, 0.00000, 0, 35, -35, 
1909, North Carolina A&T;, 0, 1, 0, 0.00000, 0, 11, -11, 
1910, Clarion (PA), 0, 1, 0, 0.00000, 0, 39, -39, 
1917, Texas St., 1, 0, 0, 1.00000, 12, 0, 12, 
1924, Manhattan (NY), 4, 4, 0, 0.50000, 74, 69, 5, 
1929, Campbellsville (KY), 0, 1, 0, 0.00000, 6, 54, -48, 
1943, William & Mary Freshmen (VA), 4, 2, 0, 0.66667, 157, 56, 101, 
1917, Mississippi, 1, 4, 1, 0.25000, 49, 226, -177, 
1918, Mississippi, 1, 3, 0, 0.25000, 39, 53, -14, 
1922, Mississippi St., 3, 4, 2, 0.44444, 56, 184, -128, 
1929, Michigan Tech, 2, 2, 1, 0.50000, 57, 60, -3, 
1930, Michigan Tech, 1, 5, 0, 0.16667, 27, 110, -83, 
1931, Michigan Tech, 3, 2, 0, 0.60000, 63, 56, 7, 
1932, Michigan Tech, 4, 2, 0, 0.66667, 37, 51, -14, 
1933, Michigan Tech, 2, 2, 0, 0.50000, 39, 26, 13, 
1934, Michigan Tech, 1, 3, 1, 0.30000, 15, 19, -4, 
1935, Michigan Tech, 2, 2, 1, 0.50000, 76, 42, 34, 
1987, Glenville St. (WV), 3, 6, 1, 0.35000, 172, 239, -67, 
1988, Glenville St. (WV), 3, 7, 0, 0.30000, 110, 180, -70, 
1989, Glenville St. (WV), 1, 8, 0, 0.11111, 38, 305, -267, 
2013, Sacred Heart (CT), 10, 3, 0, 0.76923, 450, 277, 173, 
1902, Army (NY), 6, 1, 1, 0.81250, 180, 28, 152, 
1940, Southwestern (KS), 3, 5, 1, 0.38889, 47, 117, -70, 
1941, Southwestern (KS), 9, 3, 1, 0.73077, 171, 43, 128, 
1983, Central Missouri St., 6, 5, 0, 0.54545, 255, 198, 57, 
1984, Central Missouri St., 5, 6, 0, 0.45455, 189, 225, -36, 
1985, Central Missouri St., 3, 7, 0, 0.30000, 104, 216, -112, 
1986, Central Missouri St., 8, 3, 0, 0.72727, 263, 228, 35, 
1987, Central Missouri St., 7, 3, 1, 0.68182, 300, 202, 98, 
1988, Central Missouri St., 6, 5, 0, 0.54545, 240, 263, -23, 
1989, Central Missouri St., 5, 6, 0, 0.45455, 244, 259, -15, 
1990, Central Missouri St., 5, 5, 0, 0.50000, 179, 154, 25, 
1991, Central Missouri St., 5, 6, 0, 0.45455, 195, 288, -93, 
1992, Central Missouri St., 6, 4, 0, 0.60000, 155, 108, 47, 
1993, Central Missouri St., 7, 2, 1, 0.75000, 248, 138, 110, 
1994, Central Missouri St., 7, 3, 0, 0.70000, 304, 184, 120, 
1995, Central Missouri St., 4, 6, 0, 0.40000, 319, 287, 32, 
1996, Central Missouri St., 3, 5, 0, 0.37500, 163, 197, -34, 
1887, Franklin & Marshall (PA), 0, 2, 0, 0.00000, 4, 15, -11, 
1945, Cincinnati (OH), 4, 4, 0, 0.50000, 132, 88, 44, 
1946, Cincinnati (OH), 9, 2, 0, 0.81818, 221, 93, 128, 
1947, Cincinnati (OH), 7, 3, 0, 0.70000, 182, 168, 14, 
1948, Cincinnati (OH), 3, 6, 1, 0.35000, 106, 193, -87, 
1912, Samford (AL), 1, 7, 0, 0.12500, 14, 233, -219, 
1913, Samford (AL), 5, 3, 1, 0.61111, 153, 121, 32, 
1914, Samford (AL), 4, 3, 1, 0.56250, 92, 62, 30, 
1906, Oregon St., 4, 1, 2, 0.71429, 77, 4, 73, 
1907, Oregon St., 6, 0, 0, 1.00000, 137, 0, 137, 
1908, Oregon St., 4, 3, 1, 0.56250, 83, 51, 32, 
2000, Texas-El Paso, 8, 4, 0, 0.66667, 378, 336, 42, 
2001, Texas-El Paso, 2, 9, 0, 0.18182, 235, 414, -179, 
2002, Texas-El Paso, 2, 10, 0, 0.16667, 220, 511, -291, 
2003, Texas-El Paso, 2, 11, 0, 0.15385, 288, 498, -210, 
1920, Hanover (IN), 1, 5, 0, 0.16667, 50, 219, -169, 
1914, Utah, 3, 3, 0, 0.50000, 87, 108, -21, 
1915, Utah, 6, 2, 0, 0.75000, 175, 71, 104, 
1916, Utah, 3, 2, 0, 0.60000, 113, 45, 68, 
1917, Utah, 2, 4, 0, 0.33333, 48, 116, -68, 
1984, Concordia-Saint Paul (MN), 4, 5, 0, 0.44444, 107, 161, -54, 
1985, Concordia-Saint Paul (MN), 2, 7, 0, 0.22222, 106, 299, -193, 
1986, Concordia-Saint Paul (MN), 4, 5, 0, 0.44444, 194, 188, 6, 
1903, Bridgewater (VA), 3, 1, 1, 0.70000, 33, 33, 0, 
1904, Bridgewater (VA), 1, 2, 0, 0.33333, 6, 12, -6, 
1979, West Alabama, 3, 8, 0, 0.27273, 121, 247, -126, 
1980, West Alabama, 5, 5, 0, 0.50000, 151, 202, -51, 
1981, West Alabama, 6, 3, 0, 0.66667, 194, 151, 43, 
1982, West Alabama, 6, 4, 0, 0.60000, 172, 166, 6, 
1983, West Alabama, 6, 4, 0, 0.60000, 242, 165, 77, 
1984, West Alabama, 5, 5, 0, 0.50000, 273, 231, 42, 
1922, Hendrix (AR), 4, 6, 0, 0.40000, 169, 181, -12, 
1923, Hendrix (AR), 5, 4, 0, 0.55556, 136, 110, 26, 
2011, Prairie View A&M; (TX), 5, 6, 0, 0.45455, 279, 339, -60, 
2012, Prairie View A&M; (TX), 3, 8, 0, 0.27273, 305, 396, -91, 
2013, Prairie View A&M; (TX), 6, 6, 0, 0.50000, 468, 431, 37, 
1896, Mount Union (OH), 2, 4, 1, 0.35714, 130, 56, 74, 
1919, Centenary (LA), 2, 2, 0, 0.50000, 30, 12, 18, 
1920, Centenary (LA), 0, 1, 0, 0.00000, 0, 13, -13, 
1921, Centenary (LA), 4, 4, 0, 0.50000, 85, 80, 5, 
1926, Centenary (LA), 6, 3, 0, 0.66667, 206, 132, 74, 
1927, Centenary (LA), 10, 0, 0, 1.00000, 261, 37, 224, 
1928, Centenary (LA), 6, 3, 2, 0.63636, 231, 99, 132, 
1929, Centenary (LA), 6, 3, 1, 0.65000, 161, 73, 88, 
1930, Centenary (LA), 8, 1, 1, 0.85000, 127, 33, 94, 
1931, Centenary (LA), 5, 5, 0, 0.50000, 145, 102, 43, 
1932, Centenary (LA), 8, 0, 1, 0.94444, 183, 26, 157, 
1933, Centenary (LA), 8, 0, 4, 0.83333, 180, 25, 155, 
1934, Texas A&M;, 2, 7, 2, 0.27273, 84, 186, -102, 
1935, Texas A&M;, 3, 7, 0, 0.30000, 125, 121, 4, 
1936, Texas A&M;, 8, 3, 1, 0.70833, 156, 74, 82, 
1937, Texas A&M;, 5, 2, 2, 0.66667, 117, 59, 58, 
1938, Texas A&M;, 4, 4, 1, 0.50000, 137, 71, 66, 
1939, Texas A&M;, 11, 0, 0, 1.00000, 212, 31, 181, 
1940, Texas A&M;, 9, 1, 0, 0.90000, 183, 46, 137, 
1941, Texas A&M;, 9, 2, 0, 0.81818, 281, 75, 206, 
1942, Texas A&M;, 4, 5, 1, 0.45000, 130, 79, 51, 
1943, Texas A&M;, 7, 2, 1, 0.75000, 184, 65, 119, 
1944, Texas A&M;, 7, 4, 0, 0.63636, 289, 87, 202, 
1945, Texas A&M;, 6, 4, 0, 0.60000, 179, 103, 76, 
1946, Texas A&M;, 4, 6, 0, 0.40000, 125, 107, 18, 
1947, Texas A&M;, 3, 6, 1, 0.35000, 169, 185, -16, 
1901, South Dakota, 6, 1, 1, 0.81250, 117, 15, 102, 
1894, Brown (RI), 10, 5, 0, 0.66667, 264, 102, 162, 
1923, Doane (NE), 3, 4, 0, 0.42857, 106, 98, 8, 
1897, California, 0, 3, 2, 0.20000, 8, 58, -50, 
1996, Northern Illinois, 1, 10, 0, 0.09091, 157, 400, -243, 
1997, Northern Illinois, 0, 11, 0, 0.00000, 129, 382, -253, 
1998, Northern Illinois, 2, 9, 0, 0.18182, 160, 329, -169, 
1999, Northern Illinois, 5, 6, 0, 0.45455, 289, 289, 0, 
2000, Northern Illinois, 6, 5, 0, 0.54545, 409, 280, 129, 
2001, Northern Illinois, 6, 5, 0, 0.54545, 303, 292, 11, 
2002, Northern Illinois, 8, 4, 0, 0.66667, 375, 298, 77, 
2003, Northern Illinois, 10, 2, 0, 0.83333, 386, 258, 128, 
2004, Northern Illinois, 9, 3, 0, 0.75000, 421, 304, 117, 
2005, Northern Illinois, 7, 5, 0, 0.58333, 389, 274, 115, 
2006, Northern Illinois, 7, 6, 0, 0.53846, 331, 275, 56, 
2007, Northern Illinois, 2, 10, 0, 0.16667, 229, 370, -141, 
1934, Ashland (OH), 2, 6, 1, 0.27778, 45, 219, -174, 
1929, Central Michigan, 2, 3, 2, 0.42857, 71, 80, -9, 
1930, Central Michigan, 5, 2, 1, 0.68750, 102, 81, 21, 
1893, Northwestern (IL), 2, 5, 3, 0.35000, 92, 176, -84, 
1901, North Dakota, 3, 4, 0, 0.42857, 37, 60, -23, 
1903, Albion (MI), 4, 3, 2, 0.55556, 101, 117, -16, 
1949, Virginia Military Institute, 3, 5, 1, 0.38889, 157, 207, -50, 
1950, Virginia Military Institute, 6, 4, 0, 0.60000, 189, 166, 23, 
1951, Virginia Military Institute, 7, 3, 0, 0.70000, 227, 161, 66, 
1952, Virginia Military Institute, 3, 6, 1, 0.35000, 165, 279, -114, 
1953, Florida St., 5, 5, 0, 0.50000, 183, 146, 37, 
1954, Florida St., 8, 4, 0, 0.66667, 277, 190, 87, 
1955, Florida St., 5, 5, 0, 0.50000, 147, 186, -39, 
1956, Florida St., 5, 4, 1, 0.55000, 178, 116, 62, 
1957, Florida St., 4, 6, 0, 0.40000, 136, 165, -29, 
1958, Florida St., 7, 4, 0, 0.63636, 218, 124, 94, 
1959, Maryland, 5, 5, 0, 0.50000, 184, 188, -4, 
1960, Maryland, 6, 4, 0, 0.60000, 171, 164, 7, 
1961, Maryland, 7, 3, 0, 0.70000, 156, 141, 15, 
1962, Maryland, 6, 4, 0, 0.60000, 170, 128, 42, 
1963, Maryland, 3, 7, 0, 0.30000, 148, 201, -53, 
1964, Maryland, 5, 5, 0, 0.50000, 164, 126, 38, 
1965, Maryland, 4, 6, 0, 0.40000, 132, 164, -32, 
1942, Kalamazoo (MI), 4, 3, 0, 0.57143, 100, 98, 2, 
1946, Kalamazoo (MI), 6, 2, 0, 0.75000, 145, 45, 100, 
1947, Kalamazoo (MI), 4, 1, 3, 0.68750, 156, 57, 99, 
1948, Kalamazoo (MI), 4, 4, 1, 0.50000, 96, 118, -22, 
1986, Nevada-Las Vegas, 6, 5, 0, 0.54545, 286, 241, 45, 
1987, Nevada-Las Vegas, 5, 6, 0, 0.45455, 244, 290, -46, 
1988, Nevada-Las Vegas, 4, 7, 0, 0.36364, 176, 313, -137, 
1989, Nevada-Las Vegas, 4, 7, 0, 0.36364, 233, 340, -107, 
1924, Broaddus College (WV), 3, 4, 2, 0.44444, 29, 88, -59, 
1993, Murray St. (KY), 4, 7, 0, 0.36364, 201, 279, -78, 
1994, Murray St. (KY), 5, 6, 0, 0.45455, 262, 321, -59, 
1995, Murray St. (KY), 11, 1, 0, 0.91667, 455, 149, 306, 
1996, Murray St. (KY), 11, 2, 0, 0.84615, 463, 206, 257, 
1997, Boise St. (ID), 5, 6, 0, 0.45455, 285, 358, -73, 
1998, Arkansas, 9, 3, 0, 0.75000, 390, 227, 163, 
1999, Arkansas, 8, 4, 0, 0.66667, 353, 214, 139, 
2000, Arkansas, 6, 6, 0, 0.50000, 278, 289, -11, 
2001, Arkansas, 7, 5, 0, 0.58333, 294, 279, 15, 
2002, Arkansas, 9, 5, 0, 0.64286, 370, 277, 93, 
2003, Arkansas, 9, 4, 0, 0.69231, 436, 305, 131, 
2004, Arkansas, 5, 6, 0, 0.45455, 328, 270, 58, 
2005, Arkansas, 4, 7, 0, 0.36364, 283, 271, 12, 
2006, Arkansas, 10, 4, 0, 0.71429, 404, 256, 148, 
2007, Arkansas, 8, 4, 0, 0.66667, 478, 307, 171, 
2008, Mississippi, 9, 4, 0, 0.69231, 417, 247, 170, 
2009, Mississippi, 9, 4, 0, 0.69231, 384, 230, 154, 
2010, Mississippi, 4, 8, 0, 0.33333, 367, 422, -55, 
2011, Mississippi, 2, 10, 0, 0.16667, 193, 385, -192, 
1970, Indianapolis (IN), 3, 6, 0, 0.33333, 132, 217, -85, 
1971, Indianapolis (IN), 6, 5, 0, 0.54545, 186, 201, -15, 
2005, Chadron St. (NE), 4, 6, 0, 0.40000, 304, 235, 69, 
2006, Chadron St. (NE), 12, 1, 0, 0.92308, 479, 199, 280, 
2007, Chadron St. (NE), 12, 1, 0, 0.92308, 488, 192, 296, 
2008, Chadron St. (NE), 11, 2, 0, 0.84615, 434, 210, 224, 
2009, Chadron St. (NE), 7, 4, 0, 0.63636, 326, 200, 126, 
2010, Chadron St. (NE), 8, 3, 0, 0.72727, 329, 187, 142, 
2011, Chadron St. (NE), 0, 4, 0, 0.00000, 178, 172, 6, 
1947, Missouri St., 7, 2, 1, 0.75000, 130, 66, 64, 
1948, Missouri St., 9, 2, 0, 0.81818, 231, 66, 165, 
1962, Tulane (LA), 0, 10, 0, 0.00000, 76, 293, -217, 
1963, Tulane (LA), 1, 8, 1, 0.15000, 43, 191, -148, 
1964, Tulane (LA), 3, 7, 0, 0.30000, 79, 147, -68, 
1965, Tulane (LA), 2, 8, 0, 0.20000, 71, 268, -197, 
2012, Penn St., 8, 4, 0, 0.66667, 349, 229, 120, 
2013, Penn St., 7, 5, 0, 0.58333, 344, 314, 30, 
1998, Concordia-Saint Paul (MN), 5, 5, 0, 0.50000, 252, 221, 31, 
1999, Concordia-Saint Paul (MN), 2, 8, 0, 0.20000, 162, 361, -199, 
1917, Mount Union (OH), 2, 6, 0, 0.25000, 27, 132, -105, 
1918, Mount Union (OH), 6, 1, 0, 0.85714, 165, 27, 138, 
1919, Mount Union (OH), 1, 7, 0, 0.12500, 103, 215, -112, 
1916, Citadel (SC), 6, 1, 1, 0.81250, 157, 36, 121, 
1917, Citadel (SC), 3, 3, 0, 0.50000, 69, 68, 1, 
1918, Citadel (SC), 0, 2, 1, 0.16667, 0, 13, -13, 
1920, Citadel (SC), 2, 6, 0, 0.25000, 79, 166, -87, 
1921, Citadel (SC), 3, 3, 2, 0.50000, 105, 82, 23, 
1946, Eastern Illinois, 2, 6, 0, 0.25000, 65, 163, -98, 
1947, Eastern Illinois, 2, 6, 0, 0.25000, 103, 126, -23, 
1948, Eastern Illinois, 7, 3, 0, 0.70000, 165, 78, 87, 
1949, Eastern Illinois, 3, 5, 0, 0.37500, 112, 151, -39, 
1950, Eastern Illinois, 5, 3, 0, 0.62500, 186, 105, 81, 
1952, Eastern Illinois, 2, 7, 0, 0.22222, 113, 174, -61, 
1953, Eastern Illinois, 1, 8, 0, 0.11111, 52, 174, -122, 
1954, Eastern Illinois, 2, 6, 1, 0.27778, 108, 213, -105, 
1955, Eastern Illinois, 3, 6, 0, 0.33333, 123, 170, -47, 
1997, Boston College (MA), 4, 7, 0, 0.36364, 237, 314, -77, 
1998, Boston College (MA), 4, 7, 0, 0.36364, 273, 311, -38, 
1999, Boston College (MA), 8, 4, 0, 0.66667, 297, 308, -11, 
2000, Boston College (MA), 7, 5, 0, 0.58333, 378, 277, 101, 
2001, Boston College (MA), 8, 4, 0, 0.66667, 337, 227, 110, 
2002, Boston College (MA), 9, 4, 0, 0.69231, 392, 253, 139, 
2003, Boston College (MA), 8, 5, 0, 0.61538, 370, 331, 39, 
2004, Boston College (MA), 9, 3, 0, 0.75000, 296, 203, 93, 
2005, Boston College (MA), 9, 3, 0, 0.75000, 310, 191, 119, 
2006, Boston College (MA), 9, 3, 0, 0.75000, 313, 180, 133, 
2007, North Carolina St., 5, 7, 0, 0.41667, 249, 339, -90, 
2008, North Carolina St., 6, 7, 0, 0.46154, 305, 342, -37, 
2009, North Carolina St., 5, 7, 0, 0.41667, 364, 374, -10, 
2010, North Carolina St., 9, 4, 0, 0.69231, 414, 277, 137, 
2011, North Carolina St., 8, 5, 0, 0.61538, 367, 321, 46, 
2012, North Carolina St., 7, 5, 0, 0.58333, 341, 295, 46, 
1952, Southern Illinois, 2, 6, 0, 0.25000, 90, 210, -120, 
1953, Southern Illinois, 2, 7, 0, 0.22222, 97, 232, -135, 
1954, Southern Illinois, 2, 7, 0, 0.22222, 93, 154, -61, 
1993, North Carolina St., 7, 5, 0, 0.58333, 278, 327, -49, 
1994, North Carolina St., 9, 3, 0, 0.75000, 305, 275, 30, 
1995, North Carolina St., 3, 8, 0, 0.27273, 260, 354, -94, 
1996, North Carolina St., 3, 8, 0, 0.27273, 268, 401, -133, 
1997, North Carolina St., 6, 5, 0, 0.54545, 325, 268, 57, 
1998, North Carolina St., 7, 5, 0, 0.58333, 366, 352, 14, 
1999, North Carolina St., 6, 6, 0, 0.50000, 244, 302, -58, 
1959, Drake (IA), 2, 7, 0, 0.22222, 106, 247, -141, 
1904, Virginia Tech, 5, 3, 0, 0.62500, 121, 27, 94, 
1907, Dartmouth (NH), 8, 0, 1, 0.94444, 150, 10, 140, 
1908, Dartmouth (NH), 6, 1, 1, 0.81250, 97, 17, 80, 
2001, Fort Hays St. (KS), 3, 8, 0, 0.27273, 288, 322, -34, 
2002, Fort Hays St. (KS), 5, 6, 0, 0.45455, 300, 373, -73, 
2003, Fort Hays St. (KS), 6, 5, 0, 0.54545, 270, 248, 22, 
2004, Fort Hays St. (KS), 6, 5, 0, 0.54545, 295, 295, 0, 
1933, Cal Poly-San Luis Obispo, 7, 0, 0, 1.00000, 78, 0, 78, 
1934, Cal Poly-San Luis Obispo, 6, 2, 0, 0.75000, 115, 14, 101, 
1935, Cal Poly-San Luis Obispo, 5, 2, 1, 0.68750, 92, 35, 57, 
1936, Cal Poly-San Luis Obispo, 5, 4, 0, 0.55556, 96, 76, 20, 
1937, Cal Poly-San Luis Obispo, 4, 2, 2, 0.62500, 82, 34, 48, 
1938, Cal Poly-San Luis Obispo, 7, 2, 0, 0.77778, 119, 53, 66, 
1939, Cal Poly-San Luis Obispo, 4, 4, 1, 0.50000, 82, 108, -26, 
1940, Cal Poly-San Luis Obispo, 6, 3, 0, 0.66667, 148, 83, 65, 
1941, Cal Poly-San Luis Obispo, 5, 3, 1, 0.61111, 84, 72, 12, 
1946, Cal Poly-San Luis Obispo, 6, 2, 1, 0.72222, 152, 88, 64, 
1947, Cal Poly-San Luis Obispo, 1, 9, 0, 0.10000, 97, 332, -235, 
1888, Georgetown (DC), 4, 2, 0, 0.66667, 31, 34, -3, 
1900, Notre Dame (IN), 6, 3, 1, 0.65000, 261, 73, 188, 
1901, Notre Dame (IN), 8, 1, 1, 0.85000, 145, 19, 126, 
1902, Missouri, 5, 3, 0, 0.62500, 99, 80, 19, 
1916, Purdue (IN), 2, 4, 1, 0.35714, 67, 99, -32, 
1917, Purdue (IN), 3, 4, 0, 0.42857, 95, 109, -14, 
1919, Holy Cross (MA), 5, 3, 0, 0.62500, 174, 42, 132, 
1920, Holy Cross (MA), 5, 3, 0, 0.62500, 177, 44, 133, 
1921, Holy Cross (MA), 5, 3, 0, 0.62500, 153, 44, 109, 
1922, Holy Cross (MA), 7, 2, 1, 0.75000, 147, 53, 94, 
1923, Holy Cross (MA), 8, 2, 0, 0.80000, 272, 29, 243, 
1924, Holy Cross (MA), 7, 1, 1, 0.83333, 192, 36, 156, 
1925, Holy Cross (MA), 8, 2, 0, 0.80000, 209, 63, 146, 
1926, Holy Cross (MA), 7, 1, 2, 0.80000, 180, 51, 129, 
1927, Holy Cross (MA), 6, 3, 0, 0.66667, 125, 42, 83, 
1928, Holy Cross (MA), 5, 3, 2, 0.60000, 176, 50, 126, 
1929, Holy Cross (MA), 6, 4, 0, 0.60000, 147, 73, 74, 
1935, Saint Anselm (NH), 2, 3, 0, 0.40000, 57, 60, -3, 
1936, Saint Anselm (NH), 6, 0, 1, 0.92857, 137, 4, 133, 
1937, Saint Anselm (NH), 5, 2, 0, 0.71429, 119, 58, 61, 
1938, Saint Anselm (NH), 6, 0, 1, 0.92857, 153, 27, 126, 
1939, Saint Anselm (NH), 4, 2, 0, 0.66667, 127, 55, 72, 
1940, Saint Anselm (NH), 5, 4, 0, 0.55556, 96, 119, -23, 
1890, Georgetown (DC), 3, 3, 1, 0.50000, 40, 128, -88, 
1983, Texas St., 9, 2, 0, 0.81818, 358, 128, 230, 
1984, Texas St., 7, 4, 0, 0.63636, 240, 204, 36, 
1985, Texas St., 3, 8, 0, 0.27273, 247, 262, -15, 
1986, Texas St., 4, 7, 0, 0.36364, 200, 234, -34, 
1987, Texas St., 4, 7, 0, 0.36364, 186, 254, -68, 
1988, Texas St., 4, 7, 0, 0.36364, 222, 281, -59, 
1989, Texas St., 5, 6, 0, 0.45455, 245, 198, 47, 
1903, Samford (AL), 1, 1, 0, 0.50000, 6, 58, -52, 
1906, Massachusetts, 1, 7, 1, 0.16667, 33, 119, -86, 
1908, William & Mary (VA), 4, 6, 1, 0.40909, 49, 110, -61, 
1909, William & Mary (VA), 6, 4, 0, 0.60000, 65, 81, -16, 
1990, Allegheny (PA), 13, 0, 1, 0.96429, 442, 171, 271, 
1991, Allegheny (PA), 11, 1, 0, 0.91667, 424, 143, 281, 
1992, Allegheny (PA), 8, 2, 0, 0.80000, 384, 123, 261, 
1993, Allegheny (PA), 9, 2, 0, 0.81818, 439, 131, 308, 
1994, Allegheny (PA), 10, 1, 0, 0.90909, 489, 112, 377, 
1995, Allegheny (PA), 9, 1, 0, 0.90000, 425, 94, 331, 
1996, Allegheny (PA), 10, 1, 0, 0.90909, 479, 121, 358, 
1997, Allegheny (PA), 9, 2, 0, 0.81818, 437, 210, 227, 
1998, Fordham (NY), 4, 7, 0, 0.36364, 252, 336, -84, 
1994, Georgia Tech, 0, 3, 0, 0.00000, 33, 88, -55, 
1995, Georgia Tech, 6, 5, 0, 0.54545, 260, 243, 17, 
1996, Georgia Tech, 5, 6, 0, 0.45455, 220, 236, -16, 
1997, Georgia Tech, 7, 5, 0, 0.58333, 314, 296, 18, 
1998, Georgia Tech, 10, 2, 0, 0.83333, 426, 295, 131, 
1999, Georgia Tech, 8, 4, 0, 0.66667, 461, 361, 100, 
2000, Georgia Tech, 9, 3, 0, 0.75000, 386, 237, 149, 
2001, Georgia Tech, 7, 5, 0, 0.58333, 381, 267, 114, 
2004, Central Florida, 0, 11, 0, 0.00000, 175, 362, -187, 
2005, Central Florida, 8, 5, 0, 0.61538, 373, 373, 0, 
2006, Central Florida, 4, 8, 0, 0.33333, 232, 345, -113, 
2007, Central Florida, 10, 4, 0, 0.71429, 502, 372, 130, 
2008, Central Florida, 4, 8, 0, 0.33333, 199, 289, -90, 
2009, Central Florida, 8, 5, 0, 0.61538, 340, 293, 47, 
2010, Central Florida, 11, 3, 0, 0.78571, 449, 240, 209, 
2011, Central Florida, 5, 7, 0, 0.41667, 325, 220, 105, 
2012, Central Florida, 10, 4, 0, 0.71429, 496, 309, 187, 
2013, Central Florida, 12, 1, 0, 0.92308, 450, 277, 173, 
1920, Southern Mississippi, 5, 2, 1, 0.68750, 182, 82, 100, 
1951, Albany St. (GA), 5, 3, 0, 0.62500, 142, 98, 44, 
1952, Albany St. (GA), 7, 3, 0, 0.70000, 208, 111, 97, 
1953, Albany St. (GA), 2, 5, 1, 0.31250, 93, 88, 5, 
1954, Albany St. (GA), 3, 4, 1, 0.43750, 62, 96, -34, 
1955, Albany St. (GA), 7, 1, 0, 0.87500, 181, 72, 109, 
1956, Albany St. (GA), 3, 3, 2, 0.50000, 114, 116, -2, 
1957, Albany St. (GA), 4, 3, 1, 0.56250, 69, 77, -8, 
1958, Albany St. (GA), 4, 4, 0, 0.50000, 122, 90, 32, 
1959, Albany St. (GA), 4, 5, 0, 0.44444, 159, 101, 58, 
1960, Albany St. (GA), 7, 0, 2, 0.88889, 151, 0, 151, 
1961, Albany St. (GA), 6, 3, 0, 0.66667, 169, 95, 74, 
1962, Albany St. (GA), 6, 3, 0, 0.66667, 124, 96, 28, 
1963, Albany St. (GA), 4, 4, 0, 0.50000, 81, 101, -20, 
1964, Albany St. (GA), 5, 3, 0, 0.62500, 133, 79, 54, 
1965, Albany St. (GA), 5, 3, 2, 0.60000, 199, 253, -54, 
1966, Albany St. (GA), 4, 4, 1, 0.50000, 204, 143, 61, 
1967, Albany St. (GA), 3, 6, 0, 0.33333, 126, 122, 4, 
1915, Eureka (IL), 4, 4, 0, 0.50000, 43, 163, -120, 
1916, Eureka (IL), 5, 3, 0, 0.62500, 232, 91, 141, 
1902, Colgate (NY), 5, 3, 1, 0.61111, 167, 55, 112, 
1904, Colgate (NY), 8, 1, 1, 0.85000, 268, 30, 238, 
1905, Colgate (NY), 5, 4, 0, 0.55556, 217, 83, 134, 
1906, Syracuse (NY), 6, 3, 0, 0.66667, 168, 75, 93, 
1907, Syracuse (NY), 5, 3, 1, 0.61111, 133, 64, 69, 
1913, Syracuse (NY), 6, 4, 0, 0.60000, 271, 126, 145, 
1914, Syracuse (NY), 5, 3, 2, 0.60000, 202, 95, 107, 
1915, Syracuse (NY), 9, 2, 2, 0.76923, 338, 29, 309, 
1917, Syracuse (NY), 8, 1, 1, 0.85000, 197, 61, 136, 
1918, Syracuse (NY), 5, 1, 0, 0.83333, 141, 21, 120, 
1919, Syracuse (NY), 8, 3, 0, 0.72727, 123, 41, 82, 
1920, Columbia (NY), 4, 4, 0, 0.50000, 96, 120, -24, 
1921, Columbia (NY), 2, 6, 0, 0.25000, 89, 148, -59, 
1922, Columbia (NY), 4, 5, 0, 0.44444, 147, 188, -41, 
1952, Massachusetts, 4, 3, 1, 0.56250, 189, 137, 52, 
1953, Massachusetts, 1, 7, 0, 0.12500, 101, 239, -138, 
1954, Massachusetts, 4, 4, 0, 0.50000, 127, 210, -83, 
1955, Massachusetts, 4, 4, 0, 0.50000, 172, 183, -11, 
1956, Massachusetts, 2, 5, 1, 0.31250, 90, 223, -133, 
1957, Massachusetts, 1, 5, 1, 0.21429, 60, 198, -138, 
1958, Massachusetts, 2, 6, 0, 0.25000, 117, 177, -60, 
1959, Massachusetts, 3, 5, 1, 0.38889, 111, 182, -71, 
1931, Montana, 1, 6, 0, 0.14286, 56, 155, -99, 
1932, Montana, 2, 7, 0, 0.22222, 84, 224, -140, 
1933, Montana, 3, 4, 0, 0.42857, 91, 85, 6, 
1934, Montana, 2, 5, 1, 0.31250, 90, 82, 8, 
1935, Colorado, 5, 4, 0, 0.55556, 140, 47, 93, 
1936, Colorado, 4, 3, 0, 0.57143, 99, 43, 56, 
1937, Colorado, 8, 1, 0, 0.88889, 262, 54, 208, 
1938, Colorado, 3, 4, 1, 0.43750, 78, 78, 0, 
1939, Colorado, 5, 3, 0, 0.62500, 106, 110, -4, 
1941, Wyoming, 2, 7, 1, 0.25000, 44, 233, -189, 
1942, Wyoming, 3, 5, 0, 0.37500, 106, 115, -9, 
1946, Wyoming, 1, 8, 1, 0.15000, 44, 192, -148, 
1931, Canisius (NY), 1, 5, 2, 0.25000, 39, 92, -53, 
1932, Canisius (NY), 1, 2, 1, 0.37500, 51, 34, 17, 
1935, Bowling Green (OH), 1, 6, 0, 0.14286, 25, 246, -221, 
1936, Bowling Green (OH), 4, 2, 3, 0.61111, 66, 60, 6, 
1937, Bowling Green (OH), 3, 4, 1, 0.43750, 56, 80, -24, 
1938, Bowling Green (OH), 3, 2, 3, 0.56250, 95, 41, 54, 
1939, Bowling Green (OH), 6, 1, 1, 0.81250, 159, 46, 113, 
1940, Bowling Green (OH), 3, 4, 1, 0.43750, 62, 122, -60, 
1949, Eastern Michigan, 0, 8, 0, 0.00000, 61, 180, -119, 
1950, Eastern Michigan, 3, 6, 0, 0.33333, 123, 191, -68, 
1951, Eastern Michigan, 4, 5, 0, 0.44444, 186, 183, 3, 
1958, East Stroudsburg (PA), 2, 5, 2, 0.33333, 75, 151, -76, 
1958, Bucknell (PA), 1, 8, 0, 0.11111, 97, 230, -133, 
1959, Bucknell (PA), 4, 5, 0, 0.44444, 119, 119, 0, 
1960, Bucknell (PA), 7, 2, 0, 0.77778, 188, 59, 129, 
1961, Bucknell (PA), 6, 3, 0, 0.66667, 107, 79, 28, 
1962, Bucknell (PA), 6, 3, 0, 0.66667, 208, 119, 89, 
1963, Bucknell (PA), 6, 3, 0, 0.66667, 164, 97, 67, 
1964, Bucknell (PA), 7, 2, 0, 0.77778, 255, 101, 154, 
1965, Pennsylvania, 4, 4, 1, 0.50000, 136, 192, -56, 
1966, Pennsylvania, 2, 7, 0, 0.22222, 176, 237, -61, 
1967, Pennsylvania, 3, 6, 0, 0.33333, 173, 237, -64, 
1968, Pennsylvania, 7, 2, 0, 0.77778, 165, 131, 34, 
1969, Pennsylvania, 4, 5, 0, 0.44444, 104, 185, -81, 
1970, Pennsylvania, 4, 5, 0, 0.44444, 185, 195, -10, 
1942, Yale (CT), 5, 3, 0, 0.62500, 116, 83, 33, 
1943, Yale (CT), 4, 5, 0, 0.44444, 132, 166, -34, 
1944, Yale (CT), 7, 0, 1, 0.93750, 120, 32, 88, 
1945, Yale (CT), 6, 3, 0, 0.66667, 160, 102, 58, 
1946, Yale (CT), 7, 1, 1, 0.83333, 272, 72, 200, 
1947, Yale (CT), 6, 3, 0, 0.66667, 182, 101, 81, 
1948, Washington, 2, 7, 1, 0.25000, 89, 189, -100, 
1949, Washington, 3, 7, 0, 0.30000, 167, 285, -118, 
1950, Washington, 8, 2, 0, 0.80000, 265, 134, 131, 
1951, Washington, 3, 6, 1, 0.35000, 273, 218, 55, 
1952, Washington, 7, 3, 0, 0.70000, 248, 201, 47, 
1893, Brown (RI), 6, 3, 0, 0.66667, 168, 88, 80, 
2012, Southern (LA), 4, 5, 0, 0.44444, 241, 249, -8, 
2013, Southern (LA), 9, 4, 0, 0.69231, 396, 380, 16, 
1955, Buffalo (NY), 4, 4, 1, 0.50000, 186, 118, 68, 
1956, Buffalo (NY), 5, 3, 0, 0.62500, 227, 122, 105, 
1957, Buffalo (NY), 5, 4, 0, 0.55556, 108, 101, 7, 
1958, Buffalo (NY), 8, 1, 0, 0.88889, 236, 101, 135, 
1959, Buffalo (NY), 8, 1, 0, 0.88889, 279, 93, 186, 
1960, Buffalo (NY), 4, 6, 0, 0.40000, 213, 238, -25, 
1961, Buffalo (NY), 4, 5, 0, 0.44444, 136, 163, -27, 
1962, Buffalo (NY), 6, 3, 0, 0.66667, 159, 148, 11, 
1963, Buffalo (NY), 5, 3, 1, 0.61111, 120, 85, 35, 
1964, Buffalo (NY), 4, 4, 1, 0.50000, 177, 97, 80, 
1965, Buffalo (NY), 5, 3, 2, 0.60000, 145, 78, 67, 
1952, Willamette (OR), 5, 2, 2, 0.66667, 248, 95, 153, 
1953, Willamette (OR), 2, 5, 1, 0.31250, 80, 159, -79, 
1954, Willamette (OR), 6, 2, 0, 0.75000, 145, 93, 52, 
1955, Willamette (OR), 1, 7, 0, 0.12500, 56, 172, -116, 
1956, Willamette (OR), 2, 4, 2, 0.37500, 97, 122, -25, 
1957, Willamette (OR), 5, 2, 2, 0.66667, 199, 139, 60, 
1958, Willamette (OR), 8, 1, 0, 0.88889, 281, 41, 240, 
1959, Willamette (OR), 5, 3, 1, 0.61111, 172, 150, 22, 
1960, Willamette (OR), 8, 0, 0, 1.00000, 247, 97, 150, 
1961, Willamette (OR), 4, 4, 0, 0.50000, 213, 163, 50, 
1962, Willamette (OR), 6, 3, 1, 0.65000, 199, 103, 96, 
1963, Willamette (OR), 3, 6, 0, 0.33333, 111, 183, -72, 
1964, Willamette (OR), 5, 3, 0, 0.62500, 141, 99, 42, 
1965, Willamette (OR), 6, 1, 1, 0.81250, 139, 64, 75, 
1966, Willamette (OR), 5, 4, 0, 0.55556, 241, 185, 56, 
1967, Willamette (OR), 7, 2, 0, 0.77778, 299, 104, 195, 
1968, Willamette (OR), 9, 1, 0, 0.90000, 251, 141, 110, 
1969, Willamette (OR), 2, 7, 0, 0.22222, 139, 219, -80, 
1970, Willamette (OR), 3, 5, 0, 0.37500, 93, 152, -59, 
1971, Willamette (OR), 5, 4, 0, 0.55556, 192, 115, 77, 
1899, New York (NY), 2, 6, 0, 0.25000, 29, 175, -146, 
1900, Lehigh (PA), 5, 6, 0, 0.45455, 79, 172, -93, 
1922, Western Michigan, 6, 0, 0, 1.00000, 160, 0, 160, 
1923, Western Michigan, 6, 1, 1, 0.81250, 159, 21, 138, 
1902, North Carolina, 5, 1, 3, 0.72222, 122, 34, 88, 
1903, North Carolina, 6, 3, 0, 0.66667, 137, 72, 65, 
1907, New York (NY), 5, 2, 0, 0.71429, 69, 69, 0, 
1908, New York (NY), 2, 3, 2, 0.42857, 27, 35, -8, 
1909, New York (NY), 6, 1, 1, 0.81250, 141, 20, 121, 
1910, New York (NY), 2, 4, 1, 0.35714, 47, 59, -12, 
1911, New York (NY), 1, 3, 3, 0.35714, 16, 42, -26, 
1912, New York (NY), 2, 6, 0, 0.25000, 32, 174, -142, 
1915, Kansas, 6, 2, 0, 0.75000, 153, 79, 74, 
1916, Kansas, 4, 3, 1, 0.56250, 68, 72, -4, 
1917, Kansas, 6, 2, 0, 0.75000, 126, 46, 80, 
1938, Adrian (MI), 0, 7, 1, 0.06250, 13, 219, -206, 
1939, Adrian (MI), 2, 6, 0, 0.25000, 47, 217, -170, 
1940, Adrian (MI), 1, 7, 0, 0.12500, 19, 119, -100, 
1941, Adrian (MI), 2, 6, 0, 0.25000, 21, 141, -120, 
1943, Villanova (PA), 5, 3, 0, 0.62500, 167, 119, 48, 
1944, Villanova (PA), 4, 4, 0, 0.50000, 53, 180, -127, 
1945, Villanova (PA), 4, 4, 0, 0.50000, 89, 169, -80, 
1946, Villanova (PA), 6, 4, 0, 0.60000, 182, 142, 40, 
1947, Villanova (PA), 6, 3, 1, 0.65000, 168, 106, 62, 
1948, Villanova (PA), 8, 2, 1, 0.77273, 282, 125, 157, 
1949, Loyola Marymount (CA), 6, 4, 0, 0.60000, 230, 226, 4, 
1950, Loyola Marymount (CA), 8, 1, 0, 0.88889, 296, 137, 159, 
1951, Loyola Marymount (CA), 3, 6, 0, 0.33333, 180, 229, -49, 
1952, Yale (CT), 7, 2, 0, 0.77778, 240, 120, 120, 
1953, Yale (CT), 5, 2, 2, 0.66667, 123, 89, 34, 
1954, Yale (CT), 5, 3, 1, 0.61111, 169, 154, 15, 
1955, Yale (CT), 7, 2, 0, 0.77778, 176, 79, 97, 
1956, Yale (CT), 8, 1, 0, 0.88889, 246, 97, 149, 
1957, Yale (CT), 6, 2, 1, 0.72222, 212, 88, 124, 
1958, Yale (CT), 2, 7, 0, 0.22222, 92, 203, -111, 
1959, Yale (CT), 6, 3, 0, 0.66667, 159, 95, 64, 
1960, Yale (CT), 9, 0, 0, 1.00000, 253, 73, 180, 
1961, Yale (CT), 4, 5, 0, 0.44444, 99, 105, -6, 
1962, Yale (CT), 2, 5, 2, 0.33333, 102, 108, -6, 
1899, Willamette (OR), 3, 2, 0, 0.60000, 49, 27, 22, 
1980, Tennessee-Chattanooga, 8, 3, 0, 0.72727, 300, 197, 103, 
1981, Tennessee-Chattanooga, 7, 3, 1, 0.68182, 217, 172, 45, 
1982, Tennessee-Chattanooga, 7, 4, 0, 0.63636, 235, 137, 98, 
1983, Tennessee-Chattanooga, 7, 4, 0, 0.63636, 227, 167, 60, 
1998, Auburn (AL), 2, 3, 0, 0.40000, 97, 106, -9, 
2010, Lindsey Wilson (KY), 5, 6, 0, 0.45455, 285, 347, -62, 
2011, Lindsey Wilson (KY), 8, 3, 0, 0.72727, 297, 269, 28, 
2012, Lindsey Wilson (KY), 3, 8, 0, 0.27273, 312, 372, -60, 
2013, Lindsey Wilson (KY), 8, 3, 0, 0.72727, 426, 259, 167, 
1933, Arizona, 5, 3, 0, 0.62500, 113, 35, 78, 
1934, Arizona, 7, 2, 1, 0.75000, 138, 54, 84, 
1935, Arizona, 7, 2, 0, 0.77778, 218, 45, 173, 
1936, Arizona, 5, 2, 3, 0.65000, 190, 54, 136, 
1937, Arizona, 8, 2, 0, 0.80000, 194, 88, 106, 
1938, Oregon, 4, 5, 0, 0.44444, 69, 138, -69, 
1939, Oregon, 3, 4, 1, 0.43750, 101, 74, 27, 
1940, Oregon, 4, 4, 1, 0.50000, 100, 58, 42, 
1941, Oregon, 5, 5, 0, 0.50000, 136, 184, -48, 
1945, Oregon, 3, 6, 0, 0.33333, 116, 124, -8, 
1946, Oregon, 4, 4, 1, 0.50000, 81, 118, -37, 
1994, Alabama A&M;, 4, 7, 0, 0.36364, 197, 259, -62, 
1995, Minnesota-Crookston, 3, 7, 0, 0.30000, 213, 320, -107, 
1996, Minnesota-Crookston, 7, 3, 0, 0.70000, 248, 135, 113, 
1997, Minnesota-Crookston, 7, 3, 0, 0.70000, 313, 172, 141, 
1998, Minnesota-Crookston, 6, 4, 0, 0.60000, 216, 190, 26, 
1999, Minnesota-Crookston, 3, 7, 0, 0.30000, 269, 284, -15, 
2000, Minnesota-Crookston, 6, 4, 0, 0.60000, 232, 197, 35, 
2001, Minnesota-Crookston, 4, 7, 0, 0.36364, 215, 385, -170, 
1929, Pacific Lutheran (WA), 3, 3, 0, 0.50000, 65, 138, -73, 
1930, Pacific Lutheran (WA), 5, 2, 0, 0.71429, 134, 57, 77, 
1931, Pacific Lutheran (WA), 6, 3, 0, 0.66667, 126, 76, 50, 
1932, Pacific Lutheran (WA), 3, 4, 0, 0.42857, 62, 71, -9, 
1933, Pacific Lutheran (WA), 1, 5, 0, 0.16667, 25, 98, -73, 
1934, Pacific Lutheran (WA), 5, 2, 0, 0.71429, 115, 48, 67, 
1935, Pacific Lutheran (WA), 5, 1, 1, 0.78571, 68, 26, 42, 
1936, Pacific Lutheran (WA), 5, 0, 2, 0.85714, 90, 6, 84, 
1937, Pacific Lutheran (WA), 3, 3, 1, 0.50000, 46, 62, -16, 
1938, Pacific Lutheran (WA), 2, 5, 1, 0.31250, 59, 99, -40, 
1939, Pacific Lutheran (WA), 7, 1, 0, 0.87500, 156, 99, 57, 
1940, Pacific Lutheran (WA), 8, 0, 0, 1.00000, 207, 53, 154, 
1941, Pacific Lutheran (WA), 8, 1, 0, 0.88889, 190, 59, 131, 
1946, Pacific Lutheran (WA), 3, 3, 1, 0.50000, 80, 62, 18, 
1948, North Central (IL), 1, 7, 0, 0.12500, 48, 113, -65, 
1949, North Central (IL), 3, 4, 1, 0.43750, 152, 120, 32, 
1950, North Central (IL), 4, 4, 0, 0.50000, 237, 212, 25, 
1951, North Central (IL), 3, 5, 0, 0.37500, 99, 186, -87, 
1952, North Central (IL), 0, 6, 1, 0.07143, 86, 202, -116, 
1953, North Central (IL), 2, 6, 0, 0.25000, 101, 211, -110, 
1954, North Central (IL), 2, 6, 0, 0.25000, 76, 127, -51, 
1955, North Central (IL), 2, 6, 0, 0.25000, 114, 90, 24, 
1996, Southern Oregon, 4, 5, 0, 0.44444, 224, 273, -49, 
1997, Southern Oregon, 5, 4, 0, 0.55556, 277, 185, 92, 
1998, Southern Oregon, 4, 6, 0, 0.40000, 288, 249, 39, 
1999, Southern Oregon, 7, 2, 0, 0.77778, 297, 199, 98, 
2000, Southern Oregon, 5, 4, 0, 0.55556, 226, 182, 44, 
2001, Southern Oregon, 9, 2, 0, 0.81818, 474, 185, 289, 
2002, Southern Oregon, 8, 3, 0, 0.72727, 334, 206, 128, 
2003, Southern Oregon, 5, 4, 0, 0.55556, 302, 192, 110, 
2004, Southern Oregon, 3, 6, 0, 0.33333, 133, 221, -88, 
1968, North Dakota, 3, 5, 0, 0.37500, 148, 179, -31, 
1969, North Dakota, 4, 5, 0, 0.44444, 205, 254, -49, 
1970, North Dakota, 5, 3, 1, 0.61111, 202, 138, 64, 
1971, North Dakota, 6, 3, 1, 0.65000, 245, 142, 103, 
1972, North Dakota, 10, 1, 0, 0.90909, 429, 161, 268, 
1973, North Dakota, 6, 4, 0, 0.60000, 291, 218, 73, 
1974, North Dakota, 6, 4, 0, 0.60000, 295, 296, -1, 
1975, North Dakota, 9, 1, 0, 0.90000, 320, 197, 123, 
1976, North Dakota, 1, 7, 1, 0.16667, 117, 233, -116, 
1977, North Dakota, 4, 6, 1, 0.40909, 165, 195, -30, 
1931, Augustana (SD), 2, 5, 0, 0.28571, 73, 119, -46, 
1932, Augustana (SD), 6, 1, 0, 0.85714, 90, 41, 49, 
1933, Augustana (SD), 5, 2, 0, 0.71429, 153, 32, 121, 
1934, Augustana (SD), 5, 3, 0, 0.62500, 139, 102, 37, 
1935, Augustana (SD), 7, 2, 0, 0.77778, 212, 79, 133, 
1936, Augustana (SD), 8, 1, 0, 0.88889, 247, 54, 193, 
1937, Augustana (SD), 8, 0, 0, 1.00000, 222, 45, 177, 
1938, Augustana (SD), 6, 1, 1, 0.81250, 97, 38, 59, 
1939, Augustana (SD), 6, 2, 0, 0.75000, 160, 70, 90, 
1940, Augustana (SD), 6, 2, 0, 0.75000, 167, 40, 127, 
1941, Augustana (SD), 7, 2, 0, 0.77778, 257, 59, 198, 
1942, Augustana (SD), 8, 0, 0, 1.00000, 214, 25, 189, 
1946, Augustana (SD), 0, 6, 1, 0.07143, 24, 137, -113, 
1948, Beloit (WI), 0, 7, 1, 0.06250, 37, 204, -167, 
1949, Beloit (WI), 2, 6, 0, 0.25000, 109, 133, -24, 
1957, West Liberty St. (WV), 2, 6, 1, 0.27778, 68, 146, -78, 
1958, West Liberty St. (WV), 2, 7, 0, 0.22222, 54, 155, -101, 
2013, Augustana (SD), 4, 7, 0, 0.36364, 222, 214, 8, 
1921, Carthage (WI), 5, 2, 0, 0.71429, 175, 57, 118, 
1922, Carthage (WI), 5, 4, 0, 0.55556, 126, 48, 78, 
1923, Carthage (WI), 4, 3, 1, 0.56250, 118, 74, 44, 
1924, Carthage (WI), 3, 4, 1, 0.43750, 46, 73, -27, 
1925, Carthage (WI), 4, 4, 1, 0.50000, 50, 34, 16, 
1926, Carthage (WI), 3, 3, 2, 0.50000, 101, 107, -6, 
1927, Carthage (WI), 2, 3, 2, 0.42857, 84, 70, 14, 
1928, Carthage (WI), 2, 3, 2, 0.42857, 37, 77, -40, 
1929, Carthage (WI), 3, 3, 1, 0.50000, 52, 38, 14, 
1930, Carthage (WI), 3, 4, 1, 0.43750, 66, 104, -38, 
1931, Carthage (WI), 5, 4, 1, 0.55000, 91, 103, -12, 
1932, Carthage (WI), 1, 4, 4, 0.33333, 53, 101, -48, 
1933, Carthage (WI), 4, 1, 2, 0.71429, 52, 67, -15, 
1934, Carthage (WI), 2, 6, 0, 0.25000, 76, 107, -31, 
1935, Carthage (WI), 4, 4, 0, 0.50000, 33, 109, -76, 
1971, Missouri, 1, 10, 0, 0.09091, 93, 260, -167, 
1972, Missouri, 7, 5, 0, 0.58333, 219, 311, -92, 
1973, Missouri, 8, 4, 0, 0.66667, 219, 152, 67, 
1974, Missouri, 7, 4, 0, 0.63636, 204, 217, -13, 
1975, Missouri, 6, 5, 0, 0.54545, 282, 241, 41, 
1976, Missouri, 6, 5, 0, 0.54545, 246, 241, 5, 
1977, Missouri, 4, 7, 0, 0.36364, 195, 180, 15, 
1948, Michigan, 9, 0, 0, 1.00000, 252, 44, 208, 
1949, Michigan, 6, 2, 1, 0.72222, 135, 85, 50, 
1950, Michigan, 6, 3, 1, 0.65000, 150, 114, 36, 
1951, Michigan, 4, 5, 0, 0.44444, 135, 122, 13, 
1952, Michigan, 5, 4, 0, 0.55556, 207, 134, 73, 
1953, Michigan, 6, 3, 0, 0.66667, 163, 101, 62, 
1954, Michigan, 6, 3, 0, 0.66667, 139, 87, 52, 
1955, Michigan, 7, 2, 0, 0.77778, 179, 94, 85, 
1956, Michigan, 7, 2, 0, 0.77778, 233, 123, 110, 
1957, Michigan, 5, 3, 1, 0.61111, 187, 147, 40, 
1958, Michigan, 2, 6, 1, 0.27778, 132, 211, -79, 
2002, Saint Francis (PA), 2, 8, 0, 0.20000, 101, 229, -128, 
2003, Saint Francis (PA), 1, 9, 0, 0.10000, 168, 367, -199, 
2004, Saint Francis (PA), 3, 8, 0, 0.27273, 207, 322, -115, 
2005, Saint Francis (PA), 3, 8, 0, 0.27273, 287, 343, -56, 
2006, Saint Francis (PA), 3, 8, 0, 0.27273, 227, 398, -171, 
2007, Saint Francis (PA), 3, 7, 0, 0.30000, 209, 349, -140, 
2008, Saint Francis (PA), 0, 11, 0, 0.00000, 125, 357, -232, 
2009, Saint Francis (PA), 2, 9, 0, 0.18182, 172, 281, -109, 
1949, Jamestown (ND), 3, 5, 0, 0.37500, 102, 159, -57, 
1950, Jamestown (ND), 2, 6, 0, 0.25000, 79, 134, -55, 
1969, Howard (DC), 3, 6, 0, 0.33333, 125, 160, -35, 
1976, Bowie St. (MD), 1, 7, 0, 0.12500, 75, 143, -68, 
1977, Bowie St. (MD), 3, 7, 0, 0.30000, 86, 204, -118, 
1978, Bowie St. (MD), 5, 4, 0, 0.55556, 108, 105, 3, 
1979, Bowie St. (MD), 2, 8, 0, 0.20000, 78, 223, -145, 
1980, Bowie St. (MD), 2, 8, 1, 0.22727, 109, 204, -95, 
1981, Bowie St. (MD), 5, 5, 0, 0.50000, 73, 183, -110, 
1982, Bowie St. (MD), 2, 8, 0, 0.20000, 145, 290, -145, 
1983, Bowie St. (MD), 1, 9, 0, 0.10000, 134, 307, -173, 
1984, Bowie St. (MD), 0, 10, 0, 0.00000, 40, 437, -397, 
1985, Bowie St. (MD), 0, 10, 0, 0.00000, 42, 363, -321, 
2005, Mississippi, 3, 8, 0, 0.27273, 148, 245, -97, 
2006, Mississippi, 4, 8, 0, 0.33333, 188, 275, -87, 
2007, Mississippi, 3, 9, 0, 0.25000, 241, 342, -101, 
2013, Southern California, 6, 2, 0, 0.75000, 241, 171, 70, 
1956, Ithaca (NY), 1, 5, 0, 0.16667, 37, 149, -112, 
1957, Ithaca (NY), 2, 5, 0, 0.28571, 96, 137, -41, 
1920, Johns Hopkins (MD), 4, 5, 0, 0.44444, 154, 176, -22, 
1921, Johns Hopkins (MD), 6, 3, 0, 0.66667, 132, 36, 96, 
1922, Johns Hopkins (MD), 5, 4, 1, 0.55000, 165, 82, 83, 
1923, Johns Hopkins (MD), 6, 2, 1, 0.72222, 166, 80, 86, 
1924, Johns Hopkins (MD), 5, 1, 2, 0.75000, 187, 29, 158, 
1925, Johns Hopkins (MD), 3, 3, 2, 0.50000, 54, 98, -44, 
1926, Johns Hopkins (MD), 4, 4, 0, 0.50000, 128, 124, 4, 
1927, Johns Hopkins (MD), 5, 2, 1, 0.68750, 146, 68, 78, 
1928, Johns Hopkins (MD), 2, 6, 0, 0.25000, 76, 183, -107, 
1929, Johns Hopkins (MD), 1, 8, 0, 0.11111, 42, 263, -221, 
1930, Johns Hopkins (MD), 3, 5, 0, 0.37500, 92, 131, -39, 
1931, Johns Hopkins (MD), 6, 2, 0, 0.75000, 164, 107, 57, 
1932, Johns Hopkins (MD), 5, 3, 0, 0.62500, 79, 68, 11, 
1933, Johns Hopkins (MD), 3, 5, 0, 0.37500, 95, 120, -25, 
1934, Johns Hopkins (MD), 2, 6, 0, 0.25000, 36, 110, -74, 
1935, Johns Hopkins (MD), 0, 5, 0, 0.00000, 12, 89, -77, 
1919, Adrian (MI), 4, 2, 1, 0.64286, 116, 67, 49, 
1946, Toledo (OH), 6, 2, 2, 0.70000, 200, 132, 68, 
1947, Toledo (OH), 9, 2, 0, 0.81818, 255, 115, 140, 
1991, Augsburg (MN), 2, 7, 0, 0.22222, 91, 315, -224, 
1992, Augsburg (MN), 3, 7, 0, 0.30000, 186, 282, -96, 
1993, Augsburg (MN), 5, 5, 0, 0.50000, 162, 239, -77, 
1994, Augsburg (MN), 5, 5, 0, 0.50000, 209, 198, 11, 
1995, Augsburg (MN), 6, 4, 0, 0.60000, 176, 218, -42, 
1996, Augsburg (MN), 3, 7, 0, 0.30000, 192, 273, -81, 
1997, Augsburg (MN), 10, 2, 0, 0.83333, 348, 243, 105, 
1998, Augsburg (MN), 6, 4, 0, 0.60000, 260, 190, 70, 
1999, Augsburg (MN), 6, 4, 0, 0.60000, 206, 237, -31, 
2000, Augsburg (MN), 3, 7, 0, 0.30000, 128, 222, -94, 
2001, Augsburg (MN), 4, 6, 0, 0.40000, 187, 249, -62, 
2002, Augsburg (MN), 2, 8, 0, 0.20000, 202, 293, -91, 
2003, Augsburg (MN), 5, 5, 0, 0.50000, 169, 282, -113, 
2004, Augsburg (MN), 2, 8, 0, 0.20000, 243, 274, -31, 
1918, Southern (LA), 0, 1, 0, 0.00000, 0, 10, -10, 
1963, Southern Utah, 4, 2, 0, 0.66667, 89, 115, -26, 
1964, Southern Utah, 4, 3, 1, 0.56250, 130, 108, 22, 
1914, North Central (IL), 2, 6, 0, 0.25000, 170, 176, -6, 
1915, North Central (IL), 5, 4, 0, 0.55556, 236, 109, 127, 
1916, North Central (IL), 8, 1, 1, 0.85000, 286, 74, 212, 
1907, Carthage (WI), 2, 5, 0, 0.28571, 49, 119, -70, 
1973, Nebraska, 9, 2, 1, 0.79167, 306, 163, 143, 
1974, Nebraska, 9, 3, 0, 0.75000, 373, 132, 241, 
1975, Nebraska, 10, 2, 0, 0.83333, 367, 137, 230, 
1976, Nebraska, 9, 3, 1, 0.73077, 416, 181, 235, 
1977, Nebraska, 9, 3, 0, 0.75000, 315, 200, 115, 
1978, Nebraska, 9, 3, 0, 0.75000, 444, 216, 228, 
1979, Nebraska, 10, 2, 0, 0.83333, 380, 131, 249, 
1980, Nebraska, 10, 2, 0, 0.83333, 470, 110, 360, 
1981, Nebraska, 9, 3, 0, 0.75000, 364, 125, 239, 
1982, Nebraska, 12, 1, 0, 0.92308, 514, 167, 347, 
1983, Nebraska, 12, 1, 0, 0.92308, 654, 217, 437, 
1984, Nebraska, 10, 2, 0, 0.83333, 387, 115, 272, 
1985, Nebraska, 9, 3, 0, 0.75000, 421, 163, 258, 
1986, Nebraska, 10, 2, 0, 0.83333, 446, 165, 281, 
1987, Nebraska, 10, 2, 0, 0.83333, 451, 164, 287, 
1988, Nebraska, 11, 2, 0, 0.84615, 477, 205, 272, 
1989, Nebraska, 10, 2, 0, 0.83333, 509, 215, 294, 
1990, Nebraska, 9, 3, 0, 0.75000, 434, 192, 242, 
1991, Nebraska, 9, 2, 1, 0.79167, 454, 230, 224, 
1992, Nebraska, 9, 3, 0, 0.75000, 441, 199, 242, 
1993, Nebraska, 11, 1, 0, 0.91667, 437, 194, 243, 
1994, Nebraska, 13, 0, 0, 1.00000, 459, 162, 297, 
1995, Nebraska, 12, 0, 0, 1.00000, 638, 174, 464, 
1996, Nebraska, 11, 2, 0, 0.84615, 553, 174, 379, 
1997, Nebraska, 13, 0, 0, 1.00000, 607, 214, 393, 
1915, Miles (AL), 4, 0, 0, 1.00000, 111, 9, 102, 
1895, Indiana, 4, 3, 1, 0.56250, 108, 90, 18, 
1927, Brooklyn Centre City College (NY), 1, 2, 2, 0.40000, 18, 45, -27, 
1928, Brooklyn Centre City College (NY), 5, 2, 1, 0.68750, 69, 53, 16, 
1929, Brooklyn Centre City College (NY), 3, 4, 1, 0.43750, 130, 98, 32, 
1930, Brooklyn (NY), 0, 5, 0, 0.00000, 13, 207, -194, 
1931, Brooklyn (NY), 3, 4, 1, 0.43750, 63, 93, -30, 
1932, Brooklyn (NY), 3, 4, 1, 0.43750, 110, 126, -16, 
1933, Brooklyn (NY), 1, 5, 1, 0.21429, 46, 139, -93, 
1934, Brooklyn (NY), 3, 5, 1, 0.38889, 54, 152, -98, 
1935, Brooklyn (NY), 0, 7, 1, 0.06250, 32, 209, -177, 
1936, Brooklyn (NY), 4, 5, 1, 0.45000, 129, 180, -51, 
1937, Brooklyn (NY), 7, 2, 0, 0.77778, 209, 50, 159, 
1938, Brooklyn (NY), 3, 5, 0, 0.37500, 57, 106, -49, 
1939, Brooklyn (NY), 2, 7, 0, 0.22222, 56, 151, -95, 
1940, Brooklyn (NY), 2, 5, 0, 0.28571, 28, 94, -66, 
1941, Brooklyn (NY), 1, 6, 0, 0.14286, 60, 164, -104, 
1942, Brooklyn (NY), 3, 5, 1, 0.38889, 137, 158, -21, 
1943, Brooklyn (NY), 3, 4, 0, 0.42857, 75, 186, -111, 
1944, Brooklyn (NY), 2, 4, 1, 0.35714, 109, 69, 40, 
1945, Brooklyn (NY), 3, 3, 1, 0.50000, 99, 122, -23, 
1946, Brooklyn (NY), 3, 4, 0, 0.42857, 71, 133, -62, 
1947, Brooklyn (NY), 2, 5, 0, 0.28571, 122, 121, 1, 
1948, Holy Cross (MA), 5, 5, 0, 0.50000, 151, 128, 23, 
1949, Holy Cross (MA), 1, 9, 0, 0.10000, 116, 325, -209, 
1959, Amherst (MA), 4, 3, 1, 0.56250, 132, 57, 75, 
1960, Amherst (MA), 5, 3, 0, 0.62500, 106, 65, 41, 
1961, Amherst (MA), 7, 1, 0, 0.87500, 229, 61, 168, 
1962, Amherst (MA), 7, 1, 0, 0.87500, 171, 49, 122, 
1963, Amherst (MA), 7, 1, 0, 0.87500, 161, 72, 89, 
1964, Amherst (MA), 8, 0, 0, 1.00000, 180, 73, 107, 
1965, Amherst (MA), 7, 1, 0, 0.87500, 242, 91, 151, 
1966, Amherst (MA), 6, 2, 0, 0.75000, 267, 96, 171, 
1967, Amherst (MA), 3, 4, 1, 0.43750, 151, 104, 47, 
1968, Amherst (MA), 7, 1, 0, 0.87500, 262, 77, 185, 
1969, Amherst (MA), 6, 2, 0, 0.75000, 239, 140, 99, 
1970, Amherst (MA), 3, 5, 0, 0.37500, 161, 199, -38, 
1971, Amherst (MA), 6, 2, 0, 0.75000, 214, 166, 48, 
1972, Amherst (MA), 7, 1, 0, 0.87500, 234, 63, 171, 
1973, Amherst (MA), 7, 1, 0, 0.87500, 230, 105, 125, 
1974, Amherst (MA), 5, 3, 0, 0.62500, 168, 102, 66, 
1975, Amherst (MA), 4, 4, 0, 0.50000, 100, 132, -32, 
1976, Amherst (MA), 3, 5, 0, 0.37500, 129, 117, 12, 
1977, Amherst (MA), 5, 2, 1, 0.68750, 218, 99, 119, 
1978, Amherst (MA), 3, 5, 0, 0.37500, 107, 119, -12, 
1979, Amherst (MA), 3, 5, 0, 0.37500, 161, 186, -25, 
1980, Amherst (MA), 2, 6, 0, 0.25000, 132, 173, -41, 
1981, Amherst (MA), 5, 3, 0, 0.62500, 118, 106, 12, 
1982, Amherst (MA), 7, 1, 0, 0.87500, 229, 97, 132, 
1983, Amherst (MA), 5, 2, 1, 0.68750, 156, 115, 41, 
1984, Amherst (MA), 8, 0, 0, 1.00000, 192, 56, 136, 
1985, Amherst (MA), 7, 1, 0, 0.87500, 203, 70, 133, 
1986, Amherst (MA), 6, 2, 0, 0.75000, 215, 191, 24, 
1987, Amherst (MA), 6, 2, 0, 0.75000, 124, 114, 10, 
1988, Amherst (MA), 4, 4, 0, 0.50000, 93, 148, -55, 
1989, Amherst (MA), 4, 4, 0, 0.50000, 124, 133, -9, 
1990, Amherst (MA), 1, 7, 0, 0.12500, 119, 242, -123, 
1991, Amherst (MA), 0, 7, 1, 0.06250, 87, 269, -182, 
1926, Saint Bonaventure (NY), 3, 5, 0, 0.37500, 79, 137, -58, 
1927, Saint Bonaventure (NY), 4, 4, 1, 0.50000, 115, 90, 25, 
1928, Saint Bonaventure (NY), 3, 4, 1, 0.43750, 53, 72, -19, 
1929, Saint Bonaventure (NY), 3, 4, 1, 0.43750, 71, 119, -48, 
1910, Washington St., 2, 3, 0, 0.40000, 25, 34, -9, 
1911, Washington St., 3, 3, 0, 0.50000, 92, 42, 50, 
1980, Monmouth (IL), 1, 8, 0, 0.11111, 104, 217, -113, 
1981, Monmouth (IL), 1, 8, 0, 0.11111, 74, 245, -171, 
1982, Monmouth (IL), 3, 6, 0, 0.33333, 122, 218, -96, 
1983, Monmouth (IL), 2, 6, 1, 0.27778, 124, 214, -90, 
2013, Northern Michigan, 3, 7, 0, 0.30000, 235, 342, -107, 
1981, Illinois St., 3, 7, 0, 0.30000, 145, 190, -45, 
1982, Illinois St., 2, 9, 0, 0.18182, 173, 313, -140, 
1983, Illinois St., 6, 4, 1, 0.59091, 308, 226, 82, 
1984, Illinois St., 5, 6, 0, 0.45455, 237, 182, 55, 
1985, Illinois St., 6, 3, 2, 0.63636, 206, 156, 50, 
1986, Illinois St., 5, 5, 0, 0.50000, 182, 178, 4, 
1987, Illinois St., 3, 7, 0, 0.30000, 175, 240, -65, 
1986, Ferris St. (MI), 5, 5, 0, 0.50000, 270, 292, -22, 
1987, Ferris St. (MI), 4, 7, 0, 0.36364, 248, 263, -15, 
1988, Ferris St. (MI), 4, 7, 0, 0.36364, 209, 252, -43, 
1989, Ferris St. (MI), 6, 5, 0, 0.54545, 289, 293, -4, 
1990, Ferris St. (MI), 6, 4, 1, 0.59091, 245, 203, 42, 
1991, Ferris St. (MI), 5, 6, 0, 0.45455, 174, 218, -44, 
1992, Ferris St. (MI), 10, 3, 0, 0.76923, 308, 165, 143, 
1993, Ferris St. (MI), 9, 1, 2, 0.83333, 359, 159, 200, 
1994, Ferris St. (MI), 11, 1, 0, 0.91667, 365, 218, 147, 
2013, Hillsdale (MI), 5, 6, 0, 0.45455, 307, 278, 29, 
1900, Franklin & Marshall (PA), 4, 5, 0, 0.44444, 95, 117, -22, 
1901, Kansas, 3, 5, 2, 0.40000, 92, 147, -55, 
1923, Tennessee Tech, 2, 4, 1, 0.35714, 45, 135, -90, 
1924, Tennessee Tech, 5, 3, 1, 0.61111, 127, 61, 66, 
1925, Tennessee Tech, 3, 2, 1, 0.58333, 105, 73, 32, 
1926, Tennessee Tech, 1, 4, 1, 0.25000, 15, 87, -72, 
1927, Tennessee Tech, 2, 5, 1, 0.31250, 61, 78, -17, 
1928, Tennessee Tech, 6, 0, 1, 0.92857, 234, 39, 195, 
1929, Tennessee Tech, 3, 3, 1, 0.50000, 123, 92, 31, 
1930, Tennessee Tech, 6, 2, 1, 0.72222, 212, 46, 166, 
1931, Tennessee Tech, 6, 3, 0, 0.66667, 149, 71, 78, 
1932, Tennessee Tech, 3, 1, 3, 0.64286, 96, 20, 76, 
1933, Tennessee Tech, 4, 4, 0, 0.50000, 82, 49, 33, 
1934, Tennessee Tech, 3, 5, 1, 0.38889, 50, 127, -77, 
1935, Tennessee Tech, 1, 6, 1, 0.18750, 32, 134, -102, 
1936, Tennessee Tech, 2, 5, 1, 0.31250, 64, 120, -56, 
1937, Tennessee Tech, 3, 5, 1, 0.38889, 57, 120, -63, 
1938, Tennessee Tech, 6, 3, 0, 0.66667, 101, 71, 30, 
1939, Tennessee Tech, 6, 3, 1, 0.65000, 130, 82, 48, 
1940, Tennessee Tech, 2, 6, 0, 0.25000, 70, 127, -57, 
1941, Tennessee Tech, 5, 4, 0, 0.55556, 110, 114, -4, 
1942, Tennessee Tech, 3, 4, 2, 0.44444, 116, 117, -1, 
1943, Tennessee Tech, 1, 5, 0, 0.16667, 26, 177, -151, 
1944, Tennessee Tech, 1, 2, 0, 0.33333, 68, 45, 23, 
1945, Tennessee Tech, 1, 8, 0, 0.11111, 107, 122, -15, 
1946, Tennessee Tech, 5, 5, 0, 0.50000, 144, 165, -21, 
1952, Tennessee Tech, 9, 2, 0, 0.81818, 232, 131, 101, 
1953, Tennessee Tech, 7, 4, 0, 0.63636, 212, 154, 58, 
1905, Oklahoma, 7, 2, 0, 0.77778, 229, 55, 174, 
1906, Oklahoma, 5, 2, 2, 0.66667, 124, 36, 88, 
1907, Oklahoma, 4, 4, 0, 0.50000, 181, 75, 106, 
1908, Oklahoma, 8, 1, 1, 0.85000, 272, 35, 237, 
1909, Oklahoma, 6, 4, 0, 0.60000, 203, 107, 96, 
1910, Oklahoma, 4, 2, 1, 0.64286, 163, 31, 132, 
1911, Oklahoma, 8, 0, 0, 1.00000, 282, 15, 267, 
1912, Oklahoma, 5, 4, 0, 0.55556, 197, 80, 117, 
1913, Oklahoma, 6, 2, 0, 0.75000, 323, 44, 279, 
1914, Oklahoma, 9, 1, 1, 0.86364, 440, 96, 344, 
1915, Oklahoma, 10, 0, 0, 1.00000, 370, 54, 316, 
1916, Oklahoma, 6, 5, 0, 0.54545, 472, 115, 357, 
1917, Oklahoma, 6, 4, 1, 0.59091, 451, 103, 348, 
1918, Oklahoma, 6, 0, 0, 1.00000, 278, 7, 271, 
1919, Oklahoma, 5, 2, 3, 0.65000, 275, 63, 212, 
1920, Oklahoma, 6, 0, 1, 0.92857, 176, 51, 125, 
1921, Oklahoma, 5, 3, 0, 0.62500, 127, 102, 25, 
1922, Oklahoma, 2, 3, 3, 0.43750, 66, 114, -48, 
1923, Oklahoma, 3, 5, 0, 0.37500, 144, 111, 33, 
1924, Oklahoma, 2, 5, 1, 0.31250, 28, 80, -52, 
1925, Oklahoma, 4, 3, 1, 0.56250, 93, 44, 49, 
1926, Oklahoma, 5, 2, 1, 0.68750, 137, 52, 85, 
1953, Eureka (IL), 3, 4, 0, 0.42857, 81, 97, -16, 
1954, Eureka (IL), 1, 5, 1, 0.21429, 25, 125, -100, 
1955, Eureka (IL), 1, 6, 1, 0.18750, 37, 163, -126, 
1898, Richmond (VA), 3, 3, 1, 0.50000, 48, 39, 9, 
1979, Arizona St., 1, 6, 0, 0.14286, 188, 153, 35, 
2013, Chapman (CA), 8, 1, 0, 0.88889, 405, 183, 222, 
1986, Miles (AL), 0, 11, 0, 0.00000, 98, 344, -246, 
1987, Miles (AL), 1, 9, 0, 0.10000, 70, 359, -289, 
1988, Miles (AL), 2, 6, 1, 0.27778, 84, 223, -139, 
1989, Miles (AL), 0, 8, 0, 0.00000, 51, 231, -180, 
1957, Washington, 3, 6, 1, 0.35000, 120, 212, -92, 
1958, Washington, 3, 7, 0, 0.30000, 102, 146, -44, 
1959, Washington, 10, 1, 0, 0.90909, 253, 73, 180, 
1960, Washington, 10, 1, 0, 0.90909, 272, 107, 165, 
1961, Washington, 5, 4, 1, 0.55000, 119, 98, 21, 
1962, Washington, 7, 1, 2, 0.80000, 208, 83, 125, 
1963, Washington, 6, 5, 0, 0.54545, 183, 141, 42, 
1964, Washington, 6, 4, 0, 0.60000, 139, 110, 29, 
1965, Washington, 5, 5, 0, 0.50000, 205, 185, 20, 
1966, Washington, 6, 4, 0, 0.60000, 171, 141, 30, 
1967, Washington, 5, 5, 0, 0.50000, 136, 130, 6, 
1968, Washington, 3, 5, 2, 0.40000, 154, 177, -23, 
1969, Washington, 1, 9, 0, 0.10000, 116, 304, -188, 
1970, Washington, 6, 4, 0, 0.60000, 334, 216, 118, 
1971, Washington, 8, 3, 0, 0.72727, 357, 188, 169, 
1972, Washington, 8, 3, 0, 0.72727, 208, 204, 4, 
1973, Washington, 2, 9, 0, 0.18182, 218, 376, -158, 
1974, Washington, 5, 6, 0, 0.45455, 272, 285, -13, 
1995, Akron (OH), 2, 9, 0, 0.18182, 141, 428, -287, 
1996, Akron (OH), 4, 7, 0, 0.36364, 175, 269, -94, 
1997, Akron (OH), 2, 9, 0, 0.18182, 218, 435, -217, 
1998, Akron (OH), 4, 7, 0, 0.36364, 265, 299, -34, 
1999, Akron (OH), 7, 4, 0, 0.63636, 315, 314, 1, 
2000, Akron (OH), 6, 5, 0, 0.54545, 333, 295, 38, 
2001, Akron (OH), 4, 7, 0, 0.36364, 281, 360, -79, 
2002, Akron (OH), 4, 8, 0, 0.33333, 325, 379, -54, 
2003, Akron (OH), 7, 5, 0, 0.58333, 435, 353, 82, 
2004, Ashland (OH), 5, 6, 0, 0.45455, 245, 245, 0, 
2005, Ashland (OH), 9, 2, 0, 0.81818, 252, 107, 145, 
2006, Ashland (OH), 4, 6, 0, 0.40000, 206, 244, -38, 
2007, Ashland (OH), 8, 2, 0, 0.80000, 440, 298, 142, 
2008, Ashland (OH), 9, 4, 0, 0.69231, 452, 383, 69, 
2009, Ashland (OH), 6, 5, 0, 0.54545, 299, 287, 12, 
2010, Ashland (OH), 8, 3, 0, 0.72727, 415, 196, 219, 
2011, Ashland (OH), 6, 5, 0, 0.54545, 333, 263, 70, 
2012, Ashland (OH), 11, 1, 0, 0.91667, 490, 183, 307, 
2013, Ashland (OH), 5, 5, 0, 0.50000, 289, 234, 55, 
1905, Yale (CT), 10, 0, 0, 1.00000, 226, 4, 222, 
1925, Navy (MD), 5, 2, 1, 0.68750, 134, 81, 53, 
1967, Vanderbilt (TN), 2, 7, 1, 0.25000, 165, 241, -76, 
1968, Vanderbilt (TN), 5, 4, 1, 0.55000, 163, 147, 16, 
1969, Vanderbilt (TN), 4, 6, 0, 0.40000, 242, 264, -22, 
1970, Vanderbilt (TN), 4, 7, 0, 0.36364, 201, 213, -12, 
1971, Vanderbilt (TN), 4, 6, 1, 0.40909, 136, 208, -72, 
1972, Vanderbilt (TN), 3, 8, 0, 0.27273, 129, 243, -114, 
1978, Fresno St. (CA), 3, 8, 0, 0.27273, 247, 329, -82, 
1979, Fresno St. (CA), 4, 7, 0, 0.36364, 245, 302, -57, 
2013, Texas Lutheran, 8, 1, 0, 0.88889, 415, 267, 148, 
1920, Butler (IN), 7, 1, 0, 0.87500, 251, 51, 200, 
1921, Butler (IN), 6, 2, 0, 0.75000, 282, 49, 233, 
1922, Butler (IN), 8, 2, 0, 0.80000, 160, 74, 86, 
1923, Butler (IN), 7, 2, 0, 0.77778, 142, 81, 61, 
1924, Butler (IN), 4, 5, 0, 0.44444, 93, 113, -20, 
1925, Butler (IN), 5, 2, 2, 0.66667, 134, 62, 72, 
1926, Indiana, 3, 5, 0, 0.37500, 80, 137, -57, 
1927, Indiana, 3, 4, 1, 0.43750, 104, 107, -3, 
1928, Indiana, 4, 4, 0, 0.50000, 55, 68, -13, 
1929, Indiana, 2, 6, 1, 0.27778, 58, 133, -75, 
1930, Indiana, 2, 5, 1, 0.31250, 28, 121, -93, 
1905, Beloit (WI), 3, 6, 1, 0.35000, 125, 170, -45, 
1948, Central Missouri St., 0, 7, 2, 0.11111, 45, 169, -124, 
1949, Central Missouri St., 3, 5, 0, 0.37500, 127, 160, -33, 
1950, Central Missouri St., 8, 3, 0, 0.72727, 262, 187, 75, 
1951, Central Missouri St., 0, 7, 2, 0.11111, 72, 177, -105, 
1968, Sam Houston St. (TX), 5, 4, 1, 0.55000, 206, 208, -2, 
1969, Sam Houston St. (TX), 3, 6, 1, 0.35000, 220, 228, -8, 
1970, Sam Houston St. (TX), 8, 2, 1, 0.77273, 284, 205, 79, 
1971, Sam Houston St. (TX), 4, 7, 0, 0.36364, 138, 146, -8, 
2013, Carleton (MN), 5, 5, 0, 0.50000, 275, 341, -66, 
1964, Jackson St. (MS), 6, 4, 0, 0.60000, 201, 187, 14, 
1965, Jackson St. (MS), 5, 3, 1, 0.61111, 216, 169, 47, 
1966, Jackson St. (MS), 5, 3, 1, 0.61111, 239, 194, 45, 
1967, Jackson St. (MS), 6, 3, 0, 0.66667, 130, 124, 6, 
1968, Jackson St. (MS), 3, 6, 0, 0.33333, 153, 163, -10, 
1971, Texas Southern, 7, 2, 1, 0.75000, 213, 140, 73, 
1972, Texas Southern, 5, 4, 1, 0.55000, 219, 177, 42, 
1973, Texas Southern, 4, 6, 1, 0.40909, 238, 213, 25, 
1974, Texas Southern, 6, 4, 0, 0.60000, 260, 226, 34, 
1975, Texas Southern, 4, 6, 0, 0.40000, 195, 187, 8, 
1977, Western Connecticut St., 2, 7, 0, 0.22222, 53, 150, -97, 
1978, Western Connecticut St., 0, 8, 0, 0.00000, 69, 177, -108, 
1979, Western Connecticut St., 1, 8, 0, 0.11111, 43, 149, -106, 
1913, Baylor (TX), 4, 5, 2, 0.45455, 74, 222, -148, 
1917, Arkansas, 5, 1, 1, 0.78571, 118, 27, 91, 
1918, Arkansas, 3, 2, 0, 0.60000, 41, 121, -80, 
1920, Iowa St., 4, 4, 0, 0.50000, 98, 48, 50, 
1979, Northern Arizona, 7, 4, 0, 0.63636, 172, 193, -21, 
1980, Northern Arizona, 5, 6, 0, 0.45455, 224, 202, 22, 
1981, Northern Arizona, 4, 7, 0, 0.36364, 226, 257, -31, 
1962, Lenoir-Rhyne (NC), 11, 1, 0, 0.91667, 291, 96, 195, 
1963, Lenoir-Rhyne (NC), 4, 6, 0, 0.40000, 143, 189, -46, 
1964, Lenoir-Rhyne (NC), 3, 6, 1, 0.35000, 117, 146, -29, 
1965, Lenoir-Rhyne (NC), 7, 3, 0, 0.70000, 198, 164, 34, 
1966, Lenoir-Rhyne (NC), 6, 3, 0, 0.66667, 203, 131, 72, 
1967, Lenoir-Rhyne (NC), 8, 1, 0, 0.88889, 384, 134, 250, 
1968, Lenoir-Rhyne (NC), 7, 2, 0, 0.77778, 321, 186, 135, 
1969, Lenoir-Rhyne (NC), 6, 4, 0, 0.60000, 280, 177, 103, 
1970, Lenoir-Rhyne (NC), 7, 4, 0, 0.63636, 282, 233, 49, 
1971, Lenoir-Rhyne (NC), 2, 7, 1, 0.25000, 111, 223, -112, 
1972, Lenoir-Rhyne (NC), 5, 6, 0, 0.45455, 222, 260, -38, 
2013, Quincy (IL), 2, 9, 0, 0.18182, 237, 369, -132, 
1989, Southern Oregon, 5, 3, 1, 0.61111, 260, 198, 62, 
1990, Southern Oregon, 6, 3, 0, 0.66667, 264, 167, 97, 
1991, Southern Oregon, 5, 3, 1, 0.61111, 324, 187, 137, 
1992, Southern Oregon, 3, 6, 0, 0.33333, 238, 297, -59, 
1993, Southern Oregon, 4, 5, 0, 0.44444, 297, 354, -57, 
1994, Southern Oregon, 3, 6, 0, 0.33333, 250, 262, -12, 
1995, Southern Oregon, 4, 5, 0, 0.44444, 202, 239, -37, 
1990, Austin Peay St. (TN), 0, 11, 0, 0.00000, 108, 339, -231, 
1966, Bemidji St. (MN), 3, 5, 0, 0.37500, 63, 123, -60, 
1967, Bemidji St. (MN), 3, 5, 1, 0.38889, 155, 201, -46, 
1968, Bemidji St. (MN), 3, 6, 0, 0.33333, 165, 240, -75, 
1986, New Haven (CT), 8, 2, 0, 0.80000, 266, 161, 105, 
1987, New Haven (CT), 8, 2, 0, 0.80000, 267, 134, 133, 
1988, Boston (MA), 4, 7, 0, 0.36364, 230, 285, -55, 
1989, Boston (MA), 4, 7, 0, 0.36364, 292, 271, 21, 
1993, Malone (OH), 2, 6, 1, 0.27778, 223, 243, -20, 
1994, Malone (OH), 7, 3, 0, 0.70000, 327, 183, 144, 
1940, Creighton (NE), 6, 2, 2, 0.70000, 178, 79, 99, 
1941, Creighton (NE), 5, 5, 0, 0.50000, 115, 160, -45, 
1942, Creighton (NE), 5, 4, 0, 0.55556, 170, 127, 43, 
1972, Memphis (TN), 5, 5, 1, 0.50000, 265, 254, 11, 
1973, Memphis (TN), 8, 3, 0, 0.72727, 264, 167, 97, 
1974, Memphis (TN), 7, 4, 0, 0.63636, 225, 148, 77, 
1975, Vanderbilt (TN), 7, 4, 0, 0.63636, 119, 200, -81, 
1976, Vanderbilt (TN), 2, 9, 0, 0.18182, 131, 282, -151, 
1977, Vanderbilt (TN), 2, 9, 0, 0.18182, 141, 276, -135, 
1978, Vanderbilt (TN), 2, 9, 0, 0.18182, 164, 418, -254, 
2000, Murray St. (KY), 6, 5, 0, 0.54545, 366, 332, 34, 
2001, Murray St. (KY), 4, 6, 0, 0.40000, 216, 315, -99, 
2002, Murray St. (KY), 7, 5, 0, 0.58333, 382, 351, 31, 
2003, Murray St. (KY), 4, 8, 0, 0.33333, 225, 338, -113, 
2004, Murray St. (KY), 7, 4, 0, 0.63636, 287, 220, 67, 
2005, Murray St. (KY), 2, 9, 0, 0.18182, 218, 377, -159, 
1955, Doane (NE), 3, 4, 1, 0.43750, 91, 91, 0, 
1956, Doane (NE), 4, 4, 1, 0.50000, 112, 104, 8, 
1957, Doane (NE), 6, 2, 0, 0.75000, 125, 95, 30, 
1958, Doane (NE), 3, 6, 0, 0.33333, 167, 201, -34, 
1959, Doane (NE), 5, 3, 1, 0.61111, 205, 115, 90, 
1960, Doane (NE), 4, 5, 0, 0.44444, 203, 106, 97, 
1961, Doane (NE), 5, 2, 2, 0.66667, 71, 59, 12, 
1962, Doane (NE), 2, 5, 1, 0.31250, 120, 206, -86, 
1963, Doane (NE), 3, 6, 0, 0.33333, 99, 176, -77, 
1964, Doane (NE), 3, 5, 1, 0.38889, 109, 140, -31, 
1965, Doane (NE), 3, 6, 0, 0.33333, 101, 156, -55, 
1966, Doane (NE), 7, 0, 1, 0.93750, 217, 61, 156, 
1967, Doane (NE), 8, 0, 1, 0.94444, 364, 90, 274, 
1968, Doane (NE), 10, 0, 0, 1.00000, 486, 64, 422, 
1969, Doane (NE), 8, 0, 0, 1.00000, 272, 93, 179, 
1970, Doane (NE), 6, 4, 0, 0.60000, 158, 154, 4, 
1999, Mount Ida (MA), 3, 5, 0, 0.37500, 162, 191, -29, 
1968, Montana St., 6, 4, 0, 0.60000, 227, 200, 27, 
1969, Montana St., 1, 8, 0, 0.11111, 106, 243, -137, 
1970, Montana St., 2, 8, 0, 0.20000, 169, 276, -107, 
1992, Marist (NY), 4, 5, 1, 0.45000, 177, 218, -41, 
1993, Marist (NY), 5, 5, 0, 0.50000, 222, 194, 28, 
1994, Marist (NY), 7, 3, 0, 0.70000, 257, 163, 94, 
1995, Marist (NY), 6, 4, 0, 0.60000, 234, 174, 60, 
1996, Marist (NY), 7, 3, 0, 0.70000, 254, 176, 78, 
1997, Marist (NY), 6, 4, 0, 0.60000, 232, 141, 91, 
1998, Marist (NY), 7, 3, 0, 0.70000, 294, 129, 165, 
1999, Marist (NY), 6, 5, 0, 0.54545, 259, 266, -7, 
2000, Marist (NY), 6, 4, 0, 0.60000, 221, 236, -15, 
2001, Marist (NY), 3, 6, 0, 0.33333, 146, 197, -51, 
2002, Marist (NY), 7, 4, 0, 0.63636, 282, 230, 52, 
2003, Marist (NY), 4, 6, 0, 0.40000, 187, 324, -137, 
2004, Marist (NY), 3, 6, 0, 0.33333, 163, 262, -99, 
2005, Marist (NY), 7, 4, 0, 0.63636, 305, 283, 22, 
2006, Marist (NY), 4, 7, 0, 0.36364, 200, 291, -91, 
2007, Marist (NY), 3, 8, 0, 0.27273, 188, 343, -155, 
2008, Marist (NY), 4, 7, 0, 0.36364, 224, 251, -27, 
2009, Marist (NY), 7, 4, 0, 0.63636, 229, 188, 41, 
2010, Marist (NY), 3, 8, 0, 0.27273, 257, 292, -35, 
2011, Marist (NY), 4, 7, 0, 0.36364, 193, 229, -36, 
2012, Marist (NY), 4, 7, 0, 0.36364, 249, 206, 43, 
2013, Marist (NY), 8, 3, 0, 0.72727, 378, 226, 152, 
1972, Southwestern (KS), 4, 5, 0, 0.44444, 117, 190, -73, 
1973, Southwestern (KS), 2, 7, 0, 0.22222, 155, 202, -47, 
1974, Southwestern (KS), 5, 4, 0, 0.55556, 120, 126, -6, 
1975, Southwestern (KS), 6, 3, 0, 0.66667, 108, 130, -22, 
1976, Southwestern (KS), 3, 6, 0, 0.33333, 171, 157, 14, 
1978, Air Force (CO), 3, 8, 0, 0.27273, 215, 328, -113, 
1987, Houston (TX), 4, 6, 1, 0.40909, 284, 292, -8, 
1988, Houston (TX), 9, 3, 0, 0.75000, 474, 219, 255, 
1989, Houston (TX), 9, 2, 0, 0.81818, 589, 150, 439, 
1989, Marist (NY), 4, 5, 1, 0.45000, 167, 194, -27, 
1990, Marist (NY), 7, 2, 1, 0.75000, 220, 192, 28, 
1991, Marist (NY), 6, 4, 0, 0.60000, 239, 143, 96, 
1909, Eastern Kentucky, 1, 0, 4, 0.60000, 32, 0, 32, 
1960, Edinboro (PA), 3, 4, 1, 0.43750, 91, 114, -23, 
1961, Edinboro (PA), 3, 4, 1, 0.43750, 139, 114, 25, 
1983, Wofford (SC), 6, 5, 0, 0.54545, 200, 207, -7, 
1984, Wofford (SC), 2, 9, 0, 0.18182, 141, 265, -124, 
1934, Centenary (LA), 10, 2, 0, 0.83333, 145, 39, 106, 
1935, Centenary (LA), 6, 5, 0, 0.54545, 114, 97, 17, 
1936, Centenary (LA), 6, 4, 2, 0.58333, 111, 104, 7, 
1937, Centenary (LA), 6, 3, 3, 0.62500, 147, 88, 59, 
1938, Centenary (LA), 7, 4, 0, 0.63636, 154, 116, 38, 
1939, Centenary (LA), 2, 9, 1, 0.20833, 51, 146, -95, 
1991, North Texas, 3, 7, 1, 0.31818, 137, 325, -188, 
1992, North Texas, 4, 7, 0, 0.36364, 243, 264, -21, 
1993, North Texas, 4, 7, 0, 0.36364, 328, 365, -37, 
1970, North Central (IL), 1, 8, 0, 0.11111, 100, 336, -236, 
1971, North Central (IL), 0, 9, 0, 0.00000, 66, 319, -253, 
1934, Livingstone (NC), 1, 5, 0, 0.16667, 12, 115, -103, 
1961, Arkansas-Monticello, 2, 8, 0, 0.20000, 81, 243, -162, 
1962, Arkansas-Monticello, 3, 6, 1, 0.35000, 124, 131, -7, 
1963, Arkansas-Monticello, 9, 1, 0, 0.90000, 203, 68, 135, 
1964, Arkansas-Monticello, 8, 2, 0, 0.80000, 187, 101, 86, 
1965, Arkansas-Monticello, 7, 2, 1, 0.75000, 198, 123, 75, 
1966, Citadel (SC), 4, 6, 0, 0.40000, 120, 178, -58, 
1967, Citadel (SC), 5, 5, 0, 0.50000, 155, 144, 11, 
1968, Citadel (SC), 5, 5, 0, 0.50000, 177, 200, -23, 
1969, Citadel (SC), 7, 3, 0, 0.70000, 262, 194, 68, 
1970, Citadel (SC), 5, 6, 0, 0.45455, 259, 241, 18, 
1971, Citadel (SC), 8, 3, 0, 0.72727, 366, 272, 94, 
1972, Citadel (SC), 5, 6, 0, 0.45455, 192, 183, 9, 
1973, Clemson (SC), 5, 6, 0, 0.45455, 231, 263, -32, 
1974, Clemson (SC), 7, 4, 0, 0.63636, 246, 250, -4, 
1975, Clemson (SC), 2, 9, 0, 0.18182, 177, 381, -204, 
1976, Clemson (SC), 3, 6, 2, 0.36364, 172, 237, -65, 
1981, Southern Arkansas, 7, 3, 0, 0.70000, 239, 175, 64, 
1982, Delta St. (MS), 6, 4, 0, 0.60000, 244, 176, 68, 
1983, Delta St. (MS), 5, 5, 0, 0.50000, 242, 273, -31, 
1984, Delta St. (MS), 7, 3, 1, 0.68182, 287, 187, 100, 
1985, Delta St. (MS), 4, 6, 1, 0.40909, 157, 227, -70, 
1986, Delta St. (MS), 6, 4, 1, 0.59091, 244, 246, -2, 
1987, Delta St. (MS), 6, 4, 1, 0.59091, 227, 220, 7, 
1996, Ouachita Baptist (AR), 3, 7, 0, 0.30000, 168, 297, -129, 
1997, Ouachita Baptist (AR), 4, 6, 0, 0.40000, 205, 244, -39, 
1998, Ouachita Baptist (AR), 3, 7, 0, 0.30000, 169, 223, -54, 
1928, Ball St. (IN), 3, 2, 2, 0.57143, 88, 50, 38, 
1929, Ball St. (IN), 0, 7, 0, 0.00000, 43, 200, -157, 
1954, Texas St., 6, 3, 1, 0.65000, 160, 170, -10, 
1955, Texas St., 6, 1, 2, 0.77778, 253, 103, 150, 
1956, Texas St., 6, 3, 0, 0.66667, 132, 101, 31, 
1957, Texas St., 4, 6, 0, 0.40000, 139, 200, -61, 
1958, Texas St., 5, 5, 0, 0.50000, 114, 170, -56, 
1959, Texas St., 4, 6, 0, 0.40000, 115, 157, -42, 
1967, Shepherd (WV), 3, 5, 0, 0.37500, 90, 195, -105, 
1968, Shepherd (WV), 2, 7, 0, 0.22222, 122, 170, -48, 
1969, Shepherd (WV), 6, 4, 0, 0.60000, 151, 191, -40, 
1970, Shepherd (WV), 5, 5, 0, 0.50000, 168, 122, 46, 
1997, North Greenville (SC), 1, 8, 0, 0.11111, 150, 308, -158, 
1998, North Greenville (SC), 7, 3, 0, 0.70000, 305, 252, 53, 
1921, Central Michigan, 7, 2, 1, 0.75000, 188, 21, 167, 
1922, Central Michigan, 6, 0, 2, 0.87500, 179, 11, 168, 
1923, Central Michigan, 5, 1, 2, 0.75000, 160, 24, 136, 
1926, Central Michigan, 3, 4, 1, 0.43750, 66, 90, -24, 
1927, Central Michigan, 7, 1, 0, 0.87500, 124, 37, 87, 
1928, Central Michigan, 6, 3, 0, 0.66667, 126, 63, 63, 
1970, Albany St. (GA), 4, 6, 0, 0.40000, 169, 219, -50, 
1973, Alabama St., 3, 8, 0, 0.27273, 105, 212, -107, 
1974, Alabama St., 2, 8, 0, 0.20000, 130, 261, -131, 
1975, Alabama St., 5, 6, 0, 0.45455, 211, 172, 39, 
1984, Alabama St., 2, 9, 0, 0.18182, 152, 323, -171, 
1986, Alabama St., 4, 7, 0, 0.36364, 184, 207, -23, 
2013, Iowa Wesleyan, 2, 8, 0, 0.20000, 243, 383, -140, 
1911, Arkansas St., 1, 1, 0, 0.50000, 12, 11, 1, 
1912, Arkansas St., 3, 1, 0, 0.75000, 39, 20, 19, 
1963, Benedict (SC), 3, 6, 0, 0.33333, 105, 123, -18, 
1926, Delta St. (MS), 1, 5, 0, 0.16667, 20, 139, -119, 
1906, Miami (OH), 1, 5, 1, 0.21429, 16, 55, -39, 
1977, Adams St. (CO), 3, 7, 0, 0.30000, 167, 215, -48, 
1978, Adams St. (CO), 6, 4, 0, 0.60000, 196, 143, 53, 
1979, Adams St. (CO), 5, 5, 0, 0.50000, 198, 206, -8, 
1980, Adams St. (CO), 8, 3, 0, 0.72727, 252, 118, 134, 
1990, Mesa St. (CO), 8, 4, 0, 0.66667, 443, 273, 170, 
1991, Mesa St. (CO), 3, 7, 0, 0.30000, 169, 296, -127, 
1992, Mesa St. (CO), 3, 8, 0, 0.27273, 161, 375, -214, 
1993, Mesa St. (CO), 5, 5, 0, 0.50000, 225, 326, -101, 
1988, Chicago (IL), 3, 6, 0, 0.33333, 143, 175, -32, 
1897, Oklahoma, 2, 0, 0, 1.00000, 33, 8, 25, 
1898, Oklahoma, 2, 0, 0, 1.00000, 29, 0, 29, 
1899, Oklahoma, 2, 1, 0, 0.66667, 61, 28, 33, 
1900, Oklahoma, 3, 1, 1, 0.70000, 118, 28, 90, 
1978, Wabash (IN), 8, 1, 0, 0.88889, 171, 59, 112, 
1979, Wabash (IN), 8, 1, 0, 0.88889, 288, 76, 212, 
1980, Wabash (IN), 8, 0, 1, 0.94444, 293, 57, 236, 
1981, Wabash (IN), 8, 1, 0, 0.88889, 272, 73, 199, 
1982, Wabash (IN), 10, 0, 0, 1.00000, 293, 117, 176, 
1984, Marshall (WV), 6, 5, 0, 0.54545, 238, 226, 12, 
1985, Marshall (WV), 7, 3, 1, 0.68182, 193, 197, -4, 
1986, Kansas St., 2, 9, 0, 0.18182, 134, 343, -209, 
1987, Kansas St., 0, 10, 1, 0.04545, 135, 421, -286, 
1988, Kansas St., 0, 11, 0, 0.00000, 171, 448, -277, 
2008, Ball St. (IN), 0, 1, 0, 0.00000, 13, 45, -32, 
2009, Ball St. (IN), 2, 10, 0, 0.16667, 230, 338, -108, 
2010, Ball St. (IN), 4, 8, 0, 0.33333, 264, 365, -101, 
2013, Eastern Michigan, 1, 2, 0, 0.33333, 52, 132, -80, 
1907, Oklahoma St., 1, 4, 1, 0.25000, 24, 105, -81, 
1908, Oklahoma St., 4, 3, 0, 0.57143, 86, 66, 20, 
1951, Miami (OH), 7, 3, 0, 0.70000, 225, 159, 66, 
1952, Miami (OH), 8, 1, 0, 0.88889, 284, 108, 176, 
1953, Miami (OH), 7, 1, 1, 0.83333, 327, 52, 275, 
1954, Miami (OH), 8, 1, 0, 0.88889, 294, 82, 212, 
1955, Miami (OH), 9, 0, 0, 1.00000, 226, 47, 179, 
1956, Northwestern (IL), 4, 4, 1, 0.50000, 107, 112, -5, 
1957, Northwestern (IL), 0, 9, 0, 0.00000, 57, 271, -214, 
1958, Northwestern (IL), 5, 4, 0, 0.55556, 199, 148, 51, 
1959, Northwestern (IL), 6, 3, 0, 0.66667, 174, 134, 40, 
1960, Northwestern (IL), 5, 4, 0, 0.55556, 107, 103, 4, 
1961, Northwestern (IL), 4, 5, 0, 0.44444, 131, 105, 26, 
1962, Northwestern (IL), 7, 2, 0, 0.77778, 237, 158, 79, 
1963, Northwestern (IL), 5, 4, 0, 0.55556, 162, 124, 38, 
1964, Notre Dame (IN), 9, 1, 0, 0.90000, 287, 77, 210, 
1965, Notre Dame (IN), 7, 2, 1, 0.75000, 270, 73, 197, 
1966, Notre Dame (IN), 9, 0, 1, 0.95000, 362, 38, 324, 
1967, Notre Dame (IN), 8, 2, 0, 0.80000, 337, 124, 213, 
1968, Notre Dame (IN), 7, 2, 1, 0.75000, 376, 170, 206, 
1969, Notre Dame (IN), 8, 2, 1, 0.77273, 351, 134, 217, 
1970, Notre Dame (IN), 10, 1, 0, 0.90909, 354, 108, 246, 
1971, Notre Dame (IN), 8, 2, 0, 0.80000, 225, 86, 139, 
1972, Notre Dame (IN), 8, 3, 0, 0.72727, 289, 192, 97, 
1973, Notre Dame (IN), 11, 0, 0, 1.00000, 382, 89, 293, 
1974, Notre Dame (IN), 10, 2, 0, 0.83333, 318, 147, 171, 
1910, Delaware Valley (PA), 0, 1, 0, 0.00000, 0, 25, -25, 
1917, Colorado School of Mines, 5, 3, 0, 0.62500, 220, 119, 101, 
2013, Missouri Western St., 8, 3, 0, 0.72727, 423, 278, 145, 
1976, Idaho St., 1, 9, 0, 0.10000, 116, 267, -151, 
1911, Northern Iowa, 4, 2, 1, 0.64286, 67, 53, 14, 
1912, Northern Iowa, 5, 2, 1, 0.68750, 85, 83, 2, 
1982, Western Connecticut St., 2, 7, 0, 0.22222, 90, 188, -98, 
1983, Western Connecticut St., 7, 3, 0, 0.70000, 192, 129, 63, 
1984, Western Connecticut St., 9, 1, 0, 0.90000, 282, 96, 186, 
1985, Western Connecticut St., 10, 2, 0, 0.83333, 374, 170, 204, 
1986, Western Connecticut St., 6, 4, 0, 0.60000, 221, 166, 55, 
1991, Syracuse (NY), 10, 2, 0, 0.83333, 321, 200, 121, 
1992, Syracuse (NY), 10, 2, 0, 0.83333, 340, 205, 135, 
1993, Syracuse (NY), 6, 4, 1, 0.59091, 281, 288, -7, 
1994, Syracuse (NY), 7, 4, 0, 0.63636, 256, 259, -3, 
1995, Syracuse (NY), 9, 3, 0, 0.75000, 375, 213, 162, 
1996, Syracuse (NY), 9, 3, 0, 0.75000, 437, 208, 229, 
1997, Syracuse (NY), 9, 4, 0, 0.69231, 441, 226, 215, 
1998, Syracuse (NY), 8, 4, 0, 0.66667, 478, 300, 178, 
1999, Syracuse (NY), 7, 5, 0, 0.58333, 300, 256, 44, 
2000, Syracuse (NY), 6, 5, 0, 0.54545, 294, 212, 82, 
2001, Syracuse (NY), 10, 3, 0, 0.76923, 334, 247, 87, 
2002, Syracuse (NY), 4, 8, 0, 0.33333, 347, 406, -59, 
2003, Syracuse (NY), 6, 6, 0, 0.50000, 320, 301, 19, 
2004, Syracuse (NY), 6, 6, 0, 0.50000, 287, 344, -57, 
2011, Connecticut, 5, 7, 0, 0.41667, 291, 292, -1, 
2012, Connecticut, 5, 7, 0, 0.41667, 213, 238, -25, 
2013, Connecticut, 0, 4, 0, 0.00000, 72, 130, -58, 
1944, Kentucky St., 1, 1, 0, 0.50000, 20, 20, 0, 
2002, New Haven (CT), 4, 6, 0, 0.40000, 245, 283, -38, 
2003, New Haven (CT), 1, 9, 0, 0.10000, 187, 355, -168, 
1965, Merchant Marine (NY), 4, 4, 1, 0.50000, 144, 163, -19, 
1966, Merchant Marine (NY), 4, 4, 1, 0.50000, 168, 158, 10, 
1967, Merchant Marine (NY), 2, 6, 0, 0.25000, 96, 157, -61, 
1968, Merchant Marine (NY), 8, 1, 0, 0.88889, 209, 51, 158, 
1971, Merchant Marine (NY), 5, 3, 1, 0.61111, 125, 114, 11, 
1972, Merchant Marine (NY), 5, 4, 0, 0.55556, 149, 147, 2, 
1973, Merchant Marine (NY), 5, 5, 0, 0.50000, 195, 146, 49, 
1974, Merchant Marine (NY), 6, 3, 0, 0.66667, 154, 118, 36, 
1975, Merchant Marine (NY), 7, 2, 0, 0.77778, 213, 67, 146, 
1966, Penn St., 5, 5, 0, 0.50000, 193, 208, -15, 
1967, Penn St., 8, 2, 1, 0.77273, 299, 158, 141, 
1968, Penn St., 11, 0, 0, 1.00000, 354, 120, 234, 
1969, Penn St., 11, 0, 0, 1.00000, 322, 90, 232, 
1970, Penn St., 7, 3, 0, 0.70000, 300, 163, 137, 
1971, Penn St., 11, 1, 0, 0.91667, 484, 137, 347, 
1972, Penn St., 10, 2, 0, 0.83333, 358, 189, 169, 
1973, Penn St., 12, 0, 0, 1.00000, 447, 129, 318, 
1974, Penn St., 10, 2, 0, 0.83333, 322, 142, 180, 
1975, Penn St., 9, 3, 0, 0.75000, 240, 123, 117, 
1976, Penn St., 7, 5, 0, 0.58333, 241, 173, 68, 
1977, Penn St., 11, 1, 0, 0.91667, 390, 187, 203, 
1978, Penn St., 11, 1, 0, 0.91667, 333, 111, 222, 
1979, Penn St., 8, 4, 0, 0.66667, 257, 177, 80, 
1980, Penn St., 10, 2, 0, 0.83333, 321, 158, 163, 
1981, Penn St., 10, 2, 0, 0.83333, 371, 162, 209, 
1982, Penn St., 11, 1, 0, 0.91667, 395, 196, 199, 
1983, Penn St., 8, 4, 1, 0.65385, 320, 312, 8, 
1984, Penn St., 6, 5, 0, 0.54545, 209, 230, -21, 
1985, Penn St., 11, 1, 0, 0.91667, 275, 153, 122, 
1986, Penn St., 12, 0, 0, 1.00000, 340, 133, 207, 
1987, Penn St., 8, 4, 0, 0.66667, 286, 244, 42, 
1988, Penn St., 5, 6, 0, 0.45455, 231, 201, 30, 
1989, Penn St., 8, 3, 1, 0.70833, 259, 169, 90, 
1990, Penn St., 9, 3, 0, 0.75000, 297, 179, 118, 
1991, Penn St., 11, 2, 0, 0.84615, 474, 184, 290, 
1992, Penn St., 7, 5, 0, 0.58333, 391, 234, 157, 
1993, Penn St., 10, 2, 0, 0.83333, 388, 215, 173, 
1994, Penn St., 12, 0, 0, 1.00000, 564, 252, 312, 
1995, Penn St., 9, 3, 0, 0.75000, 399, 259, 140, 
1996, Penn St., 11, 2, 0, 0.84615, 400, 203, 197, 
1997, Penn St., 9, 3, 0, 0.75000, 366, 254, 112, 
1998, Penn St., 0, 3, 0, 0.00000, 317, 183, 134, 
1999, Penn St., 0, 3, 0, 0.00000, 417, 234, 183, 
2000, Penn St., 0, 7, 0, 0.00000, 264, 293, -29, 
2001, Penn St., 0, 6, 0, 0.00000, 248, 281, -33, 
2002, Penn St., 0, 4, 0, 0.00000, 446, 227, 219, 
2003, Penn St., 0, 9, 0, 0.00000, 233, 255, -22, 
2004, Penn St., 0, 7, 0, 0.00000, 195, 168, 27, 
2005, Penn St., 0, 1, 0, 0.00000, 413, 204, 209, 
2006, Penn St., 0, 4, 0, 0.00000, 290, 187, 103, 
2007, Penn St., 0, 4, 0, 0.00000, 394, 228, 166, 
2008, Penn St., 0, 2, 0, 0.00000, 506, 187, 319, 
2009, Penn St., 0, 2, 0, 0.00000, 375, 159, 216, 
2010, Penn St., 0, 6, 0, 0.00000, 319, 308, 11, 
2011, Penn St., 0, 1, 0, 0.00000, 196, 112, 84, 
1916, North Carolina St., 2, 5, 0, 0.28571, 24, 191, -167, 
1958, Louisiana College, 9, 2, 0, 0.81818, 313, 83, 230, 
1934, Oglethorpe (GA), 5, 4, 1, 0.55000, 80, 85, -5, 
1935, Oglethorpe (GA), 2, 7, 0, 0.22222, 47, 184, -137, 
1936, Oglethorpe (GA), 4, 5, 0, 0.44444, 100, 99, 1, 
1937, Oglethorpe (GA), 3, 6, 1, 0.35000, 41, 139, -98, 
1938, Oglethorpe (GA), 2, 9, 0, 0.18182, 79, 275, -196, 
1939, Oglethorpe (GA), 3, 4, 1, 0.43750, 98, 99, -1, 
1940, Oglethorpe (GA), 2, 6, 0, 0.25000, 75, 211, -136, 
1941, Oglethorpe (GA), 4, 4, 0, 0.50000, 187, 50, 137, 
1994, Cal Poly-San Luis Obispo, 7, 4, 0, 0.63636, 304, 334, -30, 
1995, Cal Poly-San Luis Obispo, 5, 6, 0, 0.45455, 411, 271, 140, 
1996, Cal Poly-San Luis Obispo, 5, 6, 0, 0.45455, 308, 356, -48, 
1999, Western Illinois, 7, 4, 0, 0.63636, 383, 241, 142, 
2000, Western Illinois, 9, 3, 0, 0.75000, 390, 231, 159, 
2001, Western Illinois, 5, 5, 0, 0.50000, 257, 290, -33, 
2002, Western Illinois, 11, 2, 0, 0.84615, 470, 241, 229, 
2003, Western Illinois, 9, 4, 0, 0.69231, 472, 331, 141, 
2004, Western Illinois, 4, 7, 0, 0.36364, 311, 409, -98, 
2005, Western Illinois, 5, 6, 0, 0.45455, 352, 371, -19, 
2006, Western Illinois, 5, 6, 0, 0.45455, 333, 277, 56, 
2007, Western Illinois, 6, 5, 0, 0.54545, 273, 215, 58, 
2008, Western Illinois, 1, 3, 0, 0.25000, 96, 130, -34, 
2009, Western Illinois, 1, 2, 0, 0.33333, 72, 109, -37, 
1896, Missouri, 11, 5, 1, 0.67647, 319, 94, 225, 
2000, Texas Christian, 0, 1, 0, 0.00000, 21, 28, -7, 
2001, Texas Christian, 6, 6, 0, 0.50000, 289, 285, 4, 
2002, Texas Christian, 10, 2, 0, 0.83333, 361, 222, 139, 
2003, Texas Christian, 11, 2, 0, 0.84615, 380, 276, 104, 
2004, Texas Christian, 5, 6, 0, 0.45455, 362, 373, -11, 
2005, Texas Christian, 11, 1, 0, 0.91667, 398, 223, 175, 
2006, Texas Christian, 11, 2, 0, 0.84615, 380, 160, 220, 
2007, Texas Christian, 8, 5, 0, 0.61538, 339, 243, 96, 
2008, Texas Christian, 11, 2, 0, 0.84615, 437, 147, 290, 
2009, Texas Christian, 12, 1, 0, 0.92308, 498, 166, 332, 
2010, Texas Christian, 13, 0, 0, 1.00000, 541, 156, 385, 
2011, Texas Christian, 11, 2, 0, 0.84615, 531, 279, 252, 
2012, Texas Christian, 7, 6, 0, 0.53846, 368, 294, 74, 
2013, Texas Christian, 4, 8, 0, 0.33333, 301, 303, -2, 
2011, Pittsburgh (PA), 0, 1, 0, 0.00000, 6, 28, -22, 
1979, Louisiana Tech, 1, 0, 0, 1.00000, 13, 10, 3, 
1917, Southern Illinois, 2, 2, 0, 0.50000, 60, 63, -3, 
1953, New Mexico St., 2, 7, 0, 0.22222, 56, 316, -260, 
1954, New Mexico St., 0, 9, 0, 0.00000, 87, 306, -219, 
1995, North Greenville (SC), 5, 6, 0, 0.45455, 237, 294, -57, 
1996, North Greenville (SC), 7, 3, 0, 0.70000, 319, 155, 164, 
1997, Gardner-Webb (NC), 8, 3, 0, 0.72727, 339, 220, 119, 
1998, Gardner-Webb (NC), 6, 5, 0, 0.54545, 236, 258, -22, 
1999, Gardner-Webb (NC), 7, 4, 0, 0.63636, 290, 196, 94, 
2000, Gardner-Webb (NC), 7, 4, 0, 0.63636, 293, 277, 16, 
2001, Gardner-Webb (NC), 6, 4, 0, 0.60000, 322, 241, 81, 
2002, Gardner-Webb (NC), 9, 1, 0, 0.90000, 278, 204, 74, 
2003, Gardner-Webb (NC), 8, 4, 0, 0.66667, 335, 254, 81, 
2004, Gardner-Webb (NC), 5, 6, 0, 0.45455, 282, 335, -53, 
2005, Gardner-Webb (NC), 5, 6, 0, 0.45455, 386, 367, 19, 
2006, Gardner-Webb (NC), 6, 5, 0, 0.54545, 270, 329, -59, 
2007, Gardner-Webb (NC), 5, 6, 0, 0.45455, 245, 278, -33, 
2008, Gardner-Webb (NC), 5, 6, 0, 0.45455, 267, 261, 6, 
2009, Gardner-Webb (NC), 6, 5, 0, 0.54545, 305, 277, 28, 
2010, Gardner-Webb (NC), 4, 7, 0, 0.36364, 214, 306, -92, 
1965, Texas Southern, 5, 4, 1, 0.55000, 177, 123, 54, 
1966, Texas Southern, 5, 4, 1, 0.55000, 220, 207, 13, 
1967, Texas Southern, 7, 3, 0, 0.70000, 220, 119, 101, 
1968, Texas Southern, 6, 4, 0, 0.60000, 194, 155, 39, 
1969, Texas Southern, 4, 3, 2, 0.55556, 229, 136, 93, 
1999, Thomas More (KY), 7, 3, 0, 0.70000, 258, 184, 74, 
2000, Thomas More (KY), 9, 1, 0, 0.90000, 298, 117, 181, 
2001, Thomas More (KY), 11, 1, 0, 0.91667, 423, 204, 219, 
2002, Thomas More (KY), 7, 3, 0, 0.70000, 255, 169, 86, 
2003, Thomas More (KY), 6, 4, 0, 0.60000, 306, 260, 46, 
2013, Ohio Northern, 6, 4, 0, 0.60000, 332, 260, 72, 
1919, Hanover (IN), 0, 6, 1, 0.07143, 6, 389, -383, 
1969, Minnesota-Crookston, 3, 3, 0, 0.50000, 107, 83, 24, 
1970, Minnesota-Crookston, 4, 4, 0, 0.50000, 102, 119, -17, 
1971, Minnesota-Crookston, 3, 5, 0, 0.37500, 129, 111, 18, 
1948, Cal Poly-San Luis Obispo, 3, 5, 0, 0.37500, 159, 189, -30, 
1949, Cal Poly-San Luis Obispo, 4, 6, 0, 0.40000, 134, 224, -90, 
1981, Northeastern (MA), 3, 7, 0, 0.30000, 115, 206, -91, 
1982, Northeastern (MA), 3, 6, 0, 0.33333, 176, 149, 27, 
1983, Northeastern (MA), 6, 4, 1, 0.59091, 220, 199, 21, 
1984, Northeastern (MA), 3, 7, 0, 0.30000, 135, 192, -57, 
1985, Northeastern (MA), 2, 8, 0, 0.20000, 134, 240, -106, 
1986, Northeastern (MA), 4, 6, 0, 0.40000, 236, 232, 4, 
1987, Northeastern (MA), 6, 5, 0, 0.54545, 257, 212, 45, 
1988, Northeastern (MA), 4, 7, 0, 0.36364, 269, 289, -20, 
1989, Northeastern (MA), 3, 7, 0, 0.30000, 167, 242, -75, 
1990, Northeastern (MA), 1, 10, 0, 0.09091, 144, 342, -198, 
1954, Louisiana-Monroe, 1, 8, 1, 0.15000, 119, 337, -218, 
1955, Louisiana-Monroe, 4, 6, 0, 0.40000, 100, 206, -106, 
1956, Louisiana-Monroe, 8, 2, 0, 0.80000, 220, 155, 65, 
1957, Louisiana-Monroe, 2, 6, 0, 0.25000, 105, 128, -23, 
1936, Howard (DC), 1, 6, 0, 0.14286, 12, 136, -124, 
1937, Howard (DC), 2, 5, 1, 0.31250, 51, 117, -66, 
1938, Howard (DC), 4, 5, 0, 0.44444, 45, 66, -21, 
1939, Howard (DC), 2, 6, 0, 0.25000, 44, 155, -111, 
1940, Howard (DC), 1, 7, 0, 0.12500, 25, 209, -184, 
1985, Abilene Christian (TX), 5, 4, 2, 0.54545, 260, 231, 29, 
1986, Abilene Christian (TX), 7, 3, 0, 0.70000, 310, 213, 97, 
1987, Abilene Christian (TX), 5, 6, 0, 0.45455, 281, 270, 11, 
1988, Abilene Christian (TX), 3, 7, 0, 0.30000, 245, 348, -103, 
1989, Abilene Christian (TX), 5, 5, 0, 0.50000, 231, 264, -33, 
1990, Abilene Christian (TX), 1, 9, 0, 0.10000, 133, 322, -189, 
1922, Abilene Christian (TX), 6, 2, 0, 0.75000, 160, 35, 125, 
1923, Abilene Christian (TX), 6, 1, 0, 0.85714, 112, 13, 99, 
1926, Hardin-Simmons (TX), 6, 1, 3, 0.75000, 85, 46, 39, 
1988, Louisiana Tech, 4, 7, 0, 0.36364, 185, 352, -167, 
1989, Louisiana Tech, 4, 6, 0, 0.40000, 283, 265, 18, 
1990, Louisiana Tech, 8, 3, 1, 0.70833, 365, 219, 146, 
1991, Louisiana Tech, 8, 1, 2, 0.81818, 280, 194, 86, 
1992, Louisiana Tech, 5, 6, 0, 0.45455, 199, 167, 32, 
1993, Louisiana Tech, 3, 8, 0, 0.27273, 143, 332, -189, 
1994, Louisiana Tech, 3, 8, 0, 0.27273, 164, 274, -110, 
1995, Louisiana Tech, 5, 6, 0, 0.45455, 320, 371, -51, 
2003, Campbellsville (KY), 9, 2, 0, 0.81818, 318, 222, 96, 
2004, Campbellsville (KY), 6, 5, 0, 0.54545, 313, 307, 6, 
1916, Mercer (GA), 0, 5, 0, 0.00000, 7, 221, -214, 
2013, Robert Morris-Peoria (IL), 6, 1, 0, 0.85714, 256, 61, 195, 
1991, Abilene Christian (TX), 1, 9, 0, 0.10000, 73, 259, -186, 
1992, Abilene Christian (TX), 3, 6, 0, 0.33333, 117, 314, -197, 
1992, Stephen F. Austin (TX), 3, 8, 0, 0.27273, 195, 240, -45, 
1993, Stephen F. Austin (TX), 8, 4, 0, 0.66667, 362, 272, 90, 
1994, Stephen F. Austin (TX), 6, 3, 2, 0.63636, 311, 198, 113, 
1995, Stephen F. Austin (TX), 11, 2, 0, 0.84615, 392, 242, 150, 
1996, Stephen F. Austin (TX), 7, 4, 0, 0.63636, 310, 211, 99, 
1997, Stephen F. Austin (TX), 8, 3, 0, 0.72727, 296, 199, 97, 
1998, Stephen F. Austin (TX), 3, 8, 0, 0.27273, 217, 213, 4, 
1954, Savannah St. (GA), 1, 7, 0, 0.12500, 50, 244, -194, 
1955, Savannah St. (GA), 2, 4, 1, 0.35714, 60, 112, -52, 
1956, Savannah St. (GA), 4, 4, 0, 0.50000, 127, 102, 25, 
1969, Wheaton (IL), 3, 6, 0, 0.33333, 121, 221, -100, 
1970, Wheaton (IL), 1, 7, 1, 0.16667, 166, 225, -59, 
2010, Miles (AL), 1, 5, 0, 0.16667, 72, 164, -92, 
1971, Northern Arizona, 5, 5, 0, 0.50000, 193, 224, -31, 
1972, Northern Arizona, 3, 8, 0, 0.27273, 189, 292, -103, 
1973, Northern Arizona, 4, 6, 0, 0.40000, 201, 254, -53, 
1974, Northern Arizona, 3, 6, 0, 0.33333, 139, 241, -102, 
1986, Northwestern (IL), 4, 7, 0, 0.36364, 217, 251, -34, 
1987, Northwestern (IL), 2, 8, 1, 0.22727, 186, 328, -142, 
1988, Northwestern (IL), 2, 8, 1, 0.22727, 192, 350, -158, 
1989, Northwestern (IL), 0, 11, 0, 0.00000, 241, 497, -256, 
1990, Northwestern (IL), 2, 9, 0, 0.18182, 210, 370, -160, 
1991, Northwestern (IL), 3, 8, 0, 0.27273, 160, 306, -146, 
1928, Loyola Marymount (CA), 5, 3, 0, 0.62500, 147, 50, 97, 
1931, Gonzaga (WA), 3, 4, 0, 0.42857, 116, 59, 57, 
1932, Gonzaga (WA), 5, 3, 0, 0.62500, 184, 77, 107, 
1933, Gonzaga (WA), 2, 6, 1, 0.27778, 40, 96, -56, 
1934, Gonzaga (WA), 8, 2, 1, 0.77273, 180, 71, 109, 
1935, Gonzaga (WA), 5, 4, 1, 0.55000, 125, 109, 16, 
1936, Gonzaga (WA), 5, 3, 0, 0.62500, 98, 83, 15, 
1937, Gonzaga (WA), 2, 6, 2, 0.30000, 44, 138, -94, 
1938, Gonzaga (WA), 1, 7, 0, 0.12500, 82, 105, -23, 
1939, Loyola Marymount (CA), 2, 6, 1, 0.27778, 59, 162, -103, 
1960, San Diego (CA), 4, 5, 1, 0.45000, 165, 199, -34, 
1961, San Diego (CA), 2, 8, 0, 0.20000, 90, 272, -182, 
1970, Middle Tennessee St., 6, 3, 1, 0.65000, 167, 105, 62, 
1971, Middle Tennessee St., 7, 4, 0, 0.63636, 196, 178, 18, 
1972, Middle Tennessee St., 7, 3, 1, 0.68182, 216, 172, 44, 
1973, Middle Tennessee St., 4, 7, 0, 0.36364, 148, 264, -116, 
1974, Middle Tennessee St., 3, 8, 0, 0.27273, 164, 254, -90, 
1902, Montana, 0, 2, 0, 0.00000, 0, 54, -54, 
1904, Morningside (IA), 0, 4, 3, 0.21429, 10, 41, -31, 
1924, Ohio, 4, 4, 0, 0.50000, 64, 59, 5, 
1925, Ohio, 6, 2, 0, 0.75000, 96, 40, 56, 
1926, Ohio, 5, 2, 1, 0.68750, 111, 17, 94, 
1927, Ohio, 4, 2, 2, 0.62500, 85, 69, 16, 
1928, Ohio, 6, 3, 0, 0.66667, 254, 66, 188, 
1929, Ohio, 9, 0, 0, 1.00000, 305, 7, 298, 
1930, Ohio, 8, 0, 1, 0.94444, 266, 26, 240, 
1931, Ohio, 7, 1, 0, 0.87500, 172, 14, 158, 
1932, Ohio, 7, 2, 0, 0.77778, 172, 29, 143, 
1933, Ohio, 6, 2, 1, 0.72222, 277, 28, 249, 
1934, Ohio, 4, 4, 1, 0.50000, 116, 67, 49, 
1935, Ohio, 8, 0, 0, 1.00000, 170, 36, 134, 
1936, Ohio, 5, 2, 1, 0.68750, 67, 76, -9, 
1937, Ohio, 5, 3, 1, 0.61111, 168, 52, 116, 
1938, Ohio, 7, 2, 0, 0.77778, 161, 89, 72, 
1939, Ohio, 6, 3, 0, 0.66667, 116, 82, 34, 
1940, Ohio, 5, 2, 2, 0.66667, 89, 32, 57, 
1941, Ohio, 5, 2, 1, 0.68750, 108, 42, 66, 
1942, Ohio, 5, 3, 0, 0.62500, 144, 107, 37, 
1945, Ohio, 3, 4, 0, 0.42857, 100, 106, -6, 
1946, Ohio, 6, 3, 0, 0.66667, 206, 97, 109, 
1915, Hawaii, 5, 1, 1, 0.78571, 121, 36, 85, 
2013, Grinnell (IA), 2, 8, 0, 0.20000, 126, 327, -201, 
1950, Marshall (WV), 2, 8, 0, 0.20000, 107, 249, -142, 
1951, Marshall (WV), 5, 5, 1, 0.50000, 218, 194, 24, 
1952, Marshall (WV), 2, 7, 2, 0.27273, 192, 233, -41, 
1933, Augsburg (MN), 0, 5, 0, 0.00000, 7, 106, -99, 
1934, Augsburg (MN), 0, 5, 0, 0.00000, 21, 194, -173, 
1953, Augustana (SD), 1, 8, 0, 0.11111, 76, 260, -184, 
1942, Mount Union (OH), 1, 6, 0, 0.14286, 64, 116, -52, 
1946, Mount Union (OH), 7, 1, 1, 0.83333, 127, 51, 76, 
1947, Mount Union (OH), 5, 4, 0, 0.55556, 165, 138, 27, 
1948, Mount Union (OH), 6, 3, 0, 0.66667, 147, 88, 59, 
1949, Mount Union (OH), 3, 6, 0, 0.33333, 147, 203, -56, 
1883, Minnesota, 1, 2, 0, 0.33333, 9, 8, 1, 
1936, Buffalo (NY), 5, 3, 0, 0.62500, 121, 127, -6, 
1937, Buffalo (NY), 4, 4, 0, 0.50000, 88, 94, -6, 
1938, Buffalo (NY), 2, 6, 0, 0.25000, 81, 158, -77, 
1939, Buffalo (NY), 0, 7, 0, 0.00000, 7, 126, -119, 
1940, Buffalo (NY), 3, 5, 0, 0.37500, 47, 116, -69, 
1941, Buffalo (NY), 3, 4, 1, 0.43750, 55, 75, -20, 
1942, Buffalo (NY), 6, 2, 0, 0.75000, 215, 52, 163, 
1946, Buffalo (NY), 7, 2, 0, 0.77778, 224, 91, 133, 
1947, Buffalo (NY), 8, 1, 0, 0.88889, 258, 79, 179, 
1998, Kent St. (OH), 0, 11, 0, 0.00000, 149, 454, -305, 
1999, Kent St. (OH), 2, 9, 0, 0.18182, 213, 376, -163, 
2000, Kent St. (OH), 1, 10, 0, 0.09091, 128, 359, -231, 
2001, Kent St. (OH), 6, 5, 0, 0.54545, 248, 281, -33, 
2002, Kent St. (OH), 3, 9, 0, 0.25000, 202, 424, -222, 
2003, Kent St. (OH), 5, 7, 0, 0.41667, 321, 396, -75, 
2013, Millsaps (MS), 9, 1, 0, 0.90000, 338, 228, 110, 
2003, Nebraska, 1, 0, 0, 1.00000, 17, 3, 14, 
2008, Nebraska, 9, 4, 0, 0.69231, 460, 371, 89, 
2009, Nebraska, 10, 4, 0, 0.71429, 352, 146, 206, 
2010, Nebraska, 10, 4, 0, 0.71429, 432, 243, 189, 
2011, Nebraska, 9, 4, 0, 0.69231, 379, 304, 75, 
2012, Nebraska, 10, 4, 0, 0.71429, 487, 386, 101, 
2013, Nebraska, 9, 4, 0, 0.69231, 415, 323, 92, 
2012, Florida Atlantic, 3, 9, 0, 0.25000, 246, 370, -124, 
2013, Florida Atlantic, 2, 6, 0, 0.25000, 166, 227, -61, 
1957, Monmouth (IL), 1, 7, 0, 0.12500, 74, 206, -132, 
1958, Monmouth (IL), 2, 5, 1, 0.31250, 70, 189, -119, 
1959, Monmouth (IL), 1, 7, 0, 0.12500, 72, 164, -92, 
1960, Monmouth (IL), 3, 4, 1, 0.43750, 89, 121, -32, 
1961, Monmouth (IL), 1, 7, 0, 0.12500, 45, 212, -167, 
1962, Monmouth (IL), 2, 6, 0, 0.25000, 54, 201, -147, 
1963, Monmouth (IL), 0, 8, 0, 0.00000, 57, 225, -168, 
1964, Monmouth (IL), 2, 6, 0, 0.25000, 60, 234, -174, 
1902, Northern Iowa, 1, 6, 1, 0.18750, 53, 194, -141, 
1903, Northern Iowa, 4, 4, 1, 0.50000, 153, 96, 57, 
1904, Northern Iowa, 5, 3, 1, 0.61111, 227, 75, 152, 
1905, Northern Iowa, 5, 3, 2, 0.60000, 112, 99, 13, 
1906, Drake (IA), 2, 4, 1, 0.35714, 41, 62, -21, 
1907, Drake (IA), 3, 4, 1, 0.43750, 61, 74, -13, 
1969, Jacksonville St. (AL), 3, 6, 0, 0.33333, 127, 211, -84, 
1970, Jacksonville St. (AL), 10, 0, 0, 1.00000, 325, 104, 221, 
1971, Jacksonville St. (AL), 6, 3, 0, 0.66667, 297, 142, 155, 
1972, Jacksonville St. (AL), 7, 2, 1, 0.75000, 239, 109, 130, 
1973, Jacksonville St. (AL), 7, 2, 0, 0.77778, 319, 137, 182, 
1977, Clemson (SC), 8, 3, 1, 0.70833, 228, 163, 65, 
1978, Clemson (SC), 10, 1, 0, 0.90909, 351, 116, 235, 
1979, Florida, 0, 10, 1, 0.04545, 106, 265, -159, 
1980, Florida, 8, 4, 0, 0.66667, 256, 186, 70, 
1981, Florida, 7, 5, 0, 0.58333, 284, 166, 118, 
1982, Florida, 8, 4, 0, 0.66667, 296, 228, 68, 
1983, Florida, 9, 2, 1, 0.79167, 304, 156, 148, 
1984, Florida, 1, 1, 1, 0.50000, 104, 74, 30, 
1983, Utah St., 5, 6, 0, 0.45455, 193, 214, -21, 
1984, Utah St., 1, 10, 0, 0.09091, 196, 390, -194, 
1985, Utah St., 3, 8, 0, 0.27273, 177, 319, -142, 
1913, North Texas, 0, 1, 0, 0.00000, 0, 13, -13, 
1914, North Texas, 3, 3, 0, 0.50000, 56, 87, -31, 
2000, Hamilton (NY), 2, 6, 0, 0.25000, 49, 131, -82, 
2001, Cornell (NY), 2, 7, 0, 0.22222, 187, 292, -105, 
2002, Cornell (NY), 4, 6, 0, 0.40000, 169, 292, -123, 
2003, Cornell (NY), 1, 9, 0, 0.10000, 130, 304, -174, 
1896, Rutgers (NJ), 6, 6, 0, 0.50000, 74, 204, -130, 
1897, Rutgers (NJ), 2, 7, 0, 0.22222, 38, 128, -90, 
1914, Princeton (NJ), 5, 2, 1, 0.68750, 87, 65, 22, 
1927, Mesa St. (CO), 0, 2, 0, 0.00000, 0, 20, -20, 
1936, Johnson C. Smith (NC), 2, 3, 3, 0.43750, 74, 69, 5, 
1959, Morehead St. (KY), 3, 6, 0, 0.33333, 126, 181, -55, 
1960, Morehead St. (KY), 5, 4, 0, 0.55556, 155, 135, 20, 
1961, Morehead St. (KY), 1, 6, 1, 0.18750, 128, 107, 21, 
1962, Morehead St. (KY), 5, 3, 0, 0.62500, 116, 88, 28, 
1963, Morehead St. (KY), 5, 4, 0, 0.55556, 120, 116, 4, 
1964, Morehead St. (KY), 5, 4, 0, 0.55556, 114, 87, 27, 
1965, Morehead St. (KY), 3, 6, 0, 0.33333, 176, 185, -9, 
1966, Morehead St. (KY), 7, 2, 0, 0.77778, 159, 118, 41, 
1967, Morehead St. (KY), 4, 5, 1, 0.45000, 148, 150, -2, 
1910, Jacksonville St. (AL), 1, 3, 2, 0.33333, 62, 34, 28, 
1911, Troy (AL), 4, 1, 1, 0.75000, 49, 20, 29, 
1912, Troy (AL), 3, 0, 0, 1.00000, 61, 10, 51, 
1898, Clemson (SC), 3, 1, 0, 0.75000, 110, 20, 90, 
1913, Hampton (VA), 6, 0, 0, 1.00000, 261, 6, 255, 
2001, Case Western Reserve (OH), 5, 5, 0, 0.50000, 316, 271, 45, 
2002, Case Western Reserve (OH), 6, 4, 0, 0.60000, 371, 291, 80, 
2003, Case Western Reserve (OH), 5, 5, 0, 0.50000, 253, 293, -40, 
1989, Saint Francis (PA), 2, 8, 0, 0.20000, 135, 249, -114, 
1990, Saint Francis (PA), 4, 6, 0, 0.40000, 130, 199, -69, 
1991, Saint Francis (PA), 6, 3, 0, 0.66667, 140, 107, 33, 
1992, Saint Francis (PA), 8, 2, 1, 0.77273, 244, 175, 69, 
1993, Saint Francis (PA), 3, 7, 0, 0.30000, 182, 241, -59, 
1994, Saint Francis (PA), 2, 7, 1, 0.25000, 159, 218, -59, 
1894, Texas A&M;, 1, 1, 0, 0.50000, 14, 44, -30, 
1983, Alabama, 8, 4, 0, 0.66667, 366, 229, 137, 
1984, Alabama, 5, 6, 0, 0.45455, 226, 208, 18, 
1985, Alabama, 9, 2, 1, 0.79167, 318, 181, 137, 
1986, Alabama, 10, 3, 0, 0.76923, 351, 163, 188, 
1992, Arkansas St., 2, 9, 0, 0.18182, 118, 402, -284, 
1983, Michigan St., 4, 6, 1, 0.40909, 162, 233, -71, 
1984, Michigan St., 6, 6, 0, 0.50000, 193, 203, -10, 
1985, Michigan St., 7, 5, 0, 0.58333, 258, 219, 39, 
1986, Michigan St., 6, 5, 0, 0.54545, 285, 197, 88, 
1987, Michigan St., 9, 2, 1, 0.79167, 261, 153, 108, 
1988, Michigan St., 6, 5, 1, 0.54167, 269, 177, 92, 
1989, Michigan St., 8, 4, 0, 0.66667, 356, 163, 193, 
1990, Michigan St., 8, 3, 1, 0.70833, 312, 223, 89, 
1991, Michigan St., 3, 8, 0, 0.27273, 162, 272, -110, 
1992, Michigan St., 5, 6, 0, 0.45455, 238, 261, -23, 
1993, Michigan St., 6, 6, 0, 0.50000, 277, 289, -12, 
1994, Michigan St., 0, 11, 0, 0.00000, 280, 267, 13, 
1966, Mesa St. (CO), 5, 4, 0, 0.55556, 221, 219, 2, 
1967, Mesa St. (CO), 8, 1, 1, 0.85000, 233, 152, 81, 
1968, Mesa St. (CO), 8, 2, 0, 0.80000, 262, 115, 147, 
1969, Mesa St. (CO), 5, 2, 2, 0.66667, 233, 149, 84, 
1970, Mesa St. (CO), 4, 6, 0, 0.40000, 180, 147, 33, 
1971, Mesa St. (CO), 4, 4, 0, 0.50000, 233, 99, 134, 
1972, Mesa St. (CO), 4, 3, 2, 0.55556, 177, 137, 40, 
1973, Mesa St. (CO), 4, 5, 0, 0.44444, 130, 200, -70, 
1974, Mesa St. (CO), 1, 7, 1, 0.16667, 117, 221, -104, 
1975, Mesa St. (CO), 0, 8, 0, 0.00000, 87, 356, -269, 
1976, Mesa St. (CO), 4, 5, 1, 0.45000, 159, 225, -66, 
1977, Mesa St. (CO), 8, 1, 1, 0.85000, 278, 146, 132, 
1978, Mesa St. (CO), 4, 6, 0, 0.40000, 179, 207, -28, 
1979, Mesa St. (CO), 1, 8, 0, 0.11111, 84, 248, -164, 
1910, Northern Iowa, 1, 4, 1, 0.25000, 78, 64, 14, 
1917, Northern Iowa, 2, 3, 0, 0.40000, 52, 45, 7, 
1982, Hanover (IN), 7, 2, 0, 0.77778, 212, 112, 100, 
1983, Hanover (IN), 5, 4, 0, 0.55556, 177, 178, -1, 
1984, Hanover (IN), 8, 2, 1, 0.77273, 352, 209, 143, 
1985, Hanover (IN), 5, 4, 0, 0.55556, 272, 274, -2, 
1986, Hanover (IN), 8, 2, 0, 0.80000, 325, 143, 182, 
1987, Hanover (IN), 6, 3, 0, 0.66667, 312, 219, 93, 
1988, Hanover (IN), 4, 6, 0, 0.40000, 332, 299, 33, 
1989, Hanover (IN), 9, 1, 1, 0.86364, 368, 166, 202, 
1990, Hanover (IN), 6, 4, 0, 0.60000, 271, 196, 75, 
1991, Hanover (IN), 7, 3, 0, 0.70000, 338, 278, 60, 
1992, Hanover (IN), 6, 4, 0, 0.60000, 311, 279, 32, 
1993, Hanover (IN), 3, 7, 0, 0.30000, 295, 325, -30, 
1994, Hanover (IN), 8, 2, 0, 0.80000, 361, 257, 104, 
1995, Hanover (IN), 10, 1, 0, 0.90909, 405, 260, 145, 
1996, Hanover (IN), 6, 4, 0, 0.60000, 256, 181, 75, 
1997, Hanover (IN), 10, 1, 0, 0.90909, 302, 150, 152, 
1998, Hanover (IN), 9, 1, 0, 0.90000, 407, 199, 208, 
1999, Hanover (IN), 10, 1, 0, 0.90909, 355, 237, 118, 
2000, Hanover (IN), 8, 4, 0, 0.66667, 370, 237, 133, 
2001, Hanover (IN), 5, 5, 0, 0.50000, 268, 281, -13, 
2002, Hanover (IN), 10, 1, 0, 0.90909, 482, 198, 284, 
2003, Hanover (IN), 8, 3, 0, 0.72727, 418, 315, 103, 
2004, Hanover (IN), 6, 4, 0, 0.60000, 254, 231, 23, 
2005, Hanover (IN), 4, 6, 0, 0.40000, 263, 329, -66, 
2006, Hanover (IN), 4, 6, 0, 0.40000, 170, 200, -30, 
2007, Hanover (IN), 2, 8, 0, 0.20000, 182, 388, -206, 
1955, Bowling Green (OH), 7, 1, 1, 0.83333, 224, 53, 171, 
1956, Bowling Green (OH), 8, 0, 1, 0.94444, 311, 99, 212, 
1957, Bowling Green (OH), 6, 1, 2, 0.77778, 167, 55, 112, 
1958, Bowling Green (OH), 7, 2, 0, 0.77778, 218, 91, 127, 
1959, Bowling Green (OH), 9, 0, 0, 1.00000, 274, 83, 191, 
1960, Bowling Green (OH), 8, 1, 0, 0.88889, 196, 61, 135, 
1961, Bowling Green (OH), 8, 2, 0, 0.80000, 194, 78, 116, 
1962, Bowling Green (OH), 7, 1, 1, 0.83333, 204, 91, 113, 
1963, Bowling Green (OH), 8, 2, 0, 0.80000, 201, 116, 85, 
1964, Bowling Green (OH), 9, 1, 0, 0.90000, 275, 87, 188, 
1946, Elon (NC), 4, 5, 1, 0.45000, 79, 171, -92, 
1947, Elon (NC), 4, 6, 0, 0.40000, 67, 131, -64, 
1984, Lenoir-Rhyne (NC), 1, 10, 0, 0.09091, 146, 309, -163, 
1985, Lenoir-Rhyne (NC), 3, 8, 0, 0.27273, 194, 342, -148, 
1986, Lenoir-Rhyne (NC), 4, 7, 0, 0.36364, 172, 254, -82, 
1987, Lenoir-Rhyne (NC), 7, 4, 0, 0.63636, 296, 272, 24, 
1988, Lenoir-Rhyne (NC), 7, 4, 0, 0.63636, 282, 234, 48, 
1989, Lenoir-Rhyne (NC), 5, 6, 0, 0.45455, 284, 307, -23, 
1990, Lenoir-Rhyne (NC), 6, 5, 0, 0.54545, 311, 255, 56, 
1991, Presbyterian (SC), 4, 7, 0, 0.36364, 199, 332, -133, 
1992, Presbyterian (SC), 4, 7, 0, 0.36364, 179, 252, -73, 
1993, Presbyterian (SC), 5, 6, 0, 0.45455, 285, 258, 27, 
1994, Presbyterian (SC), 5, 6, 0, 0.45455, 285, 279, 6, 
1995, Presbyterian (SC), 6, 5, 0, 0.54545, 278, 176, 102, 
1996, Presbyterian (SC), 5, 6, 0, 0.45455, 221, 274, -53, 
2008, Merrimack (MA), 6, 4, 0, 0.60000, 289, 239, 50, 
2009, Merrimack (MA), 7, 3, 0, 0.70000, 349, 278, 71, 
2010, Merrimack (MA), 4, 6, 0, 0.40000, 348, 347, 1, 
2011, Merrimack (MA), 6, 4, 0, 0.60000, 397, 278, 119, 
2012, Merrimack (MA), 6, 4, 0, 0.60000, 410, 311, 99, 
1926, Toledo (OH), 3, 5, 0, 0.37500, 81, 154, -73, 
1927, Toledo (OH), 5, 2, 0, 0.71429, 88, 64, 24, 
1928, Toledo (OH), 1, 6, 0, 0.14286, 46, 130, -84, 
1929, Toledo (OH), 4, 2, 1, 0.64286, 68, 70, -2, 
1918, Wofford (SC), 0, 3, 0, 0.00000, 0, 47, -47, 
1900, Maryland, 3, 4, 1, 0.43750, 68, 67, 1, 
1922, Susquehanna (PA), 2, 6, 1, 0.27778, 75, 253, -178, 
1967, Louisiana College, 0, 10, 0, 0.00000, 92, 322, -230, 
2006, Boise St. (ID), 13, 0, 0, 1.00000, 516, 229, 287, 
2007, Boise St. (ID), 10, 3, 0, 0.76923, 551, 281, 270, 
2008, Boise St. (ID), 12, 1, 0, 0.92308, 489, 164, 325, 
2009, Boise St. (ID), 14, 0, 0, 1.00000, 591, 240, 351, 
2010, Boise St. (ID), 12, 1, 0, 0.92308, 586, 166, 420, 
2011, Boise St. (ID), 12, 1, 0, 0.92308, 575, 243, 332, 
2012, Boise St. (ID), 11, 2, 0, 0.84615, 393, 205, 188, 
2013, Boise St. (ID), 8, 4, 0, 0.66667, 465, 285, 180, 
1896, Holy Cross (MA), 1, 3, 2, 0.33333, 22, 24, -2, 
1897, Holy Cross (MA), 4, 3, 1, 0.56250, 50, 36, 14, 
1952, Southern Oregon, 3, 5, 0, 0.37500, 99, 251, -152, 
1953, Southern Oregon, 3, 4, 0, 0.42857, 86, 151, -65, 
1954, Southern Oregon, 2, 5, 0, 0.28571, 117, 220, -103, 
2011, Maranatha Baptist Bible (WI), 3, 7, 0, 0.30000, 165, 374, -209, 
2012, Maranatha Baptist Bible (WI), 0, 10, 0, 0.00000, 113, 436, -323, 
2013, Maranatha Baptist Bible (WI), 1, 9, 0, 0.10000, 205, 524, -319, 
1960, Florida St., 3, 6, 1, 0.35000, 111, 136, -25, 
1961, Florida St., 4, 5, 1, 0.45000, 93, 128, -35, 
1962, Florida St., 4, 3, 3, 0.55000, 170, 69, 101, 
1963, Florida St., 4, 5, 1, 0.45000, 167, 93, 74, 
1964, Florida St., 9, 1, 1, 0.86364, 263, 85, 178, 
1965, Florida St., 4, 5, 1, 0.45000, 121, 119, 2, 
1966, Florida St., 6, 5, 0, 0.54545, 274, 215, 59, 
1967, Florida St., 7, 2, 2, 0.72727, 250, 187, 63, 
1968, Florida St., 8, 3, 0, 0.72727, 308, 211, 97, 
1969, Florida St., 6, 3, 1, 0.65000, 220, 182, 38, 
1970, Florida St., 7, 4, 0, 0.63636, 254, 195, 59, 
1971, Rice (TX), 3, 7, 1, 0.31818, 146, 220, -74, 
1921, San Diego St. (CA), 4, 6, 0, 0.40000, 60, 100, -40, 
1922, San Diego St. (CA), 6, 4, 0, 0.60000, 190, 104, 86, 
1923, San Diego St. (CA), 8, 2, 0, 0.80000, 207, 82, 125, 
1924, San Diego St. (CA), 7, 1, 2, 0.80000, 249, 53, 196, 
1925, San Diego St. (CA), 5, 3, 1, 0.61111, 108, 59, 49, 
1926, San Diego St. (CA), 3, 4, 1, 0.43750, 78, 150, -72, 
1927, San Diego St. (CA), 4, 3, 0, 0.57143, 190, 79, 111, 
1928, San Diego St. (CA), 3, 3, 0, 0.50000, 111, 105, 6, 
1929, San Diego St. (CA), 3, 5, 0, 0.37500, 81, 96, -15, 
1929, Dubuque (IA), 2, 3, 1, 0.41667, 29, 204, -175, 
1930, Dubuque (IA), 2, 5, 0, 0.28571, 32, 189, -157, 
1970, Sonoma St. (CA), 4, 4, 1, 0.50000, 157, 210, -53, 
1971, Sonoma St. (CA), 2, 8, 0, 0.20000, 153, 277, -124, 
2013, Kentucky Christian, 3, 8, 0, 0.27273, 149, 271, -122, 
1971, Wofford (SC), 6, 4, 0, 0.60000, 205, 155, 50, 
1972, Wofford (SC), 6, 4, 0, 0.60000, 196, 155, 41, 
1973, Wofford (SC), 4, 6, 1, 0.40909, 312, 274, 38, 
1951, Northern Arizona, 1, 7, 0, 0.12500, 76, 211, -135, 
1952, Northern Arizona, 3, 4, 0, 0.42857, 92, 127, -35, 
1953, Northern Arizona, 4, 5, 0, 0.44444, 126, 166, -40, 
1982, Bemidji St. (MN), 2, 8, 0, 0.20000, 150, 257, -107, 
1983, Bemidji St. (MN), 4, 6, 1, 0.40909, 198, 187, 11, 
1984, Bemidji St. (MN), 8, 3, 0, 0.72727, 278, 150, 128, 
1985, Bemidji St. (MN), 7, 3, 0, 0.70000, 248, 90, 158, 
1986, Bemidji St. (MN), 7, 4, 0, 0.63636, 251, 182, 69, 
1987, Bemidji St. (MN), 3, 6, 1, 0.35000, 207, 340, -133, 
1988, Bemidji St. (MN), 1, 9, 0, 0.10000, 151, 308, -157, 
1941, Bethune-Cookman (FL), 4, 3, 1, 0.56250, 127, 38, 89, 
1942, Eastern Washington, 3, 4, 0, 0.42857, 65, 68, -3, 
1934, American International (MA), 1, 4, 1, 0.25000, 19, 99, -80, 
1935, American International (MA), 0, 5, 0, 0.00000, 7, 80, -73, 
1936, American International (MA), 2, 4, 0, 0.33333, 26, 114, -88, 
1937, American International (MA), 4, 2, 1, 0.64286, 61, 56, 5, 
1938, American International (MA), 1, 6, 0, 0.14286, 32, 161, -129, 
1939, American International (MA), 3, 4, 0, 0.42857, 41, 54, -13, 
1940, American International (MA), 5, 2, 0, 0.71429, 127, 40, 87, 
2006, North Park (IL), 1, 9, 0, 0.10000, 101, 371, -270, 
2007, North Park (IL), 1, 9, 0, 0.10000, 146, 309, -163, 
2008, North Park (IL), 1, 9, 0, 0.10000, 175, 389, -214, 
2009, North Park (IL), 1, 9, 0, 0.10000, 119, 437, -318, 
2010, North Park (IL), 2, 8, 0, 0.20000, 139, 296, -157, 
2011, North Park (IL), 3, 7, 0, 0.30000, 167, 294, -127, 
2012, North Park (IL), 1, 9, 0, 0.10000, 153, 384, -231, 
1953, Western Michigan, 1, 6, 1, 0.18750, 66, 238, -172, 
1954, Western Michigan, 4, 5, 0, 0.44444, 136, 186, -50, 
1955, Western Michigan, 1, 7, 1, 0.16667, 80, 200, -120, 
1956, Western Michigan, 2, 7, 0, 0.22222, 114, 168, -54, 
1942, Wofford (SC), 2, 5, 0, 0.28571, 92, 144, -52, 
1946, Wofford (SC), 1, 8, 0, 0.11111, 67, 254, -187, 
1891, Auburn (AL), 1, 0, 0, 1.00000, 10, 0, 10, 
1892, Auburn (AL), 1, 2, 0, 0.33333, 32, 98, -66, 
2003, Louisville (KY), 9, 4, 0, 0.69231, 450, 361, 89, 
2004, Louisville (KY), 11, 1, 0, 0.91667, 597, 236, 361, 
2005, Louisville (KY), 9, 3, 0, 0.75000, 521, 285, 236, 
2006, Louisville (KY), 12, 1, 0, 0.92308, 491, 212, 279, 
2008, Arkansas, 5, 7, 0, 0.41667, 263, 374, -111, 
2009, Arkansas, 8, 5, 0, 0.61538, 468, 326, 142, 
2010, Arkansas, 10, 3, 0, 0.76923, 474, 304, 170, 
2011, Arkansas, 11, 2, 0, 0.84615, 478, 289, 189, 
2013, Western Kentucky, 8, 4, 0, 0.66667, 370, 295, 75, 
2013, Idaho, 1, 11, 0, 0.08333, 218, 561, -343, 
1981, California (PA), 5, 5, 0, 0.50000, 169, 140, 29, 
1982, California (PA), 2, 7, 1, 0.25000, 171, 208, -37, 
1983, California (PA), 7, 3, 0, 0.70000, 303, 138, 165, 
1984, California (PA), 8, 3, 0, 0.72727, 247, 196, 51, 
1985, California (PA), 4, 6, 0, 0.40000, 149, 167, -18, 
1986, California (PA), 6, 4, 0, 0.60000, 227, 232, -5, 
1987, California (PA), 6, 5, 0, 0.54545, 198, 152, 46, 
1988, California (PA), 2, 8, 0, 0.20000, 197, 266, -69, 
1989, California (PA), 4, 6, 0, 0.40000, 212, 272, -60, 
1990, California (PA), 4, 5, 1, 0.45000, 278, 289, -11, 
1991, California (PA), 1, 9, 0, 0.10000, 100, 288, -188, 
1992, California (PA), 4, 6, 1, 0.40909, 184, 239, -55, 
1985, Northern Illinois, 4, 7, 0, 0.36364, 174, 259, -85, 
1986, Northern Illinois, 2, 9, 0, 0.18182, 144, 308, -164, 
1987, Northern Illinois, 5, 5, 1, 0.50000, 305, 262, 43, 
1988, Northern Illinois, 7, 4, 0, 0.63636, 155, 185, -30, 
1989, Northern Illinois, 9, 2, 0, 0.81818, 344, 269, 75, 
1990, Northern Illinois, 6, 5, 0, 0.54545, 333, 260, 73, 
1991, Oregon St., 1, 10, 0, 0.09091, 125, 365, -240, 
1992, Oregon St., 1, 9, 1, 0.13636, 163, 363, -200, 
1993, Oregon St., 4, 7, 0, 0.36364, 224, 294, -70, 
1994, Oregon St., 4, 7, 0, 0.36364, 223, 239, -16, 
1995, Oregon St., 1, 10, 0, 0.09091, 136, 237, -101, 
1996, Oregon St., 2, 9, 0, 0.18182, 216, 388, -172, 
1987, Mississippi Valley St., 1, 10, 0, 0.09091, 81, 283, -202, 
1988, Mississippi Valley St., 3, 8, 0, 0.27273, 156, 292, -136, 
1989, Mississippi Valley St., 1, 9, 0, 0.10000, 82, 316, -234, 
1995, Alabama A&M;, 6, 5, 0, 0.54545, 192, 244, -52, 
1996, Alabama A&M;, 6, 5, 0, 0.54545, 236, 214, 22, 
1997, Alabama A&M;, 7, 4, 0, 0.63636, 236, 223, 13, 
2002, Savannah St. (GA), 1, 9, 0, 0.10000, 106, 341, -235, 
2003, Savannah St. (GA), 0, 5, 0, 0.00000, 18, 205, -187, 
2002, Howard (DC), 6, 5, 0, 0.54545, 243, 286, -43, 
2003, Howard (DC), 4, 7, 0, 0.36364, 208, 265, -57, 
2004, Howard (DC), 6, 5, 0, 0.54545, 249, 225, 24, 
2005, Howard (DC), 4, 7, 0, 0.36364, 173, 228, -55, 
2006, Howard (DC), 5, 6, 0, 0.45455, 180, 237, -57, 
2013, Howard (DC), 6, 6, 0, 0.50000, 316, 322, -6, 
1902, Wichita St. (KS), 4, 3, 1, 0.56250, 52, 29, 23, 
2009, Northwestern St. (LA), 0, 11, 0, 0.00000, 158, 401, -243, 
2010, Northwestern St. (LA), 5, 6, 0, 0.45455, 194, 302, -108, 
2011, Northwestern St. (LA), 5, 6, 0, 0.45455, 234, 297, -63, 
2012, Northwestern St. (LA), 4, 7, 0, 0.36364, 265, 354, -89, 
1931, Swarthmore (PA), 1, 6, 0, 0.14286, 46, 148, -102, 
1932, Swarthmore (PA), 2, 5, 0, 0.28571, 35, 132, -97, 
1933, Swarthmore (PA), 2, 4, 1, 0.35714, 40, 52, -12, 
1934, Swarthmore (PA), 2, 5, 0, 0.28571, 25, 73, -48, 
1935, Swarthmore (PA), 1, 6, 0, 0.14286, 38, 127, -89, 
1980, Johns Hopkins (MD), 1, 8, 0, 0.11111, 188, 293, -105, 
1981, Johns Hopkins (MD), 7, 2, 0, 0.77778, 198, 118, 80, 
1982, Johns Hopkins (MD), 3, 6, 0, 0.33333, 122, 128, -6, 
1983, Johns Hopkins (MD), 5, 4, 0, 0.55556, 177, 205, -28, 
1984, Johns Hopkins (MD), 5, 4, 0, 0.55556, 226, 136, 90, 
1985, Johns Hopkins (MD), 6, 3, 0, 0.66667, 183, 110, 73, 
1986, Johns Hopkins (MD), 3, 5, 1, 0.38889, 102, 176, -74, 
1987, Johns Hopkins (MD), 4, 6, 0, 0.40000, 171, 218, -47, 
1988, Johns Hopkins (MD), 1, 9, 0, 0.10000, 102, 224, -122, 
1989, Johns Hopkins (MD), 1, 9, 0, 0.10000, 113, 291, -178, 
2010, Montana, 7, 4, 0, 0.63636, 349, 243, 106, 
2011, Montana, 11, 3, 0, 0.78571, 474, 279, 195, 
1926, Ashland (OH), 6, 2, 0, 0.75000, 189, 35, 154, 
1920, Missouri, 7, 1, 0, 0.87500, 156, 61, 95, 
1921, Missouri, 6, 2, 0, 0.75000, 136, 50, 86, 
1922, Purdue (IN), 1, 5, 1, 0.21429, 36, 126, -90, 
1923, Purdue (IN), 2, 5, 1, 0.31250, 65, 106, -41, 
1924, Purdue (IN), 5, 2, 0, 0.71429, 137, 46, 91, 
1925, Purdue (IN), 3, 4, 1, 0.43750, 119, 39, 80, 
1926, Purdue (IN), 5, 2, 1, 0.68750, 146, 67, 79, 
1927, Purdue (IN), 6, 2, 0, 0.75000, 170, 38, 132, 
1928, Purdue (IN), 5, 2, 1, 0.68750, 143, 41, 102, 
1929, Purdue (IN), 8, 0, 0, 1.00000, 187, 44, 143, 
1930, Washington, 5, 4, 0, 0.55556, 182, 67, 115, 
1931, Washington, 5, 3, 1, 0.61111, 166, 83, 83, 
1932, Washington, 6, 2, 2, 0.70000, 193, 56, 137, 
1933, Washington, 5, 4, 0, 0.55556, 88, 81, 7, 
1934, Washington, 6, 1, 1, 0.81250, 104, 51, 53, 
1935, Washington, 5, 3, 0, 0.62500, 93, 42, 51, 
1936, Washington, 7, 2, 1, 0.75000, 148, 56, 92, 
1937, Washington, 7, 2, 2, 0.72727, 187, 52, 135, 
1938, Washington, 3, 5, 1, 0.38889, 68, 83, -15, 
1939, Washington, 4, 5, 0, 0.44444, 77, 93, -16, 
1940, Washington, 7, 2, 0, 0.77778, 169, 54, 115, 
1941, Washington, 5, 4, 0, 0.55556, 120, 94, 26, 
1942, Saint Mary's (CA), 6, 3, 1, 0.65000, 135, 46, 89, 
1943, Saint Mary's (CA), 2, 5, 0, 0.28571, 93, 126, -33, 
1944, Saint Mary's (CA), 0, 5, 0, 0.00000, 14, 148, -134, 
1945, Saint Mary's (CA), 7, 2, 0, 0.77778, 282, 65, 217, 
1946, Saint Mary's (CA), 6, 3, 0, 0.66667, 229, 160, 69, 
1947, Saint Mary's (CA), 3, 7, 0, 0.30000, 178, 246, -68, 
1947, Lambuth (TN), 1, 7, 0, 0.12500, 20, 246, -226, 
1999, Siena (NY), 3, 7, 0, 0.30000, 135, 215, -80, 
1900, Mount Union (OH), 3, 6, 1, 0.35000, 42, 127, -85, 
1929, Nevada, 2, 5, 1, 0.31250, 63, 180, -117, 
1930, Nevada, 2, 4, 2, 0.37500, 77, 73, 4, 
1931, Nevada, 2, 5, 2, 0.33333, 76, 134, -58, 
1962, Texas-El Paso, 4, 5, 0, 0.44444, 84, 144, -60, 
1948, Shepherd (WV), 3, 3, 1, 0.50000, 79, 96, -17, 
1949, Shepherd (WV), 6, 2, 0, 0.75000, 196, 62, 134, 
1950, Shepherd (WV), 4, 4, 1, 0.50000, 107, 119, -12, 
1951, West Virginia Tech, 7, 1, 0, 0.87500, 174, 83, 91, 
1952, West Virginia Tech, 6, 3, 0, 0.66667, 144, 119, 25, 
1953, West Virginia Tech, 1, 7, 0, 0.12500, 109, 223, -114, 
1954, West Virginia Tech, 5, 4, 0, 0.55556, 176, 199, -23, 
1955, West Virginia Tech, 5, 3, 1, 0.61111, 129, 145, -16, 
1956, West Virginia Tech, 4, 5, 0, 0.44444, 134, 137, -3, 
1983, Morgan St. (MD), 2, 8, 0, 0.20000, 109, 346, -237, 
1984, Morgan St. (MD), 0, 11, 0, 0.00000, 85, 442, -357, 
2010, Kentucky, 6, 7, 0, 0.46154, 406, 369, 37, 
2011, Kentucky, 5, 7, 0, 0.41667, 190, 296, -106, 
2012, Kentucky, 2, 10, 0, 0.16667, 215, 372, -157, 
1941, Louisiana College, 4, 7, 0, 0.36364, 139, 160, -21, 
1912, Montana, 4, 3, 0, 0.57143, 104, 66, 38, 
1959, Southern Illinois, 5, 4, 0, 0.55556, 181, 144, 37, 
1960, Southern Illinois, 8, 2, 0, 0.80000, 294, 173, 121, 
1961, Southern Illinois, 7, 3, 0, 0.70000, 244, 102, 142, 
1962, Southern Illinois, 4, 6, 0, 0.40000, 152, 144, 8, 
1963, Southern Illinois, 4, 5, 0, 0.44444, 146, 153, -7, 
2013, Central Washington, 7, 4, 0, 0.63636, 265, 173, 92, 
1982, Tennessee-Martin, 5, 6, 0, 0.45455, 142, 266, -124, 
1983, Tennessee-Martin, 4, 7, 0, 0.36364, 143, 282, -139, 
1984, Tennessee-Martin, 2, 8, 1, 0.22727, 124, 282, -158, 
1985, Tennessee-Martin, 1, 10, 0, 0.09091, 105, 324, -219, 
1909, Parsons (IA), 0, 5, 1, 0.08333, 9, 101, -92, 
1913, Arkansas, 7, 2, 0, 0.77778, 137, 43, 94, 
1914, Arkansas, 3, 6, 0, 0.33333, 96, 206, -110, 
1978, Massachusetts, 9, 4, 0, 0.69231, 343, 173, 170, 
1979, Massachusetts, 6, 4, 0, 0.60000, 207, 154, 53, 
1980, Massachusetts, 7, 3, 0, 0.70000, 212, 105, 107, 
1981, Massachusetts, 6, 3, 0, 0.66667, 173, 184, -11, 
1982, Massachusetts, 5, 6, 0, 0.45455, 220, 227, -7, 
1983, Massachusetts, 3, 8, 0, 0.27273, 141, 229, -88, 
1911, Saint Bonaventure (NY), 3, 2, 0, 0.60000, 13, 80, -67, 
1912, Saint Bonaventure (NY), 2, 1, 0, 0.66667, 33, 48, -15, 
1913, Saint Bonaventure (NY), 4, 4, 0, 0.50000, 95, 118, -23, 
1971, American International (MA), 4, 5, 0, 0.44444, 170, 131, 39, 
1972, American International (MA), 5, 4, 0, 0.55556, 227, 199, 28, 
1973, American International (MA), 5, 4, 0, 0.55556, 209, 174, 35, 
1974, American International (MA), 4, 5, 0, 0.44444, 230, 165, 65, 
1975, American International (MA), 8, 1, 0, 0.88889, 214, 109, 105, 
1964, San Francisco (CA), 6, 2, 0, 0.75000, 105, 65, 40, 
1965, San Francisco (CA), 3, 5, 0, 0.37500, 46, 99, -53, 
1966, San Francisco (CA), 4, 5, 0, 0.44444, 168, 164, 4, 
1967, San Francisco (CA), 5, 4, 0, 0.55556, 245, 202, 43, 
1968, San Francisco (CA), 0, 8, 1, 0.05556, 66, 300, -234, 
1909, Middlebury (VT), 2, 3, 0, 0.40000, 21, 48, -27, 
1906, Carlisle Indian School (PA), 9, 3, 0, 0.75000, 244, 40, 204, 
1946, Stephen F. Austin (TX), 1, 9, 0, 0.10000, 69, 174, -105, 
1904, Louisiana Tech, 1, 3, 0, 0.25000, 11, 60, -49, 
1906, Mount Union (OH), 2, 5, 1, 0.31250, 22, 141, -119, 
1896, Delaware, 0, 6, 0, 0.00000, 0, 114, -114, 
1899, Tennessee, 6, 2, 0, 0.75000, 87, 56, 31, 
1900, Tennessee, 3, 2, 1, 0.58333, 67, 51, 16, 
1995, Ferris St. (MI), 12, 1, 0, 0.92308, 440, 280, 160, 
1996, Ferris St. (MI), 10, 2, 0, 0.83333, 334, 209, 125, 
1997, Ferris St. (MI), 3, 7, 0, 0.30000, 222, 243, -21, 
1998, Ferris St. (MI), 5, 6, 0, 0.45455, 355, 346, 9, 
1999, Ferris St. (MI), 7, 3, 0, 0.70000, 473, 262, 211, 
2000, Ferris St. (MI), 5, 6, 0, 0.45455, 298, 256, 42, 
2001, Ferris St. (MI), 7, 4, 0, 0.63636, 274, 248, 26, 
2002, Ferris St. (MI), 5, 5, 0, 0.50000, 210, 198, 12, 
2003, Ferris St. (MI), 6, 5, 0, 0.54545, 285, 286, -1, 
2004, Ferris St. (MI), 6, 5, 0, 0.54545, 183, 273, -90, 
2005, Ferris St. (MI), 3, 8, 0, 0.27273, 258, 355, -97, 
2006, Ferris St. (MI), 8, 3, 0, 0.72727, 278, 217, 61, 
2007, Ferris St. (MI), 6, 5, 0, 0.54545, 320, 318, 2, 
2008, Ferris St. (MI), 6, 5, 0, 0.54545, 182, 228, -46, 
2009, Ferris St. (MI), 1, 10, 0, 0.09091, 122, 402, -280, 
2010, Ferris St. (MI), 5, 6, 0, 0.45455, 273, 299, -26, 
2011, Ferris St. (MI), 6, 5, 0, 0.54545, 309, 272, 37, 
1952, Sam Houston St. (TX), 6, 4, 0, 0.60000, 335, 233, 102, 
1953, Sam Houston St. (TX), 9, 1, 0, 0.90000, 225, 115, 110, 
1954, Sam Houston St. (TX), 6, 4, 0, 0.60000, 242, 130, 112, 
1955, Sam Houston St. (TX), 6, 1, 2, 0.77778, 238, 125, 113, 
1956, Sam Houston St. (TX), 10, 0, 0, 1.00000, 242, 53, 189, 
1957, Sam Houston St. (TX), 3, 5, 1, 0.38889, 122, 147, -25, 
1958, Sam Houston St. (TX), 7, 3, 0, 0.70000, 134, 140, -6, 
1959, Sam Houston St. (TX), 5, 5, 0, 0.50000, 120, 114, 6, 
1960, Sam Houston St. (TX), 3, 6, 0, 0.33333, 74, 87, -13, 
1961, Sam Houston St. (TX), 8, 1, 0, 0.88889, 154, 73, 81, 
1962, Sam Houston St. (TX), 5, 3, 1, 0.61111, 130, 109, 21, 
1963, Sam Houston St. (TX), 4, 3, 1, 0.56250, 172, 115, 57, 
1964, Sam Houston St. (TX), 9, 1, 1, 0.86364, 214, 100, 114, 
1965, Sam Houston St. (TX), 4, 6, 0, 0.40000, 152, 109, 43, 
1966, Sam Houston St. (TX), 6, 3, 1, 0.65000, 182, 96, 86, 
1967, Sam Houston St. (TX), 3, 6, 0, 0.33333, 102, 229, -127, 
1928, Doane (NE), 4, 2, 1, 0.64286, 80, 54, 26, 
1929, Doane (NE), 6, 1, 0, 0.85714, 114, 30, 84, 
1930, Doane (NE), 4, 3, 0, 0.57143, 76, 52, 24, 
1931, Doane (NE), 1, 6, 1, 0.18750, 71, 129, -58, 
1932, Doane (NE), 3, 4, 1, 0.43750, 39, 87, -48, 
1945, Fresno St. (CA), 4, 6, 2, 0.41667, 113, 92, 21, 
1949, Fresno St. (CA), 3, 8, 0, 0.27273, 156, 344, -188, 
2013, Olivet (MI), 6, 4, 0, 0.60000, 271, 259, 12, 
1957, North Carolina A&T;, 4, 3, 1, 0.56250, 118, 86, 32, 
1958, North Carolina A&T;, 7, 2, 0, 0.77778, 188, 132, 56, 
1959, North Carolina A&T;, 6, 2, 0, 0.75000, 164, 100, 64, 
1960, North Carolina A&T;, 5, 3, 1, 0.61111, 208, 150, 58, 
1961, North Carolina A&T;, 5, 4, 0, 0.55556, 178, 165, 13, 
1962, North Carolina A&T;, 7, 3, 0, 0.70000, 234, 142, 92, 
1963, North Carolina A&T;, 6, 3, 0, 0.66667, 233, 124, 109, 
1964, North Carolina A&T;, 6, 3, 1, 0.65000, 272, 208, 64, 
1965, North Carolina A&T;, 4, 5, 0, 0.44444, 138, 186, -48, 
1966, North Carolina A&T;, 3, 6, 0, 0.33333, 181, 204, -23, 
1967, North Carolina A&T;, 3, 5, 1, 0.38889, 155, 191, -36, 
1956, Delaware Valley (PA), 3, 4, 0, 0.42857, 91, 110, -19, 
1957, Delaware Valley (PA), 6, 1, 0, 0.85714, 193, 45, 148, 
1958, Delaware Valley (PA), 5, 2, 1, 0.68750, 114, 101, 13, 
1954, Tulane (LA), 1, 6, 3, 0.25000, 46, 144, -98, 
1955, Tulane (LA), 5, 4, 1, 0.55000, 163, 136, 27, 
1956, Tulane (LA), 6, 4, 0, 0.60000, 124, 123, 1, 
1957, Tulane (LA), 2, 8, 0, 0.20000, 91, 195, -104, 
1958, Tulane (LA), 3, 7, 0, 0.30000, 105, 189, -84, 
1959, Tulane (LA), 3, 6, 1, 0.35000, 94, 176, -82, 
1960, Tulane (LA), 3, 6, 1, 0.35000, 132, 140, -8, 
1961, Tulane (LA), 2, 8, 0, 0.20000, 60, 225, -165, 
1991, Toledo (OH), 5, 5, 1, 0.50000, 187, 209, -22, 
1992, Toledo (OH), 8, 3, 0, 0.72727, 269, 153, 116, 
1993, Toledo (OH), 4, 7, 0, 0.36364, 252, 270, -18, 
1994, Toledo (OH), 6, 4, 1, 0.59091, 352, 324, 28, 
1995, Toledo (OH), 11, 0, 1, 0.95833, 411, 264, 147, 
1996, Toledo (OH), 7, 4, 0, 0.63636, 210, 259, -49, 
1997, Toledo (OH), 9, 3, 0, 0.75000, 356, 268, 88, 
1998, Toledo (OH), 7, 5, 0, 0.58333, 229, 216, 13, 
1999, Toledo (OH), 6, 5, 0, 0.54545, 293, 229, 64, 
2000, Toledo (OH), 10, 1, 0, 0.90909, 400, 125, 275, 
2001, Missouri, 4, 7, 0, 0.36364, 240, 330, -90, 
2002, Missouri, 5, 7, 0, 0.41667, 360, 352, 8, 
2003, Missouri, 8, 5, 0, 0.61538, 399, 287, 112, 
2004, Missouri, 5, 6, 0, 0.45455, 256, 215, 41, 
2005, Missouri, 7, 5, 0, 0.58333, 369, 350, 19, 
2006, Missouri, 8, 5, 0, 0.61538, 391, 254, 137, 
2007, Missouri, 12, 2, 0, 0.85714, 558, 326, 232, 
2008, Missouri, 10, 4, 0, 0.71429, 591, 381, 210, 
2009, Missouri, 8, 5, 0, 0.61538, 377, 330, 47, 
2010, Missouri, 10, 3, 0, 0.76923, 388, 209, 179, 
2011, Missouri, 7, 5, 0, 0.58333, 396, 279, 117, 
2012, Missouri, 5, 7, 0, 0.41667, 309, 341, -32, 
2013, Missouri, 12, 2, 0, 0.85714, 548, 323, 225, 
1911, Jackson St. (MS), 0, 1, 0, 0.00000, 0, 17, -17, 
1912, Jackson St. (MS), 0, 2, 0, 0.00000, 0, 40, -40, 
1912, Oregon, 3, 4, 0, 0.42857, 39, 77, -38, 
1910, South Dakota, 5, 2, 0, 0.71429, 142, 46, 96, 
1916, Oregon St., 4, 5, 0, 0.44444, 92, 112, -20, 
1917, Oregon St., 4, 2, 1, 0.64286, 83, 33, 50, 
1902, Doane (NE), 2, 3, 0, 0.40000, 44, 75, -31, 
2001, West Alabama, 1, 10, 0, 0.09091, 132, 380, -248, 
2002, West Alabama, 5, 6, 0, 0.45455, 280, 337, -57, 
2003, West Alabama, 2, 9, 0, 0.18182, 252, 390, -138, 
1943, Richmond (VA), 6, 1, 0, 0.85714, 204, 84, 120, 
1944, Richmond (VA), 2, 6, 0, 0.25000, 79, 224, -145, 
1952, Stetson (FL), 3, 4, 3, 0.45000, 149, 243, -94, 
1953, Stetson (FL), 3, 6, 0, 0.33333, 111, 215, -104, 
1954, Stetson (FL), 1, 7, 0, 0.12500, 60, 301, -241, 
1927, Arkansas-Monticello, 2, 5, 1, 0.31250, 43, 118, -75, 
1928, Arkansas-Monticello, 4, 5, 0, 0.44444, 74, 166, -92, 
1929, Arkansas-Monticello, 4, 4, 1, 0.50000, 129, 120, 9, 
1930, Arkansas-Monticello, 4, 3, 1, 0.56250, 118, 134, -16, 
2009, Fort Valley St. (GA), 7, 4, 0, 0.63636, 326, 232, 94, 
2010, Fort Valley St. (GA), 8, 3, 0, 0.72727, 323, 153, 170, 
2011, Fort Valley St. (GA), 2, 8, 0, 0.20000, 242, 285, -43, 
2012, Fort Valley St. (GA), 8, 4, 0, 0.66667, 325, 297, 28, 
2013, Fort Valley St. (GA), 4, 6, 0, 0.40000, 220, 238, -18, 
1966, Tulane (LA), 5, 4, 1, 0.55000, 153, 182, -29, 
1967, Tulane (LA), 3, 7, 0, 0.30000, 164, 223, -59, 
1968, Tulane (LA), 2, 8, 0, 0.20000, 163, 300, -137, 
1969, Tulane (LA), 3, 7, 0, 0.30000, 152, 235, -83, 
1970, Tulane (LA), 8, 4, 0, 0.66667, 196, 160, 36, 
1971, Texas Christian, 3, 3, 1, 0.50000, 159, 203, -44, 
1923, Auburn (AL), 3, 3, 3, 0.50000, 96, 58, 38, 
1924, Auburn (AL), 4, 4, 1, 0.50000, 46, 40, 6, 
1927, Auburn (AL), 0, 4, 2, 0.16667, 24, 82, -58, 
1924, Miami (OH), 2, 6, 0, 0.25000, 62, 147, -85, 
1925, Miami (OH), 5, 3, 0, 0.62500, 123, 55, 68, 
1926, Miami (OH), 5, 2, 1, 0.68750, 112, 58, 54, 
1927, Miami (OH), 8, 1, 0, 0.88889, 255, 56, 199, 
1928, Miami (OH), 6, 2, 0, 0.75000, 140, 46, 94, 
1929, Miami (OH), 7, 2, 0, 0.77778, 179, 40, 139, 
1930, Miami (OH), 4, 4, 1, 0.50000, 131, 82, 49, 
1931, Miami (OH), 4, 5, 0, 0.44444, 161, 122, 39, 
1919, Oklahoma St., 3, 3, 2, 0.50000, 126, 94, 32, 
1920, Oklahoma St., 0, 7, 1, 0.06250, 35, 199, -164, 
1929, George Washington (DC), 0, 8, 0, 0.00000, 32, 230, -198, 
1930, George Washington (DC), 4, 4, 1, 0.50000, 153, 112, 41, 
1931, George Washington (DC), 5, 2, 1, 0.68750, 200, 44, 156, 
1932, George Washington (DC), 6, 2, 1, 0.72222, 149, 76, 73, 
1933, George Washington (DC), 5, 3, 1, 0.61111, 125, 51, 74, 
1934, George Washington (DC), 6, 3, 1, 0.65000, 102, 29, 73, 
1935, George Washington (DC), 6, 3, 0, 0.66667, 135, 101, 34, 
1936, George Washington (DC), 7, 1, 1, 0.83333, 175, 38, 137, 
1937, George Washington (DC), 3, 4, 1, 0.43750, 104, 105, -1, 
1976, New York Tech, 3, 6, 0, 0.33333, 137, 145, -8, 
1977, New York Tech, 3, 7, 0, 0.30000, 128, 217, -89, 
1978, New York Tech, 6, 3, 0, 0.66667, 159, 107, 52, 
1979, New York Tech, 1, 7, 1, 0.16667, 98, 198, -100, 
1903, Akron (OH), 1, 2, 0, 0.33333, 11, 43, -32, 
2007, Chowan (NC), 2, 9, 0, 0.18182, 199, 511, -312, 
2008, Chowan (NC), 2, 8, 0, 0.20000, 216, 440, -224, 
2009, Chowan (NC), 2, 8, 0, 0.20000, 253, 352, -99, 
2010, Chowan (NC), 3, 7, 0, 0.30000, 187, 413, -226, 
2011, Chowan (NC), 3, 7, 0, 0.30000, 271, 337, -66, 
2012, Chowan (NC), 6, 4, 0, 0.60000, 328, 268, 60, 
2013, Chowan (NC), 4, 6, 0, 0.40000, 313, 346, -33, 
1906, Washington, 4, 1, 4, 0.66667, 49, 35, 14, 
1907, Washington, 4, 4, 2, 0.50000, 96, 48, 48, 
1908, Notre Dame (IN), 8, 1, 0, 0.88889, 326, 20, 306, 
1928, Idaho St., 5, 1, 1, 0.78571, 138, 69, 69, 
1929, Idaho St., 6, 4, 0, 0.60000, 140, 74, 66, 
1930, Idaho St., 4, 3, 0, 0.57143, 191, 125, 66, 
1931, Idaho St., 7, 1, 0, 0.87500, 223, 38, 185, 
1932, Idaho St., 3, 4, 1, 0.43750, 83, 103, -20, 
1933, Idaho St., 5, 1, 0, 0.83333, 86, 46, 40, 
1934, Idaho St., 4, 2, 1, 0.64286, 187, 47, 140, 
1902, Texas A&M;, 7, 0, 2, 0.88889, 129, 11, 118, 
1903, Texas A&M;, 7, 3, 1, 0.68182, 90, 59, 31, 
1904, Texas A&M;, 4, 2, 0, 0.66667, 104, 51, 53, 
1959, San Diego (CA), 1, 5, 0, 0.16667, 84, 198, -114, 
1910, Franklin & Marshall (PA), 4, 3, 2, 0.55556, 88, 46, 42, 
1914, West Virginia Wesleyan, 4, 3, 0, 0.57143, 88, 101, -13, 
1915, Buffalo (NY), 4, 4, 0, 0.50000, 53, 110, -57, 
1979, Delta St. (MS), 4, 6, 0, 0.40000, 164, 240, -76, 
1980, Delta St. (MS), 3, 8, 0, 0.27273, 112, 245, -133, 
1981, Delta St. (MS), 2, 7, 0, 0.22222, 135, 227, -92, 
1913, Virginia Military Institute, 7, 1, 2, 0.80000, 197, 54, 143, 
1903, Virginia, 7, 2, 1, 0.75000, 177, 34, 143, 
1893, Virginia, 8, 3, 0, 0.72727, 244, 78, 166, 
1894, Virginia, 8, 2, 0, 0.80000, 404, 30, 374, 
1896, Navy (MD), 5, 3, 0, 0.62500, 180, 53, 127, 
1947, Eastern Washington, 6, 1, 1, 0.81250, 122, 60, 62, 
1948, Eastern Washington, 8, 1, 0, 0.88889, 194, 80, 114, 
1949, Eastern Washington, 7, 2, 0, 0.77778, 174, 96, 78, 
1950, Eastern Washington, 8, 2, 0, 0.80000, 191, 86, 105, 
1951, Eastern Washington, 2, 6, 0, 0.25000, 70, 250, -180, 
1952, Eastern Washington, 1, 7, 0, 0.12500, 80, 148, -68, 
1975, Dubuque (IA), 4, 5, 1, 0.45000, 157, 216, -59, 
1976, Dubuque (IA), 1, 9, 0, 0.10000, 83, 282, -199, 
1931, Western Carolina (NC), 4, 4, 0, 0.50000, 59, 123, -64, 
1932, Western Carolina (NC), 2, 9, 0, 0.18182, 114, 171, -57, 
1933, Western Carolina (NC), 1, 7, 1, 0.16667, 32, 202, -170, 
1934, Western Carolina (NC), 3, 7, 0, 0.30000, 61, 139, -78, 
1935, Western Carolina (NC), 1, 10, 0, 0.09091, 73, 236, -163, 
1982, Pittsburg St. (KS), 7, 2, 0, 0.77778, 232, 112, 120, 
1983, Pittsburg St. (KS), 6, 4, 0, 0.60000, 228, 227, 1, 
2013, Nevada, 4, 8, 0, 0.33333, 323, 413, -90, 
1994, Indianapolis (IN), 2, 7, 1, 0.25000, 145, 315, -170, 
1995, Indianapolis (IN), 3, 8, 0, 0.27273, 109, 304, -195, 
1996, Indianapolis (IN), 4, 7, 0, 0.36364, 175, 241, -66, 
1997, Indianapolis (IN), 8, 3, 0, 0.72727, 262, 204, 58, 
1998, Indianapolis (IN), 8, 2, 0, 0.80000, 320, 179, 141, 
1999, Indianapolis (IN), 7, 4, 0, 0.63636, 220, 169, 51, 
2000, Indianapolis (IN), 3, 8, 0, 0.27273, 305, 313, -8, 
2001, Indianapolis (IN), 7, 4, 0, 0.63636, 254, 210, 44, 
2002, Indianapolis (IN), 5, 6, 0, 0.45455, 276, 287, -11, 
2003, Indianapolis (IN), 6, 5, 0, 0.54545, 287, 368, -81, 
2004, Indianapolis (IN), 4, 7, 0, 0.36364, 259, 306, -47, 
2005, Indianapolis (IN), 6, 5, 0, 0.54545, 201, 201, 0, 
2006, Indianapolis (IN), 6, 5, 0, 0.54545, 292, 236, 56, 
2007, Indianapolis (IN), 6, 5, 0, 0.54545, 353, 301, 52, 
2008, Indianapolis (IN), 5, 6, 0, 0.45455, 286, 256, 30, 
2009, Indianapolis (IN), 4, 7, 0, 0.36364, 199, 234, -35, 
1996, Lock Haven (PA), 1, 10, 0, 0.09091, 103, 395, -292, 
1997, Lock Haven (PA), 3, 8, 0, 0.27273, 161, 285, -124, 
1998, Lock Haven (PA), 4, 7, 0, 0.36364, 211, 320, -109, 
1999, Lock Haven (PA), 2, 9, 0, 0.18182, 232, 383, -151, 
1921, Broaddus College (WV), 2, 6, 0, 0.25000, 46, 79, -33, 
1901, Lehigh (PA), 1, 11, 0, 0.08333, 26, 278, -252, 
1906, Alabama, 5, 1, 0, 0.83333, 97, 82, 15, 
1907, Alabama, 5, 1, 2, 0.75000, 70, 64, 6, 
1908, Alabama, 6, 1, 1, 0.81250, 108, 31, 77, 
1909, Alabama, 5, 1, 2, 0.75000, 68, 17, 51, 
1934, Yale (CT), 5, 3, 0, 0.62500, 104, 54, 50, 
1935, Yale (CT), 6, 3, 0, 0.66667, 182, 99, 83, 
1936, Yale (CT), 7, 1, 0, 0.87500, 131, 60, 71, 
1937, Yale (CT), 6, 1, 1, 0.81250, 137, 36, 101, 
1938, Yale (CT), 2, 6, 0, 0.25000, 69, 135, -66, 
1939, Yale (CT), 3, 4, 1, 0.43750, 78, 122, -44, 
1940, Yale (CT), 1, 7, 0, 0.12500, 43, 162, -119, 
1956, Miami (OH), 7, 1, 1, 0.83333, 159, 83, 76, 
1957, Miami (OH), 6, 3, 0, 0.66667, 163, 137, 26, 
1958, Miami (OH), 6, 3, 0, 0.66667, 193, 96, 97, 
1959, Miami (OH), 5, 4, 0, 0.55556, 158, 94, 64, 
1960, Miami (OH), 5, 5, 0, 0.50000, 139, 159, -20, 
1961, Miami (OH), 6, 4, 0, 0.60000, 153, 115, 38, 
1962, Miami (OH), 8, 2, 1, 0.77273, 241, 175, 66, 
1963, Yale (CT), 6, 3, 0, 0.66667, 135, 78, 57, 
1964, Yale (CT), 6, 2, 1, 0.72222, 195, 120, 75, 
1965, Indiana, 2, 8, 0, 0.20000, 134, 225, -91, 
1966, Indiana, 1, 8, 1, 0.15000, 104, 229, -125, 
1967, Indiana, 9, 2, 0, 0.81818, 197, 159, 38, 
1968, Indiana, 6, 4, 0, 0.60000, 250, 262, -12, 
1969, Indiana, 4, 6, 0, 0.40000, 252, 242, 10, 
1970, Indiana, 1, 9, 0, 0.10000, 102, 300, -198, 
1971, Indiana, 3, 8, 0, 0.27273, 152, 260, -108, 
1972, Indiana, 5, 6, 0, 0.45455, 204, 272, -68, 
1973, Northwestern (IL), 4, 7, 0, 0.36364, 188, 299, -111, 
1974, Northwestern (IL), 3, 8, 0, 0.27273, 140, 385, -245, 
1975, Northwestern (IL), 3, 8, 0, 0.27273, 149, 318, -169, 
1976, Northwestern (IL), 1, 10, 0, 0.09091, 134, 311, -177, 
1977, Northwestern (IL), 1, 10, 0, 0.09091, 102, 337, -235, 
1990, Mount Saint Joseph (OH), 1, 9, 0, 0.10000, 160, 330, -170, 
1991, Mount Saint Joseph (OH), 4, 6, 0, 0.40000, 204, 249, -45, 
1992, Mount Saint Joseph (OH), 4, 5, 0, 0.44444, 135, 269, -134, 
1910, Northwestern St. (LA), 6, 1, 0, 0.85714, 120, 37, 83, 
1911, Northwestern St. (LA), 3, 5, 0, 0.37500, 92, 175, -83, 
1912, Northwestern St. (LA), 4, 1, 1, 0.75000, 120, 46, 74, 
1920, Miles (AL), 4, 1, 0, 0.80000, 129, 39, 90, 
1921, Miles (AL), 0, 1, 2, 0.33333, 7, 34, -27, 
1922, Miles (AL), 2, 1, 0, 0.66667, 57, 12, 45, 
1923, Miles (AL), 0, 2, 0, 0.00000, 6, 29, -23, 
1924, Miles (AL), 4, 3, 1, 0.56250, 57, 68, -11, 
1968, Franklin & Marshall (PA), 6, 2, 0, 0.75000, 149, 58, 91, 
1969, Franklin & Marshall (PA), 1, 7, 0, 0.12500, 114, 229, -115, 
1970, Franklin & Marshall (PA), 3, 5, 0, 0.37500, 152, 147, 5, 
1906, Wisconsin-Oshkosh, 3, 3, 2, 0.50000, 53, 21, 32, 
1961, Mississippi Valley St., 2, 5, 0, 0.28571, 47, 213, -166, 
1962, Mississippi Valley St., 2, 5, 0, 0.28571, 94, 145, -51, 
1963, Mississippi Valley St., 6, 3, 0, 0.66667, 302, 122, 180, 
1964, Mississippi Valley St., 5, 4, 0, 0.55556, 221, 105, 116, 
1965, Mississippi Valley St., 6, 3, 0, 0.66667, 255, 118, 137, 
1974, Howard (DC), 8, 2, 1, 0.77273, 270, 89, 181, 
1975, Howard (DC), 8, 3, 0, 0.72727, 201, 147, 54, 
1976, Howard (DC), 5, 5, 1, 0.50000, 237, 212, 25, 
1977, Howard (DC), 5, 5, 0, 0.50000, 183, 184, -1, 
1978, Howard (DC), 4, 6, 0, 0.40000, 178, 193, -15, 
1979, Fort Valley St. (GA), 5, 3, 1, 0.61111, 148, 171, -23, 
1980, Fort Valley St. (GA), 7, 3, 1, 0.68182, 247, 122, 125, 
1981, Fort Valley St. (GA), 9, 2, 0, 0.81818, 398, 103, 295, 
1982, Fort Valley St. (GA), 10, 2, 0, 0.83333, 348, 92, 256, 
1983, Fort Valley St. (GA), 9, 1, 0, 0.90000, 289, 130, 159, 
1984, Fort Valley St. (GA), 8, 3, 0, 0.72727, 323, 132, 191, 
1985, Fort Valley St. (GA), 9, 3, 0, 0.75000, 296, 83, 213, 
1986, Fort Valley St. (GA), 7, 3, 0, 0.70000, 176, 124, 52, 
1987, Fort Valley St. (GA), 4, 6, 0, 0.40000, 172, 174, -2, 
1988, Fort Valley St. (GA), 5, 5, 0, 0.50000, 185, 187, -2, 
1989, Fort Valley St. (GA), 7, 3, 0, 0.70000, 263, 179, 84, 
1990, Fort Valley St. (GA), 4, 7, 0, 0.36364, 206, 286, -80, 
1991, Fort Valley St. (GA), 7, 3, 0, 0.70000, 250, 184, 66, 
1992, Fort Valley St. (GA), 7, 4, 0, 0.63636, 235, 169, 66, 
1993, Fort Valley St. (GA), 7, 4, 0, 0.63636, 243, 180, 63, 
1994, Fort Valley St. (GA), 6, 4, 0, 0.60000, 228, 291, -63, 
1995, Fort Valley St. (GA), 4, 7, 0, 0.36364, 142, 233, -91, 
1996, Fort Valley St. (GA), 6, 5, 0, 0.54545, 189, 177, 12, 
2010, Avila (MO), 2, 8, 0, 0.20000, 162, 373, -211, 
2011, Point (GA), 2, 5, 0, 0.28571, 129, 198, -69, 
2012, Point (GA), 3, 8, 0, 0.27273, 230, 386, -156, 
2010, Memphis (TN), 1, 11, 0, 0.08333, 173, 478, -305, 
2011, Memphis (TN), 2, 10, 0, 0.16667, 195, 421, -226, 
1945, Norfolk St. (VA), 3, 2, 1, 0.58333, 69, 22, 47, 
1946, Norfolk St. (VA), 4, 5, 0, 0.44444, 78, 76, 2, 
1947, Norfolk St. (VA), 5, 2, 0, 0.71429, 116, 80, 36, 
1948, Norfolk St. (VA), 5, 3, 1, 0.61111, 218, 47, 171, 
1949, Norfolk St. (VA), 6, 0, 0, 1.00000, 107, 30, 77, 
1950, Norfolk St. (VA), 5, 2, 1, 0.68750, 122, 39, 83, 
1951, Norfolk St. (VA), 2, 3, 1, 0.41667, 59, 59, 0, 
2003, Delaware St., 1, 4, 0, 0.20000, 98, 168, -70, 
2006, Brevard College (NC), 2, 6, 0, 0.25000, 72, 303, -231, 
1985, Presbyterian (SC), 7, 3, 1, 0.68182, 234, 158, 76, 
1986, Presbyterian (SC), 5, 6, 0, 0.45455, 217, 199, 18, 
1987, Presbyterian (SC), 8, 5, 0, 0.61538, 289, 191, 98, 
1988, Presbyterian (SC), 3, 8, 0, 0.27273, 221, 285, -64, 
1989, Presbyterian (SC), 4, 7, 0, 0.36364, 286, 356, -70, 
1990, Presbyterian (SC), 2, 9, 0, 0.18182, 143, 347, -204, 
1906, Kalamazoo (MI), 1, 3, 1, 0.30000, 14, 65, -51, 
1961, Missouri St., 4, 4, 1, 0.50000, 109, 100, 9, 
1962, Missouri St., 5, 3, 1, 0.61111, 177, 138, 39, 
1963, Missouri St., 9, 1, 0, 0.90000, 265, 61, 204, 
1964, Missouri St., 6, 4, 0, 0.60000, 202, 92, 110, 
1897, Drake (IA), 2, 3, 0, 0.40000, 34, 66, -32, 
1898, Drake (IA), 4, 2, 0, 0.66667, 102, 55, 47, 
1899, Drake (IA), 5, 2, 0, 0.71429, 121, 57, 64, 
1977, Marquette (WI), 1, 5, 0, 0.16667, 28, 157, -129, 
1978, Marquette (WI), 1, 5, 0, 0.16667, 8, 133, -125, 
1979, Marquette (WI), 0, 4, 0, 0.00000, 18, 113, -95, 
1980, Marquette (WI), 0, 6, 0, 0.00000, 6, 204, -198, 
1981, Marquette (WI), 2, 5, 0, 0.28571, 119, 197, -78, 
1982, Marquette (WI), 4, 4, 0, 0.50000, 103, 127, -24, 
1983, Marquette (WI), 4, 4, 0, 0.50000, 130, 114, 16, 
1984, Marquette (WI), 4, 4, 0, 0.50000, 132, 126, 6, 
1985, Marquette (WI), 2, 5, 0, 0.28571, 38, 174, -136, 
1940, Colorado, 5, 3, 1, 0.61111, 182, 106, 76, 
1944, Colorado, 6, 2, 0, 0.75000, 201, 72, 129, 
1945, Colorado, 5, 3, 0, 0.62500, 111, 58, 53, 
2002, South Carolina St., 7, 5, 0, 0.58333, 321, 212, 109, 
2003, South Carolina St., 8, 4, 0, 0.66667, 364, 229, 135, 
2004, South Carolina St., 9, 2, 0, 0.81818, 384, 230, 154, 
2005, South Carolina St., 9, 2, 0, 0.81818, 378, 166, 212, 
2006, South Carolina St., 7, 4, 0, 0.63636, 298, 204, 94, 
2007, South Carolina St., 7, 4, 0, 0.63636, 294, 216, 78, 
2008, South Carolina St., 10, 3, 0, 0.76923, 387, 221, 166, 
2009, South Carolina St., 10, 2, 0, 0.83333, 365, 187, 178, 
2010, South Carolina St., 9, 3, 0, 0.75000, 366, 184, 182, 
2011, South Carolina St., 7, 4, 0, 0.63636, 313, 204, 109, 
2012, South Carolina St., 5, 6, 0, 0.45455, 204, 303, -99, 
2013, South Carolina St., 9, 4, 0, 0.69231, 375, 198, 177, 
1916, Buffalo (NY), 3, 5, 2, 0.40000, 24, 88, -64, 
1917, Buffalo (NY), 4, 4, 0, 0.50000, 125, 59, 66, 
1918, Buffalo (NY), 6, 1, 0, 0.85714, 234, 40, 194, 
1919, Buffalo (NY), 0, 5, 1, 0.08333, 12, 114, -102, 
1920, Buffalo (NY), 1, 4, 0, 0.20000, 17, 60, -43, 
1921, Buffalo (NY), 2, 3, 2, 0.42857, 74, 105, -31, 
1924, Texas-El Paso, 3, 2, 1, 0.58333, 70, 51, 19, 
1925, Texas-El Paso, 5, 1, 1, 0.78571, 118, 57, 61, 
1926, Texas-El Paso, 3, 4, 0, 0.42857, 106, 92, 14, 
1969, Southern Arkansas, 4, 6, 0, 0.40000, 156, 182, -26, 
1970, Southern Arkansas, 5, 5, 0, 0.50000, 110, 150, -40, 
1971, Southern Arkansas, 9, 2, 0, 0.81818, 258, 158, 100, 
1972, Southern Arkansas, 8, 2, 0, 0.80000, 288, 126, 162, 
1973, Southern Arkansas, 8, 2, 0, 0.80000, 213, 99, 114, 
1974, Southern Arkansas, 7, 4, 0, 0.63636, 254, 112, 142, 
1975, Southern Arkansas, 6, 3, 1, 0.65000, 220, 112, 108, 
1976, Southern Arkansas, 7, 3, 0, 0.70000, 210, 148, 62, 
1977, Southern Arkansas, 6, 3, 1, 0.65000, 228, 192, 36, 
1978, Southern Arkansas, 2, 8, 0, 0.20000, 132, 255, -123, 
1919, Montana St., 1, 3, 1, 0.30000, 49, 97, -48, 
1920, Stanford (CA), 4, 3, 0, 0.57143, 82, 65, 17, 
1996, Citadel (SC), 4, 7, 0, 0.36364, 236, 335, -99, 
1997, Citadel (SC), 6, 5, 0, 0.54545, 165, 224, -59, 
1998, Citadel (SC), 5, 6, 0, 0.45455, 223, 296, -73, 
1999, Citadel (SC), 2, 9, 0, 0.18182, 147, 349, -202, 
2000, Citadel (SC), 2, 9, 0, 0.18182, 144, 335, -191, 
1977, Washington St., 7, 4, 0, 0.63636, 263, 236, 27, 
1978, Missouri, 8, 4, 0, 0.66667, 368, 236, 132, 
1979, Missouri, 7, 5, 0, 0.58333, 260, 166, 94, 
1980, Missouri, 8, 4, 0, 0.66667, 332, 175, 157, 
1981, Missouri, 8, 4, 0, 0.66667, 276, 159, 117, 
1982, Missouri, 5, 4, 2, 0.54545, 207, 196, 11, 
1983, Missouri, 7, 5, 0, 0.58333, 292, 202, 90, 
1984, Missouri, 3, 7, 1, 0.31818, 310, 301, 9, 
1919, Bloomsburg (PA), 2, 4, 0, 0.33333, 45, 87, -42, 
1963, Colorado St.-Pueblo, 3, 5, 0, 0.37500, 111, 133, -22, 
1964, Colorado St.-Pueblo, 6, 4, 0, 0.60000, 239, 119, 120, 
1965, Colorado St.-Pueblo, 8, 1, 1, 0.85000, 232, 122, 110, 
1966, Colorado St.-Pueblo, 3, 7, 0, 0.30000, 142, 212, -70, 
1967, Colorado St.-Pueblo, 3, 6, 1, 0.35000, 148, 221, -73, 
1968, Colorado St.-Pueblo, 4, 6, 0, 0.40000, 138, 256, -118, 
1969, Colorado St.-Pueblo, 7, 2, 0, 0.77778, 191, 121, 70, 
1970, Colorado St.-Pueblo, 5, 5, 0, 0.50000, 202, 236, -34, 
1971, Colorado St.-Pueblo, 4, 6, 0, 0.40000, 200, 183, 17, 
1972, Colorado St.-Pueblo, 6, 4, 0, 0.60000, 209, 149, 60, 
1973, Colorado St.-Pueblo, 3, 7, 0, 0.30000, 176, 275, -99, 
1912, Louisiana-Lafayette, 3, 4, 0, 0.42857, 90, 239, -149, 
1913, Northwestern St. (LA), 4, 1, 1, 0.75000, 213, 67, 146, 
1914, Northwestern St. (LA), 4, 1, 1, 0.75000, 203, 19, 184, 
1915, Northwestern St. (LA), 4, 2, 0, 0.66667, 288, 45, 243, 
1916, Northwestern St. (LA), 1, 2, 0, 0.33333, 84, 46, 38, 
1917, Northwestern St. (LA), 2, 1, 0, 0.66667, 57, 34, 23, 
1919, Northwestern St. (LA), 5, 2, 0, 0.71429, 105, 25, 80, 
1920, Northwestern St. (LA), 5, 1, 1, 0.78571, 76, 47, 29, 
1921, Northwestern St. (LA), 3, 3, 1, 0.50000, 37, 134, -97, 
1922, Northwestern St. (LA), 4, 2, 1, 0.64286, 73, 47, 26, 
1923, Northwestern St. (LA), 3, 6, 0, 0.33333, 65, 209, -144, 
1924, Northwestern St. (LA), 4, 2, 1, 0.64286, 91, 63, 28, 
1925, Northwestern St. (LA), 5, 3, 1, 0.61111, 101, 70, 31, 
1926, Northwestern St. (LA), 3, 5, 1, 0.38889, 88, 160, -72, 
1927, Northwestern St. (LA), 2, 3, 2, 0.42857, 63, 85, -22, 
1928, Northwestern St. (LA), 5, 4, 0, 0.55556, 152, 153, -1, 
1929, Northwestern St. (LA), 4, 3, 2, 0.55556, 125, 117, 8, 
1930, Northwestern St. (LA), 7, 2, 0, 0.77778, 151, 107, 44, 
1931, Northwestern St. (LA), 5, 4, 0, 0.55556, 184, 95, 89, 
1932, Northwestern St. (LA), 7, 1, 0, 0.87500, 162, 53, 109, 
1933, Northwestern St. (LA), 5, 3, 1, 0.61111, 141, 48, 93, 
1936, Mesa St. (CO), 6, 0, 0, 1.00000, 160, 13, 147, 
1937, Mesa St. (CO), 6, 1, 1, 0.81250, 120, 38, 82, 
1938, Mesa St. (CO), 2, 4, 2, 0.37500, 73, 91, -18, 
1901, Cincinnati (OH), 1, 4, 1, 0.25000, 10, 63, -53, 
1896, Kansas St., 0, 1, 1, 0.25000, 6, 20, -14, 
1922, Citadel (SC), 3, 5, 0, 0.37500, 102, 84, 18, 
1923, Citadel (SC), 5, 3, 1, 0.61111, 119, 59, 60, 
1924, Citadel (SC), 6, 4, 0, 0.60000, 94, 70, 24, 
1925, Citadel (SC), 6, 4, 0, 0.60000, 157, 50, 107, 
1926, Citadel (SC), 7, 3, 0, 0.70000, 98, 51, 47, 
1927, Citadel (SC), 3, 6, 1, 0.35000, 64, 79, -15, 
1928, Citadel (SC), 6, 3, 1, 0.65000, 155, 54, 101, 
1929, Citadel (SC), 5, 4, 1, 0.55000, 146, 73, 73, 
1991, Merchant Marine (NY), 2, 6, 1, 0.27778, 159, 181, -22, 
1992, Merchant Marine (NY), 8, 1, 1, 0.85000, 301, 111, 190, 
1993, Merchant Marine (NY), 5, 4, 0, 0.55556, 249, 170, 79, 
1994, Merchant Marine (NY), 7, 3, 0, 0.70000, 248, 186, 62, 
1995, Merchant Marine (NY), 5, 4, 0, 0.55556, 132, 129, 3, 
1996, Merchant Marine (NY), 7, 3, 0, 0.70000, 230, 161, 69, 
1997, Merchant Marine (NY), 8, 2, 0, 0.80000, 315, 174, 141, 
1998, Merchant Marine (NY), 6, 3, 0, 0.66667, 261, 185, 76, 
1999, Merchant Marine (NY), 3, 7, 0, 0.30000, 218, 334, -116, 
2000, Merchant Marine (NY), 3, 6, 0, 0.33333, 158, 254, -96, 
2001, Merchant Marine (NY), 4, 5, 0, 0.44444, 180, 193, -13, 
2002, Merchant Marine (NY), 8, 3, 0, 0.72727, 234, 201, 33, 
1897, Central Michigan, 2, 1, 0, 0.66667, 16, 18, -2, 
1898, Central Michigan, 1, 2, 0, 0.33333, 37, 32, 5, 
1899, Central Michigan, 3, 2, 0, 0.60000, 35, 22, 13, 
1916, Louisiana St., 2, 0, 0, 1.00000, 30, 10, 20, 
1919, Louisiana St., 6, 2, 0, 0.75000, 161, 35, 126, 
1922, Louisiana St., 3, 7, 0, 0.30000, 72, 244, -172, 
1969, Bucknell (PA), 3, 5, 1, 0.38889, 130, 224, -94, 
1970, Bucknell (PA), 4, 6, 0, 0.40000, 162, 262, -100, 
1971, Bucknell (PA), 5, 5, 0, 0.50000, 165, 206, -41, 
1972, Bucknell (PA), 6, 3, 0, 0.66667, 203, 109, 94, 
1973, Bucknell (PA), 3, 4, 2, 0.44444, 133, 167, -34, 
1974, Bucknell (PA), 2, 8, 0, 0.20000, 155, 255, -100, 
1943, Lehigh (PA), 0, 5, 1, 0.08333, 13, 190, -177, 
1944, Lehigh (PA), 0, 6, 0, 0.00000, 18, 226, -208, 
1945, Lehigh (PA), 2, 4, 0, 0.33333, 26, 93, -67, 
1942, Nebraska, 3, 7, 0, 0.30000, 55, 158, -103, 
1954, Eastern Kentucky, 8, 1, 1, 0.85000, 181, 54, 127, 
1955, Eastern Kentucky, 5, 4, 1, 0.55000, 139, 130, 9, 
1956, Eastern Kentucky, 4, 5, 0, 0.44444, 119, 107, 12, 
1957, Eastern Kentucky, 4, 5, 0, 0.44444, 162, 165, -3, 
1958, Eastern Kentucky, 3, 6, 0, 0.33333, 102, 126, -24, 
1959, Eastern Kentucky, 3, 6, 0, 0.33333, 79, 103, -24, 
1960, Eastern Kentucky, 3, 6, 1, 0.35000, 98, 143, -45, 
1961, Eastern Kentucky, 4, 5, 0, 0.44444, 114, 138, -24, 
1962, Eastern Kentucky, 6, 3, 0, 0.66667, 149, 106, 43, 
1963, Eastern Kentucky, 2, 8, 0, 0.20000, 123, 193, -70, 
1997, Arkansas-Monticello, 0, 10, 0, 0.00000, 172, 404, -232, 
1998, Arkansas-Monticello, 0, 11, 0, 0.00000, 149, 501, -352, 
1917, Hamilton (NY), 4, 1, 1, 0.75000, 59, 12, 47, 
1918, Hamilton (NY), 1, 1, 1, 0.50000, 2, 53, -51, 
1919, Hamilton (NY), 3, 4, 1, 0.43750, 25, 38, -13, 
1920, Hamilton (NY), 3, 4, 0, 0.42857, 51, 146, -95, 
1926, California, 3, 6, 0, 0.33333, 105, 167, -62, 
1927, California, 7, 3, 0, 0.70000, 184, 64, 120, 
1928, California, 6, 2, 2, 0.70000, 141, 36, 105, 
1929, California, 7, 1, 1, 0.83333, 155, 78, 77, 
1930, California, 4, 5, 0, 0.44444, 87, 170, -83, 
1974, Norfolk St. (VA), 8, 3, 0, 0.72727, 234, 115, 119, 
1975, Norfolk St. (VA), 8, 3, 0, 0.72727, 249, 191, 58, 
1976, Norfolk St. (VA), 8, 4, 0, 0.66667, 226, 161, 65, 
1977, Norfolk St. (VA), 4, 6, 1, 0.40909, 209, 197, 12, 
1978, Norfolk St. (VA), 6, 4, 0, 0.60000, 192, 134, 58, 
1979, Norfolk St. (VA), 8, 3, 1, 0.70833, 255, 188, 67, 
1980, Norfolk St. (VA), 5, 4, 1, 0.55000, 226, 197, 29, 
1981, Norfolk St. (VA), 4, 5, 1, 0.45000, 262, 207, 55, 
1982, Norfolk St. (VA), 6, 4, 0, 0.60000, 159, 140, 19, 
1983, Norfolk St. (VA), 5, 5, 0, 0.50000, 157, 194, -37, 
1951, Texas, 7, 3, 0, 0.70000, 182, 129, 53, 
1952, Texas, 9, 2, 0, 0.81818, 278, 164, 114, 
1953, Texas, 7, 3, 0, 0.70000, 190, 125, 65, 
1954, Texas, 4, 5, 1, 0.45000, 158, 161, -3, 
1955, Texas, 5, 5, 0, 0.50000, 189, 212, -23, 
1956, Texas, 1, 9, 0, 0.10000, 101, 272, -171, 
2013, Husson College (ME), 5, 5, 0, 0.50000, 183, 171, 12, 
1920, Franklin & Marshall (PA), 3, 2, 2, 0.57143, 51, 38, 13, 
1921, Franklin & Marshall (PA), 6, 1, 2, 0.77778, 166, 48, 118, 
1922, Franklin & Marshall (PA), 8, 2, 0, 0.80000, 279, 32, 247, 
1923, Franklin & Marshall (PA), 3, 5, 1, 0.38889, 49, 81, -32, 
2003, Husson College (ME), 0, 7, 0, 0.00000, 60, 265, -205, 
2004, Husson College (ME), 2, 7, 0, 0.22222, 174, 278, -104, 
2005, Husson College (ME), 4, 4, 0, 0.50000, 254, 146, 108, 
2006, Husson College (ME), 6, 4, 0, 0.60000, 176, 175, 1, 
2007, Husson College (ME), 6, 3, 0, 0.66667, 303, 186, 117, 
2008, Husson College (ME), 7, 3, 0, 0.70000, 281, 190, 91, 
1974, Hawaii, 6, 5, 0, 0.54545, 175, 211, -36, 
1975, Hawaii, 6, 5, 0, 0.54545, 180, 201, -21, 
1976, Hawaii, 3, 8, 0, 0.27273, 154, 377, -223, 
1981, Weber St. (UT), 7, 4, 0, 0.63636, 271, 228, 43, 
1982, Weber St. (UT), 4, 7, 0, 0.36364, 261, 312, -51, 
1983, Weber St. (UT), 6, 5, 0, 0.54545, 290, 279, 11, 
1984, Weber St. (UT), 5, 6, 0, 0.45455, 287, 312, -25, 
1985, Weber St. (UT), 6, 5, 0, 0.54545, 411, 333, 78, 
1986, Weber St. (UT), 3, 8, 0, 0.27273, 332, 351, -19, 
1987, Weber St. (UT), 10, 3, 0, 0.76923, 489, 382, 107, 
1988, Weber St. (UT), 5, 6, 0, 0.45455, 360, 341, 19, 
1989, Washington St., 6, 5, 0, 0.54545, 351, 268, 83, 
1990, Washington St., 3, 8, 0, 0.27273, 286, 381, -95, 
1991, Washington St., 4, 7, 0, 0.36364, 280, 340, -60, 
1992, Washington St., 9, 3, 0, 0.75000, 337, 281, 56, 
1993, Washington St., 5, 6, 0, 0.45455, 271, 248, 23, 
1994, Washington St., 8, 4, 0, 0.66667, 192, 136, 56, 
1995, Washington St., 3, 8, 0, 0.27273, 236, 274, -38, 
1996, Washington St., 5, 6, 0, 0.45455, 314, 317, -3, 
1997, Washington St., 10, 2, 0, 0.83333, 483, 296, 187, 
1998, Washington St., 3, 8, 0, 0.27273, 223, 349, -126, 
1999, Washington St., 3, 9, 0, 0.25000, 248, 327, -79, 
2000, Washington St., 4, 7, 0, 0.36364, 281, 354, -73, 
2001, Washington St., 10, 2, 0, 0.83333, 420, 269, 151, 
2002, Washington St., 10, 3, 0, 0.76923, 431, 296, 135, 
2004, Texas-El Paso, 8, 4, 0, 0.66667, 429, 301, 128, 
2005, Texas-El Paso, 8, 4, 0, 0.66667, 382, 311, 71, 
2006, Texas-El Paso, 5, 7, 0, 0.41667, 328, 375, -47, 
2007, Texas-El Paso, 4, 8, 0, 0.33333, 403, 445, -42, 
2008, Texas-El Paso, 5, 7, 0, 0.41667, 395, 444, -49, 
2009, Texas-El Paso, 4, 8, 0, 0.33333, 358, 402, -44, 
2010, Texas-El Paso, 6, 7, 0, 0.46154, 338, 357, -19, 
2011, Texas-El Paso, 5, 7, 0, 0.41667, 319, 364, -45, 
2012, Texas-El Paso, 3, 9, 0, 0.25000, 254, 357, -103, 
1908, West Virginia Wesleyan, 1, 1, 1, 0.50000, 16, 49, -33, 
1909, West Virginia Wesleyan, 6, 2, 0, 0.75000, 216, 86, 130, 
1996, West Virginia Tech, 1, 10, 0, 0.09091, 86, 452, -366, 
1997, West Virginia Tech, 0, 11, 0, 0.00000, 111, 469, -358, 
1998, West Virginia Tech, 0, 11, 0, 0.00000, 106, 500, -394, 
1985, Maranatha Baptist Bible (WI), 2, 7, 0, 0.22222, 109, 258, -149, 
1986, Maranatha Baptist Bible (WI), 2, 7, 0, 0.22222, 116, 293, -177, 
1987, Maranatha Baptist Bible (WI), 3, 5, 0, 0.37500, 115, 258, -143, 
1988, Maranatha Baptist Bible (WI), 5, 3, 0, 0.62500, 195, 132, 63, 
1989, Maranatha Baptist Bible (WI), 3, 4, 1, 0.43750, 126, 183, -57, 
1990, Maranatha Baptist Bible (WI), 7, 2, 0, 0.77778, 248, 132, 116, 
1991, Maranatha Baptist Bible (WI), 7, 2, 0, 0.77778, 344, 172, 172, 
1992, Maranatha Baptist Bible (WI), 8, 1, 0, 0.88889, 264, 147, 117, 
1993, Maranatha Baptist Bible (WI), 5, 4, 0, 0.55556, 244, 165, 79, 
1994, Maranatha Baptist Bible (WI), 7, 2, 0, 0.77778, 276, 168, 108, 
1995, Maranatha Baptist Bible (WI), 6, 3, 0, 0.66667, 222, 138, 84, 
1996, Maranatha Baptist Bible (WI), 6, 3, 0, 0.66667, 232, 178, 54, 
1997, Maranatha Baptist Bible (WI), 5, 4, 0, 0.55556, 269, 179, 90, 
1998, Maranatha Baptist Bible (WI), 6, 4, 0, 0.60000, 277, 196, 81, 
1999, Maranatha Baptist Bible (WI), 3, 6, 0, 0.33333, 229, 316, -87, 
2000, Maranatha Baptist Bible (WI), 1, 8, 0, 0.11111, 156, 356, -200, 
2001, Maranatha Baptist Bible (WI), 2, 7, 0, 0.22222, 127, 236, -109, 
2002, Maranatha Baptist Bible (WI), 6, 3, 0, 0.66667, 203, 131, 72, 
2003, Maranatha Baptist Bible (WI), 2, 7, 0, 0.22222, 149, 216, -67, 
2004, Maranatha Baptist Bible (WI), 3, 6, 0, 0.33333, 227, 207, 20, 
2005, Maranatha Baptist Bible (WI), 4, 5, 0, 0.44444, 209, 245, -36, 
2006, Maranatha Baptist Bible (WI), 6, 3, 0, 0.66667, 215, 110, 105, 
2007, Maranatha Baptist Bible (WI), 2, 7, 0, 0.22222, 156, 333, -177, 
2008, Maranatha Baptist Bible (WI), 0, 10, 0, 0.00000, 95, 332, -237, 
2009, Maranatha Baptist Bible (WI), 0, 10, 0, 0.00000, 64, 378, -314, 
2010, Maranatha Baptist Bible (WI), 1, 9, 0, 0.10000, 95, 373, -278, 
1936, Fort Valley St. (GA), 5, 1, 2, 0.75000, 81, 7, 74, 
1937, Fort Valley St. (GA), 0, 4, 0, 0.00000, 0, 77, -77, 
1938, Fort Valley St. (GA), 1, 0, 0, 1.00000, 19, 7, 12, 
1939, Fort Valley St. (GA), 0, 2, 1, 0.16667, 20, 72, -52, 
2013, Concordia (MI), 2, 9, 0, 0.18182, 125, 462, -337, 
1909, Louisiana Tech, 5, 1, 0, 0.83333, 184, 23, 161, 
1910, Louisiana Tech, 7, 0, 0, 1.00000, 265, 6, 259, 
1911, Louisiana Tech, 4, 1, 1, 0.75000, 98, 23, 75, 
1912, Louisiana Tech, 1, 2, 1, 0.37500, 33, 28, 5, 
1913, Louisiana Tech, 3, 4, 1, 0.43750, 105, 72, 33, 
1914, Louisiana Tech, 2, 4, 0, 0.33333, 55, 129, -74, 
1915, Louisiana Tech, 3, 1, 2, 0.66667, 110, 33, 77, 
1919, Louisiana Tech, 0, 3, 0, 0.00000, 13, 48, -35, 
2006, Kansas St., 7, 6, 0, 0.53846, 296, 309, -13, 
2007, Kansas St., 5, 7, 0, 0.41667, 422, 370, 52, 
2008, Kansas St., 5, 7, 0, 0.41667, 419, 430, -11, 
2006, SUNY-Stony Brook (NY), 5, 6, 0, 0.45455, 242, 278, -36, 
2007, SUNY-Stony Brook (NY), 6, 5, 0, 0.54545, 278, 272, 6, 
2008, SUNY-Stony Brook (NY), 5, 6, 0, 0.45455, 274, 289, -15, 
2009, SUNY-Stony Brook (NY), 6, 5, 0, 0.54545, 267, 256, 11, 
2010, SUNY-Stony Brook (NY), 6, 5, 0, 0.54545, 343, 282, 61, 
2011, SUNY-Stony Brook (NY), 9, 4, 0, 0.69231, 494, 303, 191, 
2012, SUNY-Stony Brook (NY), 10, 3, 0, 0.76923, 460, 202, 258, 
2013, SUNY-Stony Brook (NY), 5, 6, 0, 0.45455, 245, 242, 3, 
1931, Buffalo (NY), 2, 6, 0, 0.25000, 64, 171, -107, 
1917, Oklahoma St., 4, 5, 0, 0.44444, 93, 94, -1, 
1918, Oklahoma St., 4, 2, 0, 0.66667, 103, 73, 30, 
1917, Eureka (IL), 3, 3, 1, 0.50000, 154, 101, 53, 
1918, Eureka (IL), 0, 1, 2, 0.33333, 7, 13, -6, 
1919, Eureka (IL), 3, 5, 0, 0.37500, 55, 119, -64, 
1920, Eureka (IL), 5, 2, 1, 0.68750, 241, 80, 161, 
1909, Rutgers (NJ), 3, 5, 1, 0.38889, 62, 74, -12, 
1909, Louisiana St., 4, 1, 0, 0.80000, 124, 15, 109, 
1947, Worcester Tech (MA), 0, 6, 0, 0.00000, 27, 136, -109, 
1948, Worcester Tech (MA), 1, 4, 1, 0.25000, 45, 107, -62, 
1949, Worcester Tech (MA), 3, 3, 0, 0.50000, 99, 154, -55, 
1950, Worcester Tech (MA), 4, 3, 0, 0.57143, 89, 76, 13, 
1951, Worcester Tech (MA), 4, 2, 0, 0.66667, 120, 93, 27, 
1952, Worcester Tech (MA), 2, 4, 0, 0.33333, 102, 78, 24, 
1953, Worcester Tech (MA), 2, 3, 1, 0.41667, 61, 97, -36, 
1954, Worcester Tech (MA), 6, 0, 0, 1.00000, 161, 13, 148, 
1955, Worcester Tech (MA), 5, 2, 0, 0.71429, 170, 27, 143, 
1956, Worcester Tech (MA), 5, 2, 0, 0.71429, 127, 60, 67, 
1957, Worcester Tech (MA), 4, 3, 0, 0.57143, 81, 91, -10, 
1958, Worcester Tech (MA), 6, 1, 0, 0.85714, 143, 60, 83, 
1959, Worcester Tech (MA), 4, 3, 0, 0.57143, 93, 96, -3, 
1960, Worcester Tech (MA), 1, 6, 0, 0.14286, 72, 103, -31, 
1961, Worcester Tech (MA), 3, 4, 0, 0.42857, 140, 94, 46, 
1962, Worcester Tech (MA), 3, 4, 0, 0.42857, 112, 75, 37, 
1963, Worcester Tech (MA), 2, 5, 0, 0.28571, 91, 82, 9, 
1964, Worcester Tech (MA), 2, 6, 0, 0.25000, 74, 165, -91, 
1965, Worcester Tech (MA), 1, 7, 0, 0.12500, 82, 215, -133, 
1966, Worcester Tech (MA), 2, 5, 0, 0.28571, 69, 135, -66, 
1964, Harding (AR), 2, 8, 0, 0.20000, 67, 182, -115, 
1965, Harding (AR), 5, 3, 1, 0.61111, 136, 105, 31, 
1966, Harding (AR), 6, 3, 0, 0.66667, 163, 131, 32, 
1967, Harding (AR), 3, 7, 0, 0.30000, 146, 194, -48, 
1968, Harding (AR), 2, 8, 0, 0.20000, 157, 235, -78, 
1969, Harding (AR), 7, 2, 1, 0.75000, 208, 142, 66, 
1970, Harding (AR), 5, 5, 0, 0.50000, 131, 151, -20, 
1971, Harding (AR), 5, 5, 0, 0.50000, 190, 219, -29, 
1972, Harding (AR), 10, 1, 0, 0.90909, 355, 125, 230, 
1973, Harding (AR), 7, 3, 0, 0.70000, 215, 120, 95, 
1974, Harding (AR), 5, 4, 1, 0.55000, 98, 149, -51, 
1975, Harding (AR), 4, 6, 0, 0.40000, 119, 143, -24, 
1976, Harding (AR), 7, 5, 0, 0.58333, 223, 180, 43, 
1977, Harding (AR), 4, 7, 0, 0.36364, 132, 180, -48, 
1978, Harding (AR), 5, 4, 1, 0.55000, 199, 177, 22, 
1979, Harding (AR), 4, 6, 0, 0.40000, 98, 205, -107, 
1980, Harding (AR), 3, 8, 0, 0.27273, 154, 265, -111, 
1981, Harding (AR), 2, 9, 0, 0.18182, 170, 279, -109, 
1982, Harding (AR), 5, 6, 0, 0.45455, 136, 150, -14, 
1983, Harding (AR), 3, 6, 1, 0.35000, 138, 203, -65, 
1984, Harding (AR), 5, 3, 1, 0.61111, 146, 147, -1, 
1985, Harding (AR), 5, 5, 0, 0.50000, 187, 198, -11, 
1986, Harding (AR), 4, 5, 1, 0.45000, 163, 158, 5, 
1987, Harding (AR), 6, 4, 0, 0.60000, 221, 139, 82, 
1894, Duquesne (PA), 7, 2, 1, 0.75000, 154, 26, 128, 
1946, Charleston (WV), 2, 5, 0, 0.28571, 38, 117, -79, 
1934, Samford (AL), 3, 4, 2, 0.44444, 90, 96, -6, 
1955, Oregon St., 6, 3, 0, 0.66667, 126, 120, 6, 
1956, Oregon St., 7, 3, 1, 0.68182, 203, 166, 37, 
1957, Oregon St., 8, 2, 0, 0.80000, 203, 129, 74, 
1958, Oregon St., 6, 4, 0, 0.60000, 98, 118, -20, 
1959, Oregon St., 3, 7, 0, 0.30000, 166, 178, -12, 
1960, Oregon St., 6, 3, 1, 0.65000, 197, 145, 52, 
1961, Oregon St., 5, 5, 0, 0.50000, 165, 137, 28, 
1962, Oregon St., 9, 2, 0, 0.81818, 279, 148, 131, 
1963, Oregon St., 5, 5, 0, 0.50000, 198, 192, 6, 
1964, Oregon St., 8, 3, 0, 0.72727, 149, 124, 25, 
1965, UCLA, 8, 2, 1, 0.77273, 257, 168, 89, 
1966, UCLA, 9, 1, 0, 0.90000, 281, 127, 154, 
1967, UCLA, 7, 2, 1, 0.75000, 284, 161, 123, 
1968, UCLA, 3, 7, 0, 0.30000, 197, 246, -49, 
1969, UCLA, 8, 1, 1, 0.85000, 329, 103, 226, 
1970, UCLA, 6, 5, 0, 0.54545, 274, 240, 34, 
1990, Morehead St. (KY), 5, 6, 0, 0.45455, 268, 223, 45, 
1991, Morehead St. (KY), 4, 7, 0, 0.36364, 189, 345, -156, 
1992, Morehead St. (KY), 3, 8, 0, 0.27273, 148, 338, -190, 
1993, Morehead St. (KY), 3, 8, 0, 0.27273, 122, 334, -212, 
1996, Marshall (WV), 15, 0, 0, 1.00000, 658, 210, 448, 
1997, Marshall (WV), 10, 3, 0, 0.76923, 484, 259, 225, 
1998, Marshall (WV), 12, 1, 0, 0.92308, 405, 236, 169, 
1999, Marshall (WV), 13, 0, 0, 1.00000, 463, 137, 326, 
2000, Marshall (WV), 8, 5, 0, 0.61538, 367, 297, 70, 
2001, Marshall (WV), 11, 2, 0, 0.84615, 512, 369, 143, 
2002, Marshall (WV), 11, 2, 0, 0.84615, 457, 315, 142, 
2003, Marshall (WV), 8, 4, 0, 0.66667, 350, 278, 72, 
2004, Marshall (WV), 6, 6, 0, 0.50000, 291, 266, 25, 
1970, South Dakota St., 2, 8, 0, 0.20000, 129, 269, -140, 
1971, South Dakota St., 3, 7, 0, 0.30000, 109, 223, -114, 
1908, Hamilton (NY), 2, 7, 0, 0.22222, 31, 94, -63, 
1909, Hamilton (NY), 2, 5, 1, 0.31250, 31, 125, -94, 
2012, Alma (MI), 1, 9, 0, 0.10000, 117, 358, -241, 
2013, Alma (MI), 1, 9, 0, 0.10000, 133, 333, -200, 
1968, Kent St. (OH), 1, 9, 0, 0.10000, 101, 230, -129, 
1969, Kent St. (OH), 5, 5, 0, 0.50000, 166, 198, -32, 
1970, Kent St. (OH), 3, 7, 0, 0.30000, 161, 222, -61, 
1989, Alabama A&M;, 8, 4, 0, 0.66667, 399, 202, 197, 
1990, Alabama A&M;, 6, 5, 0, 0.54545, 300, 264, 36, 
1991, Alabama A&M;, 3, 3, 0, 0.50000, 103, 158, -55, 
1917, Louisiana Tech, 2, 3, 1, 0.41667, 72, 137, -65, 
1962, West Virginia Wesleyan, 5, 1, 2, 0.75000, 130, 87, 43, 
1963, West Virginia Wesleyan, 6, 3, 0, 0.66667, 150, 70, 80, 
1964, West Virginia Wesleyan, 4, 4, 0, 0.50000, 139, 102, 37, 
1965, West Virginia Wesleyan, 6, 3, 0, 0.66667, 155, 91, 64, 
1966, West Virginia Wesleyan, 5, 4, 0, 0.55556, 156, 117, 39, 
1967, West Virginia Wesleyan, 3, 5, 0, 0.37500, 48, 204, -156, 
1968, West Virginia Wesleyan, 1, 7, 0, 0.12500, 78, 277, -199, 
1976, Bloomsburg (PA), 2, 7, 0, 0.22222, 138, 165, -27, 
1977, Bloomsburg (PA), 4, 5, 0, 0.44444, 157, 123, 34, 
1978, Bloomsburg (PA), 6, 4, 0, 0.60000, 140, 163, -23, 
1979, Bloomsburg (PA), 2, 8, 0, 0.20000, 118, 164, -46, 
2013, Moravian (PA), 2, 8, 0, 0.20000, 222, 328, -106, 
1896, Hamilton (NY), 4, 1, 1, 0.75000, 100, 16, 84, 
1897, Hamilton (NY), 5, 3, 1, 0.61111, 62, 52, 10, 
1898, Hamilton (NY), 5, 2, 0, 0.71429, 115, 69, 46, 
1932, Southern (LA), 4, 2, 1, 0.64286, 107, 38, 69, 
1933, Southern (LA), 4, 3, 0, 0.57143, 67, 62, 5, 
1934, Southern (LA), 5, 3, 0, 0.62500, 101, 90, 11, 
1935, Southern (LA), 2, 7, 1, 0.25000, 106, 167, -61, 
1960, Alcorn St. (MS), 3, 4, 0, 0.42857, 50, 119, -69, 
1961, Alcorn St. (MS), 5, 4, 0, 0.55556, 162, 154, 8, 
1962, Alcorn St. (MS), 4, 5, 0, 0.44444, 163, 219, -56, 
1963, Alcorn St. (MS), 3, 7, 0, 0.30000, 206, 242, -36, 
2013, Saint Norbert (WI), 8, 3, 0, 0.72727, 246, 177, 69, 
1981, Delaware St., 2, 9, 0, 0.18182, 122, 211, -89, 
1982, Delaware St., 4, 7, 0, 0.36364, 223, 267, -44, 
1983, Delaware St., 7, 3, 1, 0.68182, 368, 252, 116, 
1984, Delaware St., 8, 2, 0, 0.80000, 425, 154, 271, 
1985, James Madison (VA), 5, 6, 0, 0.45455, 163, 177, -14, 
1986, James Madison (VA), 5, 5, 1, 0.50000, 299, 178, 121, 
1987, James Madison (VA), 9, 3, 0, 0.75000, 283, 197, 86, 
1988, James Madison (VA), 5, 6, 0, 0.45455, 201, 209, -8, 
1989, James Madison (VA), 5, 4, 1, 0.55000, 267, 159, 108, 
1990, James Madison (VA), 5, 6, 0, 0.45455, 228, 191, 37, 
1971, Lafayette (PA), 5, 5, 0, 0.50000, 114, 248, -134, 
1972, Lafayette (PA), 3, 7, 0, 0.30000, 127, 230, -103, 
1973, Lafayette (PA), 6, 3, 1, 0.65000, 168, 191, -23, 
1974, Lafayette (PA), 3, 7, 0, 0.30000, 104, 204, -100, 
1975, Lafayette (PA), 5, 5, 0, 0.50000, 126, 216, -90, 
1976, Lafayette (PA), 5, 5, 0, 0.50000, 214, 171, 43, 
1977, Lafayette (PA), 5, 6, 0, 0.45455, 212, 247, -35, 
1978, Lafayette (PA), 4, 7, 0, 0.36364, 165, 186, -21, 
1979, Lafayette (PA), 5, 3, 2, 0.60000, 162, 110, 52, 
1980, Lafayette (PA), 3, 7, 0, 0.30000, 73, 192, -119, 
1909, Florida, 6, 1, 1, 0.81250, 117, 34, 83, 
1910, Florida, 6, 1, 0, 0.85714, 186, 15, 171, 
1911, Florida, 5, 0, 1, 0.91667, 84, 14, 70, 
1912, Florida, 5, 2, 1, 0.68750, 203, 54, 149, 
1913, Florida, 4, 3, 0, 0.57143, 228, 94, 134, 
1992, Eastern Michigan, 1, 6, 0, 0.14286, 70, 209, -139, 
1997, Southern Illinois, 3, 8, 0, 0.27273, 238, 320, -82, 
1998, Southern Illinois, 3, 8, 0, 0.27273, 259, 296, -37, 
1999, Southern Illinois, 5, 6, 0, 0.45455, 424, 432, -8, 
2000, Southern Illinois, 3, 8, 0, 0.27273, 208, 316, -108, 
1987, Drake (IA), 5, 5, 0, 0.50000, 221, 217, 4, 
1988, Drake (IA), 7, 3, 0, 0.70000, 269, 188, 81, 
1994, Fordham (NY), 0, 11, 0, 0.00000, 146, 315, -169, 
1995, Fordham (NY), 4, 6, 1, 0.40909, 208, 236, -28, 
1996, Fordham (NY), 2, 8, 0, 0.20000, 172, 248, -76, 
1997, Fordham (NY), 5, 6, 0, 0.45455, 215, 247, -32, 
1989, Chicago (IL), 2, 7, 0, 0.22222, 123, 266, -143, 
1990, Chicago (IL), 1, 9, 0, 0.10000, 113, 301, -188, 
1991, Chicago (IL), 0, 10, 0, 0.00000, 87, 195, -108, 
1992, Chicago (IL), 3, 7, 0, 0.30000, 185, 252, -67, 
1993, Chicago (IL), 5, 5, 0, 0.50000, 222, 215, 7, 
1968, North Carolina Central, 7, 2, 0, 0.77778, 254, 95, 159, 
1969, North Carolina Central, 7, 2, 1, 0.75000, 292, 139, 153, 
1970, North Carolina Central, 5, 4, 0, 0.55556, 208, 185, 23, 
1971, North Carolina Central, 7, 2, 0, 0.77778, 173, 104, 69, 
1972, North Carolina Central, 9, 2, 0, 0.81818, 299, 165, 134, 
1919, Kansas Wesleyan, 3, 5, 0, 0.37500, 46, 103, -57, 
1900, Central Missouri St., 6, 5, 0, 0.54545, 153, 93, 60, 
1901, Central Missouri St., 7, 3, 0, 0.70000, 148, 29, 119, 
1912, Arizona, 2, 1, 0, 0.66667, 55, 30, 25, 
1921, George Washington (DC), 3, 3, 2, 0.50000, 138, 96, 42, 
1922, George Washington (DC), 2, 6, 0, 0.25000, 49, 257, -208, 
1923, George Washington (DC), 2, 8, 0, 0.20000, 41, 233, -192, 
1906, Sewanee (TN), 8, 1, 0, 0.88889, 211, 25, 186, 
2006, Central Michigan, 1, 0, 0, 1.00000, 31, 14, 17, 
2009, Cincinnati (OH), 0, 1, 0, 0.00000, 24, 51, -27, 
2010, Buffalo (NY), 2, 10, 0, 0.16667, 170, 334, -164, 
2011, Buffalo (NY), 3, 9, 0, 0.25000, 266, 353, -87, 
2012, Buffalo (NY), 4, 8, 0, 0.33333, 255, 342, -87, 
2013, Buffalo (NY), 8, 5, 0, 0.61538, 394, 317, 77, 
2013, MidAmerica Nazarene (KS), 5, 5, 0, 0.50000, 375, 289, 86, 
2013, Ave Maria (FL), 8, 2, 0, 0.80000, 370, 226, 144, 
1923, Lamar (TX), 2, 4, 1, 0.35714, 64, 77, -13, 
2001, Southern Arkansas, 5, 5, 0, 0.50000, 246, 264, -18, 
2002, Southern Arkansas, 7, 4, 0, 0.63636, 372, 292, 80, 
2003, Southern Arkansas, 9, 3, 0, 0.75000, 385, 285, 100, 
2004, Southern Arkansas, 5, 6, 0, 0.45455, 324, 371, -47, 
2005, Southern Arkansas, 6, 5, 0, 0.54545, 327, 267, 60, 
2006, Southern Arkansas, 2, 9, 0, 0.18182, 162, 342, -180, 
2007, Southern Arkansas, 3, 7, 0, 0.30000, 245, 333, -88, 
2008, Southern Arkansas, 2, 8, 0, 0.20000, 200, 336, -136, 
1918, Wake Forest (NC), 1, 3, 0, 0.25000, 40, 59, -19, 
1919, Wake Forest (NC), 2, 6, 0, 0.25000, 118, 143, -25, 
1915, Idaho, 1, 4, 1, 0.25000, 16, 118, -102, 
1988, Tulsa (OK), 4, 7, 0, 0.36364, 254, 318, -64, 
1989, Tulsa (OK), 6, 6, 0, 0.50000, 302, 271, 31, 
1990, Tulsa (OK), 3, 8, 0, 0.27273, 183, 281, -98, 
1991, Tulsa (OK), 10, 2, 0, 0.83333, 333, 225, 108, 
1992, Tulsa (OK), 4, 7, 0, 0.36364, 240, 303, -63, 
1993, Tulsa (OK), 4, 6, 1, 0.40909, 262, 273, -11, 
1994, Tulsa (OK), 3, 8, 0, 0.27273, 244, 304, -60, 
1995, Tulsa (OK), 4, 7, 0, 0.36364, 233, 300, -67, 
1996, Tulsa (OK), 4, 7, 0, 0.36364, 245, 333, -88, 
1997, Tulsa (OK), 2, 9, 0, 0.18182, 258, 426, -168, 
1998, Tulsa (OK), 4, 7, 0, 0.36364, 222, 258, -36, 
1999, Tulsa (OK), 1, 6, 0, 0.14286, 125, 274, -149, 
2013, Maryville (TN), 8, 3, 0, 0.72727, 432, 251, 181, 
1997, Sacred Heart (CT), 1, 9, 0, 0.10000, 68, 316, -248, 
1998, Sacred Heart (CT), 2, 8, 0, 0.20000, 134, 318, -184, 
1999, Sacred Heart (CT), 2, 9, 0, 0.18182, 133, 349, -216, 
2008, Wabash (IN), 10, 2, 0, 0.83333, 473, 219, 254, 
2009, Wabash (IN), 9, 2, 0, 0.81818, 427, 162, 265, 
2010, Wabash (IN), 8, 2, 0, 0.80000, 338, 157, 181, 
2011, Wabash (IN), 12, 1, 0, 0.92308, 415, 168, 247, 
2012, Wabash (IN), 8, 2, 0, 0.80000, 297, 131, 166, 
2013, Wabash (IN), 9, 1, 0, 0.90000, 466, 113, 353, 
1910, Davis & Elkins (WV), 4, 1, 0, 0.80000, 53, 6, 47, 
1980, Indiana St., 6, 5, 0, 0.54545, 208, 211, -3, 
1981, Indiana St., 5, 5, 1, 0.50000, 247, 164, 83, 
1982, Indiana St., 5, 6, 0, 0.45455, 165, 239, -74, 
1983, Indiana St., 9, 4, 0, 0.69231, 291, 209, 82, 
1984, Indiana St., 9, 3, 0, 0.75000, 332, 161, 171, 
1985, Indiana St., 4, 6, 0, 0.40000, 237, 268, -31, 
1986, Indiana St., 3, 8, 0, 0.27273, 166, 304, -138, 
1987, Indiana St., 5, 6, 0, 0.45455, 193, 271, -78, 
1988, Indiana St., 5, 6, 0, 0.45455, 205, 258, -53, 
1989, Indiana St., 4, 7, 0, 0.36364, 222, 240, -18, 
1990, Indiana St., 4, 7, 0, 0.36364, 263, 289, -26, 
1991, Indiana St., 5, 6, 0, 0.45455, 229, 242, -13, 
1992, Indiana St., 4, 7, 0, 0.36364, 319, 345, -26, 
1993, Indiana St., 4, 7, 0, 0.36364, 234, 267, -33, 
1994, Indiana St., 5, 6, 0, 0.45455, 246, 174, 72, 
1995, Indiana St., 7, 4, 0, 0.63636, 236, 186, 50, 
1996, Indiana St., 6, 5, 0, 0.54545, 256, 233, 23, 
1997, Indiana St., 3, 8, 0, 0.27273, 119, 248, -129, 
1950, Iowa, 3, 5, 1, 0.38889, 121, 201, -80, 
1951, Iowa, 2, 5, 2, 0.33333, 161, 233, -72, 
1904, Yale (CT), 10, 1, 0, 0.90909, 220, 20, 200, 
1927, Virginia Military Institute, 6, 4, 0, 0.60000, 144, 64, 80, 
1928, Virginia Military Institute, 5, 3, 2, 0.60000, 95, 75, 20, 
1929, Virginia Military Institute, 8, 2, 0, 0.80000, 156, 61, 95, 
1930, Virginia Military Institute, 3, 6, 0, 0.33333, 30, 122, -92, 
1931, Virginia Military Institute, 3, 6, 1, 0.35000, 82, 123, -41, 
1932, Virginia Military Institute, 2, 8, 0, 0.20000, 44, 166, -122, 
1933, Virginia Military Institute, 2, 7, 1, 0.25000, 44, 170, -126, 
1934, Virginia Military Institute, 1, 8, 0, 0.11111, 51, 190, -139, 
1935, Virginia Military Institute, 2, 7, 1, 0.25000, 63, 157, -94, 
1936, Virginia Military Institute, 6, 4, 0, 0.60000, 122, 140, -18, 
1966, Virginia Military Institute, 2, 8, 0, 0.20000, 129, 305, -176, 
1967, Virginia Military Institute, 6, 4, 0, 0.60000, 205, 195, 10, 
1968, Virginia Military Institute, 1, 9, 0, 0.10000, 90, 290, -200, 
1969, Virginia Military Institute, 0, 10, 0, 0.00000, 78, 409, -331, 
1970, Virginia Military Institute, 1, 10, 0, 0.09091, 120, 451, -331, 
1986, Tennessee Tech, 0, 10, 0, 0.00000, 104, 348, -244, 
1987, Tennessee Tech, 5, 6, 0, 0.45455, 283, 246, 37, 
1988, Tennessee Tech, 1, 10, 0, 0.09091, 114, 291, -177, 
1989, Tennessee Tech, 5, 5, 0, 0.50000, 191, 230, -39, 
1990, Tennessee Tech, 6, 5, 0, 0.54545, 242, 256, -14, 
1991, Tennessee Tech, 2, 9, 0, 0.18182, 221, 244, -23, 
1992, Tennessee Tech, 7, 4, 0, 0.63636, 226, 230, -4, 
1993, Tennessee Tech, 8, 3, 0, 0.72727, 263, 154, 109, 
1994, Tennessee Tech, 5, 6, 0, 0.45455, 236, 213, 23, 
1995, Tennessee Tech, 3, 8, 0, 0.27273, 234, 311, -77, 
1915, Kansas Wesleyan, 5, 4, 0, 0.55556, 96, 55, 41, 
2008, North Carolina A&T;, 1, 3, 0, 0.25000, 42, 144, -102, 
2013, Grambling St. (LA), 0, 5, 0, 0.00000, 74, 205, -131, 
1947, Northern Arizona, 1, 7, 0, 0.12500, 39, 295, -256, 
1948, Northern Arizona, 4, 5, 0, 0.44444, 144, 187, -43, 
1910, Eastern Illinois, 0, 3, 1, 0.12500, 10, 107, -97, 
1905, Ohio, 2, 5, 2, 0.33333, 48, 141, -93, 
1951, Villanova (PA), 5, 3, 0, 0.62500, 174, 173, 1, 
1952, Villanova (PA), 7, 1, 1, 0.83333, 219, 115, 104, 
1953, Villanova (PA), 4, 6, 0, 0.40000, 132, 215, -83, 
1966, Southern Illinois, 4, 5, 1, 0.45000, 152, 196, -44, 
1975, Kansas St., 3, 8, 0, 0.27273, 89, 248, -159, 
1976, Kansas St., 1, 10, 0, 0.09091, 155, 347, -192, 
1977, Kansas St., 2, 9, 0, 0.18182, 131, 286, -155, 
1891, Hamilton (NY), 3, 1, 0, 0.75000, 65, 36, 29, 
1892, Hamilton (NY), 2, 3, 0, 0.40000, 26, 38, -12, 
1893, Hamilton (NY), 1, 3, 0, 0.25000, 50, 62, -12, 
1959, Utah St., 5, 6, 0, 0.45455, 181, 185, -4, 
1960, Utah St., 9, 2, 0, 0.81818, 274, 85, 189, 
1961, Utah St., 9, 1, 1, 0.86364, 396, 102, 294, 
1962, Utah St., 8, 2, 0, 0.80000, 273, 139, 134, 
1963, Stanford (CA), 3, 7, 0, 0.30000, 154, 199, -45, 
1964, Stanford (CA), 5, 5, 0, 0.50000, 150, 138, 12, 
1965, Stanford (CA), 6, 3, 1, 0.65000, 144, 149, -5, 
1966, Stanford (CA), 5, 5, 0, 0.50000, 149, 146, 3, 
1967, Stanford (CA), 5, 5, 0, 0.50000, 157, 179, -22, 
1968, Stanford (CA), 6, 3, 1, 0.65000, 268, 162, 106, 
1969, Stanford (CA), 7, 2, 1, 0.75000, 349, 172, 177, 
1970, Stanford (CA), 9, 3, 0, 0.75000, 343, 206, 137, 
1971, Stanford (CA), 9, 3, 0, 0.75000, 261, 135, 126, 
1993, San Jose St. (CA), 2, 9, 0, 0.18182, 282, 337, -55, 
1994, San Jose St. (CA), 3, 8, 0, 0.27273, 200, 377, -177, 
1995, San Jose St. (CA), 3, 8, 0, 0.27273, 271, 378, -107, 
1996, San Jose St. (CA), 3, 9, 0, 0.25000, 221, 448, -227, 
1975, Siena (NY), 3, 5, 0, 0.37500, 154, 181, -27, 
1976, Siena (NY), 2, 5, 0, 0.28571, 103, 164, -61, 
1977, Siena (NY), 3, 5, 0, 0.37500, 96, 114, -18, 
1978, Siena (NY), 4, 4, 0, 0.50000, 130, 124, 6, 
1979, Siena (NY), 3, 5, 0, 0.37500, 145, 151, -6, 
1980, Siena (NY), 2, 4, 1, 0.35714, 85, 123, -38, 
1972, Minnesota-Crookston, 4, 4, 0, 0.50000, 130, 159, -29, 
1973, Minnesota-Crookston, 9, 0, 0, 1.00000, 306, 89, 217, 
1974, Minnesota-Crookston, 7, 0, 1, 0.93750, 214, 86, 128, 
1975, Minnesota-Crookston, 7, 2, 0, 0.77778, 291, 48, 243, 
1925, Catawba (NC), 1, 4, 0, 0.20000, 12, 57, -45, 
2013, Oberlin (OH), 3, 7, 0, 0.30000, 174, 261, -87, 
2011, Texas Southern, 4, 7, 0, 0.36364, 271, 284, -13, 
1991, Virginia-Wise, 2, 6, 0, 0.25000, 113, 192, -79, 
1992, Virginia-Wise, 3, 7, 0, 0.30000, 196, 276, -80, 
1993, Virginia-Wise, 6, 4, 0, 0.60000, 288, 217, 71, 
1994, Virginia-Wise, 6, 4, 0, 0.60000, 403, 252, 151, 
1995, Virginia-Wise, 10, 2, 0, 0.83333, 371, 241, 130, 
1996, Virginia-Wise, 10, 1, 0, 0.90909, 337, 148, 189, 
1997, Virginia-Wise, 6, 3, 0, 0.66667, 175, 161, 14, 
1998, Virginia-Wise, 4, 5, 0, 0.44444, 220, 276, -56, 
1999, Virginia-Wise, 6, 3, 0, 0.66667, 301, 162, 139, 
2000, Virginia-Wise, 3, 7, 0, 0.30000, 211, 334, -123, 
2001, Virginia-Wise, 6, 4, 0, 0.60000, 278, 199, 79, 
1926, Pacific Lutheran (WA), 0, 2, 0, 0.00000, 2, 26, -24, 
1927, Pacific Lutheran (WA), 4, 1, 2, 0.71429, 41, 19, 22, 
1928, Pacific Lutheran (WA), 0, 5, 2, 0.14286, 24, 172, -148, 
1998, Mesa St. (CO), 4, 7, 0, 0.36364, 191, 341, -150, 
1999, Mesa St. (CO), 6, 5, 0, 0.54545, 327, 276, 51, 
2000, Mesa St. (CO), 10, 3, 0, 0.76923, 437, 312, 125, 
2001, Mesa St. (CO), 7, 4, 0, 0.63636, 371, 260, 111, 
2002, Mesa St. (CO), 5, 6, 0, 0.45455, 305, 303, 2, 
2003, Mesa St. (CO), 10, 2, 0, 0.83333, 454, 270, 184, 
2004, Mesa St. (CO), 0, 11, 0, 0.00000, 175, 422, -247, 
2005, Mesa St. (CO), 5, 6, 0, 0.45455, 260, 288, -28, 
2006, Mesa St. (CO), 4, 7, 0, 0.36364, 201, 263, -62, 
2007, Mesa St. (CO), 10, 2, 0, 0.83333, 292, 197, 95, 
2008, Mesa St. (CO), 6, 5, 0, 0.54545, 269, 284, -15, 
2009, Mesa St. (CO), 5, 6, 0, 0.45455, 240, 226, 14, 
2010, Mesa St. (CO), 3, 7, 0, 0.30000, 205, 279, -74, 
2011, Mesa St. (CO), 4, 7, 0, 0.36364, 233, 300, -67, 
1894, Wabash (IN), 4, 5, 0, 0.44444, 93, 218, -125, 
1910, Dartmouth (NH), 5, 2, 0, 0.71429, 111, 27, 84, 
1971, East Carolina (NC), 4, 6, 0, 0.40000, 181, 300, -119, 
1972, East Carolina (NC), 9, 2, 0, 0.81818, 269, 176, 93, 
1973, East Carolina (NC), 9, 2, 0, 0.81818, 352, 151, 201, 
1974, Virginia, 4, 7, 0, 0.36364, 207, 239, -32, 
1975, Virginia, 1, 10, 0, 0.09091, 175, 428, -253, 
1979, Marshall (WV), 1, 10, 0, 0.09091, 95, 309, -214, 
1980, Marshall (WV), 2, 8, 1, 0.22727, 137, 245, -108, 
1981, Marshall (WV), 2, 9, 0, 0.18182, 104, 284, -180, 
1982, Marshall (WV), 3, 8, 0, 0.27273, 117, 279, -162, 
1983, Marshall (WV), 4, 7, 0, 0.36364, 209, 214, -5, 
1976, Pittsburg St. (KS), 3, 5, 1, 0.38889, 151, 156, -5, 
1977, Pittsburg St. (KS), 1, 8, 1, 0.15000, 176, 280, -104, 
1978, Pittsburg St. (KS), 1, 9, 0, 0.10000, 311, 238, 73, 
1979, Pittsburg St. (KS), 8, 3, 0, 0.72727, 320, 190, 130, 
1980, Pittsburg St. (KS), 7, 4, 0, 0.63636, 267, 174, 93, 
1981, Pittsburg St. (KS), 10, 2, 0, 0.83333, 332, 131, 201, 
1982, Sam Houston St. (TX), 4, 7, 0, 0.36364, 152, 356, -204, 
1983, Sam Houston St. (TX), 4, 7, 0, 0.36364, 203, 230, -27, 
1984, Sam Houston St. (TX), 8, 3, 0, 0.72727, 234, 189, 45, 
1985, Sam Houston St. (TX), 8, 3, 0, 0.72727, 294, 207, 87, 
1986, Sam Houston St. (TX), 9, 3, 0, 0.75000, 306, 307, -1, 
1987, Sam Houston St. (TX), 8, 3, 0, 0.72727, 392, 271, 121, 
1988, Sam Houston St. (TX), 3, 8, 0, 0.27273, 109, 225, -116, 
1989, Sam Houston St. (TX), 3, 8, 0, 0.27273, 133, 272, -139, 
1990, Sam Houston St. (TX), 4, 7, 0, 0.36364, 163, 187, -24, 
1991, Sam Houston St. (TX), 8, 3, 1, 0.70833, 241, 165, 76, 
1992, Sam Houston St. (TX), 6, 3, 2, 0.63636, 256, 258, -2, 
1993, Sam Houston St. (TX), 4, 7, 0, 0.36364, 260, 259, 1, 
1994, Sam Houston St. (TX), 6, 5, 0, 0.54545, 200, 225, -25, 
1995, Sam Houston St. (TX), 5, 5, 0, 0.50000, 193, 216, -23, 
1996, Sam Houston St. (TX), 4, 7, 0, 0.36364, 238, 309, -71, 
1997, Sam Houston St. (TX), 5, 6, 0, 0.45455, 281, 279, 2, 
1998, Sam Houston St. (TX), 3, 8, 0, 0.27273, 191, 335, -144, 
1999, Sam Houston St. (TX), 6, 5, 0, 0.54545, 331, 298, 33, 
2000, Sam Houston St. (TX), 7, 4, 0, 0.63636, 290, 228, 62, 
2001, Sam Houston St. (TX), 10, 3, 0, 0.76923, 470, 322, 148, 
2002, Sam Houston St. (TX), 4, 7, 0, 0.36364, 197, 313, -116, 
2003, Sam Houston St. (TX), 2, 9, 0, 0.18182, 239, 406, -167, 
2004, Sam Houston St. (TX), 11, 3, 0, 0.78571, 518, 338, 180, 
1893, West Virginia, 2, 1, 0, 0.66667, 24, 60, -36, 
1894, West Virginia, 2, 2, 0, 0.50000, 28, 52, -24, 
1935, Eastern Kentucky, 4, 4, 1, 0.50000, 212, 106, 106, 
1936, Eastern Kentucky, 7, 2, 0, 0.77778, 127, 45, 82, 
1937, Eastern Kentucky, 5, 2, 1, 0.68750, 81, 74, 7, 
1938, Eastern Kentucky, 6, 1, 1, 0.81250, 159, 39, 120, 
1939, Eastern Kentucky, 6, 3, 0, 0.66667, 181, 79, 102, 
1940, Eastern Kentucky, 8, 0, 0, 1.00000, 273, 27, 246, 
1941, Eastern Kentucky, 7, 1, 0, 0.87500, 206, 47, 159, 
1942, Eastern Kentucky, 4, 2, 2, 0.62500, 70, 46, 24, 
1945, Eastern Kentucky, 4, 3, 1, 0.56250, 139, 65, 74, 
1946, Eastern Kentucky, 5, 4, 0, 0.55556, 112, 88, 24, 
1997, South Dakota, 5, 6, 0, 0.45455, 290, 210, 80, 
1998, South Dakota, 3, 8, 0, 0.27273, 181, 318, -137, 
1914, Eastern Michigan, 3, 2, 1, 0.58333, 72, 46, 26, 
1912, Florida Southern, 1, 2, 0, 0.33333, 13, 81, -68, 
1936, Brevard College (NC), 3, 6, 0, 0.33333, 92, 143, -51, 
1937, Brevard College (NC), 4, 3, 2, 0.55556, 56, 84, -28, 
1974, Maranatha Baptist Bible (WI), 4, 4, 0, 0.50000, 147, 195, -48, 
1975, Maranatha Baptist Bible (WI), 7, 2, 0, 0.77778, 264, 147, 117, 
1976, Maranatha Baptist Bible (WI), 3, 5, 1, 0.38889, 134, 192, -58, 
1977, Maranatha Baptist Bible (WI), 6, 2, 1, 0.72222, 181, 144, 37, 
1978, Maranatha Baptist Bible (WI), 1, 8, 0, 0.11111, 72, 260, -188, 
1928, Lawrence (WI), 2, 5, 1, 0.31250, 49, 75, -26, 
1929, Lawrence (WI), 4, 2, 1, 0.64286, 114, 85, 29, 
1990, Saint Mary's (CA), 7, 3, 0, 0.70000, 292, 234, 58, 
1991, Saint Mary's (CA), 6, 5, 0, 0.54545, 361, 195, 166, 
1992, Saint Mary's (CA), 5, 4, 0, 0.55556, 245, 197, 48, 
1993, Saint Mary's (CA), 6, 3, 1, 0.65000, 298, 221, 77, 
1994, Saint Mary's (CA), 7, 3, 0, 0.70000, 249, 178, 71, 
1995, Saint Mary's (CA), 8, 2, 0, 0.80000, 334, 230, 104, 
1996, Saint Mary's (CA), 7, 3, 0, 0.70000, 312, 224, 88, 
1997, Saint Mary's (CA), 4, 6, 0, 0.40000, 253, 255, -2, 
1998, Saint Mary's (CA), 2, 8, 0, 0.20000, 154, 270, -116, 
1999, Saint Mary's (CA), 2, 9, 0, 0.18182, 169, 345, -176, 
1995, Eastern Michigan, 6, 5, 0, 0.54545, 363, 335, 28, 
1996, Eastern Michigan, 3, 8, 0, 0.27273, 210, 284, -74, 
1997, Eastern Michigan, 4, 7, 0, 0.36364, 329, 352, -23, 
1998, Eastern Michigan, 3, 8, 0, 0.27273, 216, 309, -93, 
1999, Eastern Michigan, 4, 6, 0, 0.40000, 216, 308, -92, 
1950, McNeese St. (LA), 5, 5, 0, 0.50000, 195, 208, -13, 
1951, McNeese St. (LA), 5, 4, 1, 0.55000, 192, 166, 26, 
1952, McNeese St. (LA), 7, 3, 0, 0.70000, 270, 126, 144, 
1953, McNeese St. (LA), 3, 7, 0, 0.30000, 166, 245, -79, 
1954, McNeese St. (LA), 2, 8, 0, 0.20000, 128, 356, -228, 
1923, Willamette (OR), 2, 5, 1, 0.31250, 80, 148, -68, 
1924, Willamette (OR), 1, 5, 1, 0.21429, 52, 118, -66, 
1925, Willamette (OR), 2, 7, 0, 0.22222, 90, 232, -142, 
1967, North Park (IL), 3, 6, 0, 0.33333, 141, 164, -23, 
1968, North Park (IL), 6, 3, 0, 0.66667, 291, 197, 94, 
1946, Glenville St. (WV), 1, 5, 2, 0.25000, 32, 63, -31, 
1947, Glenville St. (WV), 2, 5, 1, 0.31250, 41, 104, -63, 
1948, Glenville St. (WV), 0, 7, 0, 0.00000, 7, 113, -106, 
1949, Glenville St. (WV), 0, 6, 1, 0.07143, 86, 164, -78, 
1950, Glenville St. (WV), 3, 5, 0, 0.37500, 89, 118, -29, 
1951, Glenville St. (WV), 3, 4, 0, 0.42857, 98, 118, -20, 
1952, Glenville St. (WV), 3, 3, 0, 0.50000, 97, 85, 12, 
1928, Long Island-Brooklyn (NY), 5, 3, 1, 0.61111, 29, 76, -47, 
1929, Long Island-Brooklyn (NY), 5, 5, 0, 0.50000, 103, 119, -16, 
1930, Long Island-Brooklyn (NY), 3, 4, 0, 0.42857, 52, 140, -88, 
1931, Long Island-Brooklyn (NY), 7, 1, 0, 0.87500, 117, 51, 66, 
1969, Kentucky, 2, 8, 0, 0.20000, 104, 295, -191, 
1970, Kentucky, 2, 9, 0, 0.18182, 131, 233, -102, 
1971, Kentucky, 3, 8, 0, 0.27273, 144, 284, -140, 
1972, Kentucky, 3, 8, 0, 0.27273, 131, 232, -101, 
1894, Lawrence (WI), 3, 3, 0, 0.50000, 52, 118, -66, 
1907, Delaware, 0, 5, 1, 0.08333, 0, 117, -117, 
1966, Delaware, 6, 3, 0, 0.66667, 201, 156, 45, 
1967, Delaware, 2, 7, 0, 0.22222, 178, 222, -44, 
1968, Delaware, 8, 3, 0, 0.72727, 319, 180, 139, 
1969, Delaware, 9, 2, 0, 0.81818, 383, 156, 227, 
1970, Delaware, 9, 2, 0, 0.81818, 403, 207, 196, 
1971, Delaware, 10, 1, 0, 0.90909, 494, 120, 374, 
1972, Delaware, 10, 0, 0, 1.00000, 355, 81, 274, 
1973, Delaware, 8, 4, 0, 0.66667, 374, 198, 176, 
1974, Delaware, 12, 2, 0, 0.85714, 439, 198, 241, 
1975, Delaware, 8, 3, 0, 0.72727, 237, 146, 91, 
1976, Delaware, 8, 3, 1, 0.70833, 362, 159, 203, 
1977, Delaware, 6, 3, 1, 0.65000, 245, 131, 114, 
1978, Delaware, 10, 4, 0, 0.71429, 446, 184, 262, 
1979, Delaware, 13, 1, 0, 0.92857, 546, 238, 308, 
1980, Delaware, 9, 2, 0, 0.81818, 282, 129, 153, 
1981, Delaware, 9, 3, 0, 0.75000, 403, 223, 180, 
1982, Delaware, 12, 2, 0, 0.85714, 426, 162, 264, 
1983, Delaware, 4, 7, 0, 0.36364, 194, 214, -20, 
1984, Delaware, 8, 3, 0, 0.72727, 341, 191, 150, 
1985, Delaware, 7, 4, 0, 0.63636, 221, 154, 67, 
1986, Delaware, 9, 4, 0, 0.69231, 401, 311, 90, 
1987, Delaware, 5, 6, 0, 0.45455, 300, 312, -12, 
1988, Delaware, 7, 5, 0, 0.58333, 252, 239, 13, 
1989, Delaware, 7, 4, 0, 0.63636, 258, 217, 41, 
1990, Delaware, 6, 5, 0, 0.54545, 216, 233, -17, 
1991, Delaware, 10, 2, 0, 0.83333, 393, 241, 152, 
1992, Delaware, 11, 3, 0, 0.78571, 503, 268, 235, 
1993, Delaware, 9, 4, 0, 0.69231, 485, 366, 119, 
1994, Delaware, 7, 3, 1, 0.68182, 360, 280, 80, 
1995, Delaware, 11, 2, 0, 0.84615, 423, 238, 185, 
1996, Delaware, 8, 4, 0, 0.66667, 293, 244, 49, 
1997, Delaware, 12, 2, 0, 0.85714, 416, 218, 198, 
1998, Delaware, 7, 4, 0, 0.63636, 359, 299, 60, 
1999, Delaware, 7, 4, 0, 0.63636, 322, 270, 52, 
2000, Delaware, 12, 2, 0, 0.85714, 570, 238, 332, 
2001, Delaware, 4, 6, 0, 0.40000, 188, 199, -11, 
1965, Eastern Michigan, 3, 4, 1, 0.43750, 125, 129, -4, 
1966, Eastern Michigan, 5, 3, 1, 0.61111, 100, 87, 13, 
2013, Saint Lawrence (NY), 7, 3, 0, 0.70000, 212, 164, 48, 
1968, Portland St. (OR), 4, 6, 0, 0.40000, 187, 302, -115, 
1969, Portland St. (OR), 6, 4, 0, 0.60000, 293, 220, 73, 
1970, Portland St. (OR), 6, 4, 0, 0.60000, 276, 191, 85, 
1971, Portland St. (OR), 4, 5, 0, 0.44444, 151, 218, -67, 
1974, Oregon, 2, 9, 0, 0.18182, 116, 330, -214, 
1975, Oregon, 3, 8, 0, 0.27273, 146, 266, -120, 
1976, Oregon, 4, 7, 0, 0.36364, 144, 271, -127, 
1981, Portland St. (OR), 2, 9, 0, 0.18182, 152, 320, -168, 
1982, Portland St. (OR), 2, 9, 0, 0.18182, 138, 319, -181, 
1983, Portland St. (OR), 3, 7, 0, 0.30000, 175, 237, -62, 
1984, Portland St. (OR), 8, 3, 0, 0.72727, 253, 189, 64, 
1985, Portland St. (OR), 4, 5, 1, 0.45000, 261, 287, -26, 
1986, Montana, 6, 4, 0, 0.60000, 362, 306, 56, 
1987, Montana, 6, 5, 0, 0.54545, 323, 205, 118, 
1988, Montana, 8, 4, 0, 0.66667, 307, 212, 95, 
1989, Montana, 11, 3, 0, 0.78571, 451, 283, 168, 
1990, Montana, 7, 4, 0, 0.63636, 372, 275, 97, 
1991, Montana, 7, 4, 0, 0.63636, 274, 241, 33, 
1992, Montana, 6, 5, 0, 0.54545, 290, 223, 67, 
1993, Montana, 10, 2, 0, 0.83333, 501, 310, 191, 
1994, Montana, 11, 3, 0, 0.78571, 472, 294, 178, 
1995, Montana, 13, 2, 0, 0.86667, 652, 299, 353, 
1970, Parsons (IA), 2, 7, 0, 0.22222, 90, 172, -82, 
1954, Villanova (PA), 1, 9, 0, 0.10000, 95, 297, -202, 
1955, Villanova (PA), 1, 9, 0, 0.10000, 86, 204, -118, 
1956, Villanova (PA), 5, 4, 0, 0.55556, 152, 92, 60, 
1957, Villanova (PA), 3, 6, 0, 0.33333, 109, 96, 13, 
1958, Villanova (PA), 6, 4, 0, 0.60000, 112, 151, -39, 
1959, Villanova (PA), 0, 4, 0, 0.00000, 33, 120, -87, 
1917, Villanova (PA), 0, 3, 2, 0.20000, 17, 124, -107, 
1918, Villanova (PA), 3, 2, 0, 0.60000, 56, 67, -11, 
1919, Villanova (PA), 5, 3, 1, 0.61111, 85, 142, -57, 
1920, Villanova (PA), 1, 5, 1, 0.21429, 39, 112, -73, 
1932, Virginia Tech, 8, 1, 0, 0.88889, 153, 28, 125, 
1933, Virginia Tech, 4, 3, 3, 0.55000, 54, 86, -32, 
1934, Virginia Tech, 5, 5, 0, 0.50000, 95, 113, -18, 
1935, Virginia Tech, 4, 3, 2, 0.55556, 68, 47, 21, 
1936, Virginia Tech, 5, 5, 0, 0.50000, 63, 100, -37, 
1937, Virginia Tech, 5, 5, 0, 0.50000, 117, 116, 1, 
1938, Virginia Tech, 3, 5, 2, 0.40000, 75, 86, -11, 
1939, Virginia Tech, 4, 5, 1, 0.45000, 106, 84, 22, 
1940, Virginia Tech, 5, 5, 0, 0.50000, 140, 145, -5, 
1908, Davis & Elkins (WV), 4, 2, 0, 0.66667, 60, 17, 43, 
1895, Syracuse (NY), 6, 2, 2, 0.70000, 154, 46, 108, 
1896, Syracuse (NY), 5, 3, 2, 0.60000, 194, 78, 116, 
1947, Bloomsburg (PA), 6, 2, 0, 0.75000, 156, 66, 90, 
1948, Bloomsburg (PA), 9, 0, 0, 1.00000, 185, 19, 166, 
1949, Bloomsburg (PA), 8, 1, 0, 0.88889, 229, 90, 139, 
1950, Bloomsburg (PA), 7, 1, 0, 0.87500, 205, 52, 153, 
1951, Bloomsburg (PA), 8, 0, 0, 1.00000, 206, 48, 158, 
1979, Central St. (OH), 5, 5, 0, 0.50000, 195, 180, 15, 
1980, Central St. (OH), 4, 6, 1, 0.40909, 210, 230, -20, 
1981, Texas Southern, 4, 6, 1, 0.40909, 211, 246, -35, 
1982, Texas Southern, 1, 9, 1, 0.13636, 186, 249, -63, 
1983, Texas Southern, 4, 6, 0, 0.40000, 103, 242, -139, 
2005, Howard Payne (TX), 7, 3, 0, 0.70000, 306, 250, 56, 
2006, Howard Payne (TX), 5, 5, 0, 0.50000, 254, 296, -42, 
2007, Howard Payne (TX), 1, 9, 0, 0.10000, 276, 409, -133, 
1899, Cincinnati (OH), 5, 2, 0, 0.71429, 81, 60, 21, 
1900, Cincinnati (OH), 3, 5, 1, 0.38889, 51, 166, -115, 
1903, Penn St., 5, 3, 0, 0.62500, 182, 77, 105, 
1910, Cornell (NY), 5, 2, 1, 0.68750, 165, 44, 121, 
1911, Cornell (NY), 7, 3, 0, 0.70000, 101, 52, 49, 
1958, Cal St.-Long Beach, 2, 6, 1, 0.27778, 102, 155, -53, 
1959, Cal St.-Long Beach, 4, 5, 0, 0.44444, 108, 122, -14, 
1960, Cal St.-Long Beach, 5, 3, 1, 0.61111, 139, 90, 49, 
1961, Cal St.-Long Beach, 5, 5, 0, 0.50000, 142, 174, -32, 
1962, Cal St.-Long Beach, 5, 5, 0, 0.50000, 126, 202, -76, 
1963, Cal St.-Long Beach, 5, 5, 0, 0.50000, 196, 148, 48, 
1964, Cal St.-Long Beach, 8, 2, 0, 0.80000, 282, 112, 170, 
1965, Cal St.-Long Beach, 9, 1, 0, 0.90000, 327, 111, 216, 
1966, Cal St.-Long Beach, 6, 3, 0, 0.66667, 233, 156, 77, 
1967, Cal St.-Long Beach, 5, 5, 0, 0.50000, 225, 220, 5, 
1968, Cal St.-Long Beach, 3, 7, 0, 0.30000, 208, 273, -65, 
1892, Doane (NE), 1, 1, 0, 0.50000, 62, 20, 42, 
1891, Missouri, 3, 1, 0, 0.75000, 106, 28, 78, 
1916, Rensselaer Tech (NY), 3, 6, 0, 0.33333, 34, 167, -133, 
1917, Rensselaer Tech (NY), 3, 4, 0, 0.42857, 83, 89, -6, 
1918, Rensselaer Tech (NY), 1, 1, 0, 0.50000, 14, 20, -6, 
1919, Rensselaer Tech (NY), 3, 4, 1, 0.43750, 27, 67, -40, 
1915, Franklin & Marshall (PA), 7, 2, 0, 0.77778, 248, 43, 205, 
1921, Clarion (PA), 3, 2, 0, 0.60000, 32, 27, 5, 
2010, Tennessee St., 3, 8, 0, 0.27273, 220, 258, -38, 
2011, Tennessee St., 5, 6, 0, 0.45455, 335, 361, -26, 
2012, Tennessee St., 8, 3, 0, 0.72727, 317, 251, 66, 
2013, Tennessee St., 10, 4, 0, 0.71429, 381, 253, 128, 
1978, Miami (OH), 8, 2, 1, 0.77273, 228, 161, 67, 
1979, Miami (OH), 6, 5, 0, 0.54545, 223, 142, 81, 
1980, Miami (OH), 5, 6, 0, 0.45455, 241, 192, 49, 
1981, Miami (OH), 8, 2, 1, 0.77273, 199, 154, 45, 
1982, Miami (OH), 7, 4, 0, 0.63636, 195, 121, 74, 
1983, North Carolina St., 3, 8, 0, 0.27273, 236, 246, -10, 
1984, North Carolina St., 3, 8, 0, 0.27273, 263, 311, -48, 
1985, North Carolina St., 3, 8, 0, 0.27273, 186, 305, -119, 
1934, Eastern New Mexico, 7, 0, 2, 0.88889, 138, 20, 118, 
1929, West Texas A&M;, 6, 3, 1, 0.65000, 165, 55, 110, 
1930, West Texas A&M;, 6, 3, 1, 0.65000, 136, 69, 67, 
1931, Central Oklahoma, 6, 2, 1, 0.72222, 111, 46, 65, 
1932, Central Oklahoma, 6, 3, 1, 0.65000, 122, 60, 62, 
1933, Central Oklahoma, 4, 5, 1, 0.45000, 102, 93, 9, 
1934, Central Oklahoma, 7, 2, 0, 0.77778, 88, 47, 41, 
1935, Central Oklahoma, 7, 2, 1, 0.75000, 80, 25, 55, 
1936, Central Oklahoma, 8, 1, 0, 0.88889, 153, 59, 94, 
1937, Central Oklahoma, 6, 2, 2, 0.70000, 133, 110, 23, 
1938, Central Oklahoma, 6, 3, 0, 0.66667, 169, 65, 104, 
1939, Central Oklahoma, 5, 3, 0, 0.62500, 84, 83, 1, 
1940, Central Oklahoma, 2, 5, 2, 0.33333, 53, 144, -91, 
1993, Baylor (TX), 5, 6, 0, 0.45455, 265, 331, -66, 
1994, Baylor (TX), 7, 5, 0, 0.58333, 362, 277, 85, 
1995, Baylor (TX), 7, 4, 0, 0.63636, 273, 166, 107, 
1996, Baylor (TX), 4, 7, 0, 0.36364, 266, 320, -54, 
1953, West Virginia Wesleyan, 1, 4, 0, 0.20000, 32, 91, -59, 
1954, West Virginia Wesleyan, 2, 4, 1, 0.35714, 49, 112, -63, 
1955, West Virginia Wesleyan, 3, 5, 0, 0.37500, 82, 137, -55, 
1956, West Virginia Wesleyan, 3, 5, 0, 0.37500, 54, 159, -105, 
1957, West Virginia Wesleyan, 1, 6, 0, 0.14286, 71, 174, -103, 
1946, Kent St. (OH), 6, 2, 0, 0.75000, 143, 47, 96, 
1947, Kent St. (OH), 4, 4, 0, 0.50000, 89, 95, -6, 
1948, Kent St. (OH), 6, 2, 1, 0.72222, 227, 89, 138, 
1949, Kent St. (OH), 5, 3, 0, 0.62500, 166, 126, 40, 
1950, Kent St. (OH), 5, 4, 0, 0.55556, 215, 120, 95, 
1951, Kent St. (OH), 4, 3, 2, 0.55556, 241, 162, 79, 
1952, Kent St. (OH), 5, 4, 0, 0.55556, 204, 180, 24, 
1953, Kent St. (OH), 7, 2, 0, 0.77778, 250, 103, 147, 
1954, Kent St. (OH), 8, 2, 0, 0.80000, 331, 130, 201, 
1955, Kent St. (OH), 6, 2, 1, 0.72222, 184, 87, 97, 
1956, Kent St. (OH), 7, 2, 0, 0.77778, 208, 76, 132, 
1957, Kent St. (OH), 3, 6, 0, 0.33333, 114, 138, -24, 
1958, Kent St. (OH), 7, 2, 0, 0.77778, 137, 95, 42, 
1959, Kent St. (OH), 5, 3, 0, 0.62500, 144, 124, 20, 
1960, Kent St. (OH), 6, 3, 0, 0.66667, 118, 129, -11, 
1961, Kent St. (OH), 2, 8, 0, 0.20000, 126, 181, -55, 
1962, Kent St. (OH), 3, 6, 0, 0.33333, 107, 185, -78, 
1963, Kent St. (OH), 3, 5, 1, 0.38889, 107, 122, -15, 
1985, Susquehanna (PA), 3, 7, 0, 0.30000, 205, 237, -32, 
1986, Susquehanna (PA), 11, 1, 0, 0.91667, 314, 136, 178, 
1987, Susquehanna (PA), 8, 2, 0, 0.80000, 266, 108, 158, 
1988, Susquehanna (PA), 6, 4, 0, 0.60000, 234, 179, 55, 
1989, Susquehanna (PA), 8, 1, 1, 0.85000, 249, 138, 111, 
1966, East Stroudsburg (PA), 4, 4, 0, 0.50000, 151, 111, 40, 
1967, East Stroudsburg (PA), 7, 1, 0, 0.87500, 234, 100, 134, 
1968, East Stroudsburg (PA), 8, 0, 1, 0.94444, 379, 105, 274, 
1969, East Stroudsburg (PA), 5, 3, 0, 0.62500, 235, 172, 63, 
1970, East Stroudsburg (PA), 5, 4, 0, 0.55556, 242, 180, 62, 
1971, East Stroudsburg (PA), 6, 3, 0, 0.66667, 223, 83, 140, 
1972, East Stroudsburg (PA), 4, 5, 0, 0.44444, 187, 119, 68, 
1973, East Stroudsburg (PA), 6, 1, 1, 0.81250, 125, 50, 75, 
2000, Tennessee St., 3, 8, 0, 0.27273, 278, 372, -94, 
2001, Tennessee St., 8, 3, 0, 0.72727, 389, 223, 166, 
2002, Tennessee St., 2, 10, 0, 0.16667, 308, 403, -95, 
2003, Tennessee St., 7, 5, 0, 0.58333, 348, 285, 63, 
2004, Tennessee St., 4, 7, 0, 0.36364, 278, 311, -33, 
1930, Eastern Washington, 3, 4, 0, 0.42857, 102, 44, 58, 
1931, Eastern Washington, 5, 1, 2, 0.75000, 189, 53, 136, 
1932, Eastern Washington, 3, 2, 3, 0.56250, 99, 57, 42, 
1933, Eastern Washington, 6, 2, 0, 0.75000, 206, 47, 159, 
1934, Eastern Washington, 6, 1, 0, 0.85714, 153, 44, 109, 
1935, Eastern Washington, 4, 2, 1, 0.64286, 81, 33, 48, 
1936, Eastern Washington, 7, 1, 0, 0.87500, 115, 49, 66, 
1937, Eastern Washington, 6, 1, 0, 0.85714, 134, 40, 94, 
1938, Eastern Washington, 6, 2, 1, 0.72222, 90, 61, 29, 
1939, Eastern Washington, 5, 3, 0, 0.62500, 135, 65, 70, 
1940, Eastern Washington, 6, 2, 0, 0.75000, 142, 48, 94, 
1941, Eastern Washington, 5, 2, 1, 0.68750, 83, 46, 37, 
1946, Eastern Washington, 4, 3, 1, 0.56250, 119, 50, 69, 
1895, Franklin & Marshall (PA), 3, 5, 1, 0.38889, 98, 159, -61, 
1965, Southern Utah, 3, 5, 0, 0.37500, 144, 212, -68, 
1966, Southern Utah, 5, 3, 0, 0.62500, 153, 158, -5, 
1907, Navy (MD), 9, 2, 1, 0.79167, 118, 34, 84, 
1925, Miles (AL), 1, 4, 0, 0.20000, 41, 80, -39, 
1926, Miles (AL), 1, 2, 0, 0.33333, 2, 46, -44, 
1976, Bentley (MA), 2, 3, 2, 0.42857, 102, 105, -3, 
1977, Bentley (MA), 3, 4, 0, 0.42857, 81, 114, -33, 
1978, Bentley (MA), 6, 3, 0, 0.66667, 181, 146, 35, 
1991, Sacred Heart (CT), 5, 4, 0, 0.55556, 131, 135, -4, 
1992, Sacred Heart (CT), 0, 9, 0, 0.00000, 75, 228, -153, 
1993, Sacred Heart (CT), 3, 7, 0, 0.30000, 144, 174, -30, 
1994, Sacred Heart (CT), 4, 5, 0, 0.44444, 148, 145, 3, 
1995, Sacred Heart (CT), 3, 7, 0, 0.30000, 229, 210, 19, 
1996, Sacred Heart (CT), 4, 6, 0, 0.40000, 115, 189, -74, 
2013, Wingate (NC), 4, 6, 0, 0.40000, 293, 342, -49, 
1966, Monmouth (IL), 2, 6, 0, 0.25000, 88, 247, -159, 
1967, Monmouth (IL), 5, 3, 0, 0.62500, 172, 154, 18, 
1968, Monmouth (IL), 6, 1, 1, 0.81250, 254, 89, 165, 
1969, Monmouth (IL), 7, 2, 0, 0.77778, 265, 134, 131, 
1970, Monmouth (IL), 8, 1, 0, 0.88889, 242, 103, 139, 
1971, Monmouth (IL), 8, 1, 0, 0.88889, 315, 79, 236, 
1972, Monmouth (IL), 9, 0, 0, 1.00000, 328, 104, 224, 
1973, Monmouth (IL), 6, 1, 1, 0.81250, 229, 69, 160, 
1974, Monmouth (IL), 7, 2, 0, 0.77778, 230, 79, 151, 
1975, Monmouth (IL), 4, 4, 0, 0.50000, 209, 175, 34, 
1976, Monmouth (IL), 6, 3, 0, 0.66667, 222, 122, 100, 
1977, Monmouth (IL), 5, 4, 0, 0.55556, 182, 131, 51, 
1978, Monmouth (IL), 5, 3, 0, 0.62500, 206, 108, 98, 
1907, Monmouth (IL), 4, 1, 1, 0.75000, 71, 16, 55, 
1908, Monmouth (IL), 2, 4, 0, 0.33333, 35, 104, -69, 
1909, Monmouth (IL), 2, 5, 0, 0.28571, 60, 82, -22, 
1986, Massachusetts, 8, 3, 0, 0.72727, 251, 258, -7, 
1987, Massachusetts, 3, 8, 0, 0.27273, 257, 298, -41, 
1988, Massachusetts, 8, 4, 0, 0.66667, 343, 291, 52, 
1989, Massachusetts, 5, 5, 1, 0.50000, 298, 296, 2, 
1990, Massachusetts, 8, 2, 1, 0.77273, 224, 175, 49, 
1991, Massachusetts, 4, 7, 0, 0.36364, 205, 208, -3, 
1995, Richmond (VA), 7, 3, 1, 0.68182, 187, 186, 1, 
1996, Richmond (VA), 2, 9, 0, 0.18182, 157, 197, -40, 
1997, Richmond (VA), 6, 5, 0, 0.54545, 237, 183, 54, 
1998, Richmond (VA), 9, 3, 0, 0.75000, 321, 175, 146, 
1999, Richmond (VA), 5, 6, 0, 0.45455, 279, 295, -16, 
2000, Richmond (VA), 10, 3, 0, 0.76923, 255, 217, 38, 
2001, Richmond (VA), 3, 8, 0, 0.27273, 201, 189, 12, 
2002, Richmond (VA), 4, 7, 0, 0.36364, 199, 202, -3, 
2003, Richmond (VA), 2, 9, 0, 0.18182, 189, 370, -181, 
2006, Virginia Military Institute, 1, 10, 0, 0.09091, 199, 433, -234, 
2007, Virginia Military Institute, 2, 9, 0, 0.18182, 267, 461, -194, 
1925, North Texas, 6, 4, 0, 0.60000, 128, 131, -3, 
1926, North Texas, 5, 3, 1, 0.61111, 99, 104, -5, 
1927, North Texas, 1, 6, 2, 0.22222, 31, 224, -193, 
1928, North Texas, 4, 5, 0, 0.44444, 88, 171, -83, 
1924, Central Missouri St., 4, 4, 1, 0.50000, 90, 71, 19, 
1925, Central Missouri St., 4, 4, 1, 0.50000, 47, 45, 2, 
1926, Central Missouri St., 7, 0, 1, 0.93750, 145, 25, 120, 
1927, Central Missouri St., 5, 3, 0, 0.62500, 103, 80, 23, 
1928, Central Missouri St., 4, 2, 2, 0.62500, 51, 29, 22, 
1929, Central Missouri St., 0, 8, 1, 0.05556, 27, 165, -138, 
1930, Central Missouri St., 3, 4, 1, 0.43750, 70, 84, -14, 
1931, Central Missouri St., 3, 7, 0, 0.30000, 99, 89, 10, 
1932, Central Missouri St., 4, 3, 1, 0.56250, 97, 57, 40, 
1933, Central Missouri St., 6, 3, 0, 0.66667, 118, 107, 11, 
1934, Central Missouri St., 4, 4, 1, 0.50000, 79, 49, 30, 
2013, Union (KY), 3, 8, 0, 0.27273, 282, 436, -154, 
1932, Livingstone (NC), 0, 4, 0, 0.00000, 6, 51, -45, 
1901, Harvard (MA), 12, 0, 0, 1.00000, 254, 24, 230, 
1905, Harvard (MA), 8, 2, 1, 0.77273, 147, 41, 106, 
1906, Harvard (MA), 10, 1, 0, 0.90909, 167, 26, 141, 
1950, Northern Arizona, 2, 7, 0, 0.22222, 114, 374, -260, 
1914, New York (NY), 5, 4, 0, 0.55556, 130, 103, 27, 
1915, New York (NY), 4, 4, 1, 0.50000, 90, 160, -70, 
1919, Marshall (WV), 8, 0, 0, 1.00000, 302, 13, 289, 
1930, Saint Bonaventure (NY), 3, 5, 0, 0.37500, 68, 117, -49, 
1931, Saint Bonaventure (NY), 4, 2, 2, 0.62500, 70, 59, 11, 
1932, Saint Bonaventure (NY), 4, 2, 1, 0.64286, 120, 45, 75, 
1933, Saint Bonaventure (NY), 4, 2, 2, 0.62500, 99, 78, 21, 
1934, Saint Bonaventure (NY), 2, 5, 0, 0.28571, 68, 96, -28, 
1935, Saint Bonaventure (NY), 6, 2, 1, 0.72222, 188, 85, 103, 
1936, Saint Bonaventure (NY), 3, 3, 1, 0.50000, 84, 72, 12, 
1937, Saint Bonaventure (NY), 3, 4, 0, 0.42857, 55, 95, -40, 
1938, Saint Bonaventure (NY), 4, 4, 0, 0.50000, 61, 71, -10, 
1939, Saint Bonaventure (NY), 2, 3, 2, 0.42857, 13, 44, -31, 
1940, Saint Bonaventure (NY), 3, 4, 0, 0.42857, 53, 110, -57, 
1941, Saint Bonaventure (NY), 3, 5, 0, 0.37500, 134, 99, 35, 
1942, Saint Bonaventure (NY), 2, 2, 1, 0.50000, 34, 48, -14, 
1904, Georgetown (DC), 7, 1, 0, 0.87500, 193, 14, 179, 
1905, Georgetown (DC), 2, 7, 0, 0.22222, 22, 231, -209, 
1906, Georgetown (DC), 6, 1, 0, 0.85714, 92, 23, 69, 
1907, Georgetown (DC), 2, 4, 1, 0.35714, 26, 96, -70, 
1908, Georgetown (DC), 2, 4, 1, 0.35714, 54, 55, -1, 
1976, North Carolina St., 3, 7, 1, 0.31818, 205, 258, -53, 
1977, North Carolina St., 8, 4, 0, 0.66667, 259, 181, 78, 
1978, North Carolina St., 9, 3, 0, 0.75000, 280, 208, 72, 
1979, North Carolina St., 7, 4, 0, 0.63636, 258, 213, 45, 
2013, Black Hills St. (SD), 3, 8, 0, 0.27273, 296, 480, -184, 
1938, George Washington (DC), 5, 4, 0, 0.55556, 88, 82, 6, 
1939, George Washington (DC), 5, 3, 0, 0.62500, 78, 53, 25, 
1940, George Washington (DC), 5, 3, 1, 0.61111, 78, 82, -4, 
1941, George Washington (DC), 1, 7, 1, 0.16667, 31, 176, -145, 
1946, Merchant Marine (NY), 4, 7, 0, 0.36364, 173, 259, -86, 
1947, Merchant Marine (NY), 2, 9, 0, 0.18182, 100, 283, -183, 
1948, Merchant Marine (NY), 3, 4, 1, 0.43750, 113, 192, -79, 
1949, Merchant Marine (NY), 3, 5, 0, 0.37500, 131, 236, -105, 
1987, Cal St.-Long Beach, 4, 7, 0, 0.36364, 231, 287, -56, 
1988, Cal St.-Long Beach, 3, 9, 0, 0.25000, 201, 385, -184, 
1989, Cal St.-Long Beach, 4, 8, 0, 0.33333, 246, 407, -161, 
2013, Thiel (PA), 3, 7, 0, 0.30000, 285, 345, -60, 
1889, Purdue (IN), 2, 1, 0, 0.66667, 52, 28, 24, 
1910, Lehigh (PA), 2, 6, 1, 0.27778, 46, 98, -52, 
1911, Lehigh (PA), 5, 5, 1, 0.50000, 91, 82, 9, 
1896, Ohio, 4, 3, 1, 0.56250, 86, 122, -36, 
1933, Arkansas St., 2, 4, 2, 0.37500, 34, 79, -45, 
2012, Yale (CT), 2, 8, 0, 0.20000, 158, 289, -131, 
2013, Yale (CT), 5, 5, 0, 0.50000, 269, 277, -8, 
1971, Harvard (MA), 5, 4, 0, 0.55556, 180, 167, 13, 
1972, Harvard (MA), 4, 4, 1, 0.50000, 198, 186, 12, 
1973, Harvard (MA), 7, 2, 0, 0.77778, 224, 157, 67, 
1974, Harvard (MA), 7, 2, 0, 0.77778, 236, 129, 107, 
1975, Harvard (MA), 7, 2, 0, 0.77778, 216, 133, 83, 
1976, Harvard (MA), 6, 3, 0, 0.66667, 176, 115, 61, 
1977, Harvard (MA), 4, 5, 0, 0.44444, 153, 173, -20, 
1978, Harvard (MA), 4, 4, 1, 0.50000, 196, 189, 7, 
1979, Harvard (MA), 3, 6, 0, 0.33333, 148, 157, -9, 
1980, Harvard (MA), 7, 3, 0, 0.70000, 159, 138, 21, 
1981, Harvard (MA), 5, 4, 1, 0.55000, 218, 173, 45, 
1982, Harvard (MA), 7, 3, 0, 0.70000, 259, 136, 123, 
1983, Harvard (MA), 6, 2, 2, 0.70000, 188, 140, 48, 
1984, Harvard (MA), 5, 4, 0, 0.55556, 180, 196, -16, 
1985, Harvard (MA), 7, 3, 0, 0.70000, 192, 136, 56, 
1986, Harvard (MA), 3, 7, 0, 0.30000, 139, 190, -51, 
1987, Harvard (MA), 8, 2, 0, 0.80000, 243, 163, 80, 
1988, Harvard (MA), 2, 8, 0, 0.20000, 202, 272, -70, 
1989, Harvard (MA), 5, 5, 0, 0.50000, 207, 257, -50, 
1990, Harvard (MA), 5, 5, 0, 0.50000, 199, 206, -7, 
1991, Harvard (MA), 4, 5, 1, 0.45000, 203, 223, -20, 
1992, Harvard (MA), 3, 7, 0, 0.30000, 167, 240, -73, 
1993, Harvard (MA), 3, 7, 0, 0.30000, 233, 279, -46, 
2008, Briar Cliff (IA), 2, 9, 0, 0.18182, 119, 314, -195, 
2009, Briar Cliff (IA), 4, 7, 0, 0.36364, 212, 236, -24, 
2010, Briar Cliff (IA), 2, 9, 0, 0.18182, 216, 416, -200, 
2011, Briar Cliff (IA), 2, 9, 0, 0.18182, 163, 399, -236, 
2012, Briar Cliff (IA), 1, 10, 0, 0.09091, 196, 414, -218, 
2013, Briar Cliff (IA), 4, 7, 0, 0.36364, 212, 365, -153, 
1947, Texas Southern, 8, 3, 0, 0.72727, 183, 110, 73, 
1948, Texas Southern, 1, 6, 2, 0.22222, 61, 193, -132, 
1909, North Dakota St., 2, 2, 1, 0.50000, 39, 40, -1, 
1910, North Dakota St., 2, 3, 0, 0.40000, 100, 35, 65, 
1911, North Dakota St., 3, 1, 0, 0.75000, 99, 14, 85, 
1912, North Dakota St., 5, 1, 0, 0.83333, 200, 6, 194, 
1981, Wheaton (IL), 2, 7, 0, 0.22222, 145, 206, -61, 
1901, Georgia, 1, 5, 2, 0.25000, 21, 171, -150, 
1902, Georgia, 4, 2, 1, 0.64286, 55, 52, 3, 
1914, Hamilton (NY), 3, 4, 0, 0.42857, 54, 158, -104, 
1915, Hamilton (NY), 5, 1, 2, 0.75000, 90, 37, 53, 
1916, Hamilton (NY), 3, 4, 0, 0.42857, 66, 91, -25, 
1919, Bucknell (PA), 5, 4, 1, 0.55000, 142, 62, 80, 
1920, Bucknell (PA), 6, 3, 0, 0.66667, 244, 37, 207, 
1921, Bucknell (PA), 5, 3, 1, 0.61111, 179, 59, 120, 
1922, Bucknell (PA), 7, 4, 0, 0.63636, 260, 94, 166, 
1923, Bucknell (PA), 4, 4, 1, 0.50000, 160, 94, 66, 
1925, Syracuse (NY), 8, 1, 1, 0.85000, 202, 27, 175, 
1926, Syracuse (NY), 7, 2, 1, 0.75000, 227, 58, 169, 
1895, Sewanee (TN), 2, 2, 1, 0.50000, 38, 46, -8, 
1891, Rutgers (NJ), 8, 6, 0, 0.57143, 265, 137, 128, 
1896, Cincinnati (OH), 4, 3, 1, 0.56250, 88, 68, 20, 
1897, North Carolina, 7, 3, 0, 0.70000, 150, 53, 97, 
1898, North Carolina, 9, 0, 0, 1.00000, 187, 8, 179, 
1899, North Carolina, 7, 3, 1, 0.68182, 173, 58, 115, 
1900, North Carolina, 4, 1, 3, 0.68750, 163, 22, 141, 
1929, Charleston (WV), 0, 12, 0, 0.00000, 8, 414, -406, 
2011, Western Carolina (NC), 0, 1, 0, 0.00000, 21, 45, -24, 
1908, Washington St., 4, 0, 2, 0.83333, 164, 10, 154, 
1985, Troy (AL), 6, 4, 0, 0.60000, 256, 161, 95, 
1986, Troy (AL), 10, 2, 0, 0.83333, 403, 239, 164, 
1987, Troy (AL), 12, 1, 1, 0.89286, 467, 166, 301, 
1988, Southern Illinois, 4, 7, 0, 0.36364, 201, 262, -61, 
1993, Nicholls St. (LA), 3, 8, 0, 0.27273, 269, 377, -108, 
1994, Nicholls St. (LA), 5, 6, 0, 0.45455, 248, 227, 21, 
2002, Delta St. (MS), 4, 7, 0, 0.36364, 269, 284, -15, 
2003, Delta St. (MS), 9, 2, 0, 0.81818, 458, 208, 250, 
2004, Delta St. (MS), 6, 4, 0, 0.60000, 443, 296, 147, 
2005, Delta St. (MS), 7, 4, 0, 0.63636, 360, 286, 74, 
2006, Delta St. (MS), 12, 3, 0, 0.80000, 436, 201, 235, 
2009, Iowa St., 7, 6, 0, 0.53846, 267, 284, -17, 
2010, Iowa St., 5, 7, 0, 0.41667, 260, 346, -86, 
2011, Iowa St., 6, 7, 0, 0.46154, 295, 382, -87, 
2012, Iowa St., 6, 7, 0, 0.46154, 319, 311, 8, 
2013, Iowa St., 3, 9, 0, 0.25000, 298, 432, -134, 
1930, Wyoming, 2, 5, 1, 0.31250, 86, 161, -75, 
1931, Wyoming, 6, 4, 0, 0.60000, 168, 76, 92, 
1932, Wyoming, 2, 6, 1, 0.27778, 53, 137, -84, 
1893, Yale (CT), 10, 1, 0, 0.90909, 330, 12, 318, 
1894, Yale (CT), 16, 0, 0, 1.00000, 485, 13, 472, 
2013, Temple (PA), 2, 10, 0, 0.16667, 299, 358, -59, 
2005, Eastern New Mexico, 5, 6, 0, 0.45455, 307, 330, -23, 
2006, Eastern New Mexico, 3, 7, 0, 0.30000, 187, 240, -53, 
2007, Eastern New Mexico, 5, 6, 0, 0.45455, 323, 326, -3, 
2008, Eastern New Mexico, 0, 9, 0, 0.00000, 253, 388, -135, 
2009, Eastern New Mexico, 0, 8, 0, 0.00000, 374, 413, -39, 
2010, Eastern New Mexico, 0, 6, 0, 0.00000, 380, 327, 53, 
2011, Eastern New Mexico, 0, 9, 0, 0.00000, 263, 451, -188, 
1978, Saint John's (NY), 5, 5, 0, 0.50000, 183, 192, -9, 
1979, Saint John's (NY), 4, 5, 1, 0.45000, 232, 155, 77, 
1980, Saint John's (NY), 3, 7, 0, 0.30000, 126, 180, -54, 
1981, Saint John's (NY), 8, 2, 0, 0.80000, 292, 95, 197, 
1982, Saint John's (NY), 9, 1, 0, 0.90000, 292, 208, 84, 
1983, Saint John's (NY), 9, 2, 0, 0.81818, 352, 151, 201, 
1984, Saint John's (NY), 8, 2, 0, 0.80000, 208, 147, 61, 
1985, Saint John's (NY), 5, 5, 0, 0.50000, 240, 224, 16, 
1986, Saint John's (NY), 6, 4, 0, 0.60000, 219, 208, 11, 
1987, Saint John's (NY), 5, 5, 0, 0.50000, 271, 231, 40, 
1988, Saint John's (NY), 5, 5, 0, 0.50000, 218, 233, -15, 
1989, Saint John's (NY), 9, 2, 0, 0.81818, 402, 252, 150, 
1990, Saint John's (NY), 5, 5, 0, 0.50000, 164, 195, -31, 
1991, Saint John's (NY), 6, 4, 0, 0.60000, 280, 210, 70, 
1992, Saint John's (NY), 5, 5, 0, 0.50000, 285, 269, 16, 
1993, Saint John's (NY), 8, 3, 0, 0.72727, 298, 229, 69, 
1994, Saint John's (NY), 10, 1, 0, 0.90909, 260, 147, 113, 
1995, Saint John's (NY), 4, 6, 0, 0.40000, 181, 265, -84, 
1996, Saint John's (NY), 6, 4, 0, 0.60000, 260, 209, 51, 
1997, Saint John's (NY), 8, 3, 0, 0.72727, 206, 145, 61, 
1998, Saint John's (NY), 6, 5, 0, 0.54545, 193, 150, 43, 
1999, Saint John's (NY), 7, 4, 0, 0.63636, 247, 142, 105, 
2000, Saint John's (NY), 5, 6, 0, 0.45455, 169, 216, -47, 
2001, Saint John's (NY), 1, 9, 0, 0.10000, 85, 268, -183, 
2002, Saint John's (NY), 2, 8, 0, 0.20000, 184, 308, -124, 
1972, Western Connecticut St., 1, 7, 0, 0.12500, 74, 171, -97, 
1973, Western Connecticut St., 4, 5, 0, 0.44444, 76, 69, 7, 
1974, Western Connecticut St., 4, 5, 0, 0.44444, 170, 175, -5, 
1975, Fordham (NY), 3, 5, 1, 0.38889, 59, 164, -105, 
1976, Fordham (NY), 5, 3, 1, 0.61111, 229, 177, 52, 
1977, Fordham (NY), 8, 2, 0, 0.80000, 345, 118, 227, 
1978, Fordham (NY), 7, 3, 0, 0.70000, 200, 140, 60, 
1957, Colgate (NY), 3, 6, 0, 0.33333, 84, 251, -167, 
1958, Colgate (NY), 1, 8, 0, 0.11111, 46, 251, -205, 
1897, Delaware, 2, 4, 1, 0.35714, 24, 106, -82, 
1898, Delaware, 2, 6, 1, 0.27778, 80, 109, -29, 
1899, Delaware, 6, 2, 0, 0.75000, 229, 40, 189, 
1900, Delaware, 2, 4, 1, 0.35714, 90, 50, 40, 
1901, Delaware, 5, 4, 0, 0.55556, 53, 102, -49, 
1967, Cincinnati (OH), 3, 6, 0, 0.33333, 111, 189, -78, 
1968, Cincinnati (OH), 5, 4, 1, 0.55000, 300, 327, -27, 
1976, Rice (TX), 3, 8, 0, 0.27273, 236, 417, -181, 
1977, Rice (TX), 1, 10, 0, 0.09091, 151, 458, -307, 
1897, Alma (MI), 4, 2, 0, 0.66667, 110, 72, 38, 
1901, Utah St., 3, 2, 1, 0.58333, 65, 46, 19, 
1920, Jackson St. (MS), 3, 0, 0, 1.00000, 97, 14, 83, 
1923, Jackson St. (MS), 0, 1, 0, 0.00000, 0, 56, -56, 
1999, Jacksonville St. (AL), 1, 6, 0, 0.14286, 123, 254, -131, 
1911, Wisconsin, 5, 1, 1, 0.78571, 111, 14, 97, 
1912, Ohio St., 6, 3, 0, 0.66667, 244, 122, 122, 
1917, Wisconsin, 4, 2, 1, 0.64286, 85, 30, 55, 
1919, Wisconsin, 5, 2, 0, 0.71429, 91, 41, 50, 
1920, Wisconsin, 6, 1, 0, 0.85714, 141, 29, 112, 
1921, Wisconsin, 5, 1, 1, 0.78571, 141, 13, 128, 
1922, Wisconsin, 4, 2, 1, 0.64286, 101, 22, 79, 
2013, Southeastern Oklahoma St., 2, 9, 0, 0.18182, 300, 390, -90, 
1926, Coast Guard (CT), 2, 2, 0, 0.50000, 31, 57, -26, 
1927, Coast Guard (CT), 1, 6, 0, 0.14286, 39, 175, -136, 
1928, Coast Guard (CT), 3, 3, 2, 0.50000, 109, 57, 52, 
1929, Coast Guard (CT), 1, 6, 1, 0.18750, 44, 145, -101, 
1954, Eastern New Mexico, 6, 3, 0, 0.66667, 184, 157, 27, 
1955, Eastern New Mexico, 5, 4, 0, 0.55556, 145, 130, 15, 
1956, Eastern New Mexico, 7, 3, 0, 0.70000, 217, 128, 89, 
1957, Eastern New Mexico, 9, 0, 1, 0.95000, 242, 103, 139, 
1958, Eastern New Mexico, 3, 6, 1, 0.35000, 146, 153, -7, 
1959, Eastern New Mexico, 4, 6, 0, 0.40000, 111, 247, -136, 
1960, Eastern New Mexico, 4, 5, 0, 0.44444, 164, 147, 17, 
1961, Eastern New Mexico, 6, 4, 0, 0.60000, 204, 156, 48, 
1962, Eastern New Mexico, 7, 3, 0, 0.70000, 232, 107, 125, 
1963, Eastern New Mexico, 6, 4, 0, 0.60000, 223, 149, 74, 
2013, College of Faith (NC), 1, 7, 0, 0.12500, 6, 389, -383, 
1905, Philadelphia Pharmacy (PA), 0, 2, 0, 0.00000, 0, 35, -35, 
1982, Chadron St. (NE), 6, 2, 0, 0.75000, 143, 53, 90, 
1983, Chadron St. (NE), 4, 6, 0, 0.40000, 88, 139, -51, 
1984, Colorado St.-Pueblo, 1, 9, 0, 0.10000, 127, 397, -270, 
1999, Livingstone (NC), 4, 7, 0, 0.36364, 210, 229, -19, 
2000, Livingstone (NC), 2, 8, 0, 0.20000, 146, 293, -147, 
2001, Livingstone (NC), 1, 8, 0, 0.11111, 112, 295, -183, 
2008, Virginia Union, 5, 5, 0, 0.50000, 277, 159, 118, 
1964, Savannah St. (GA), 1, 6, 0, 0.14286, 60, 203, -143, 
1965, Savannah St. (GA), 1, 6, 1, 0.18750, 70, 214, -144, 
1966, Savannah St. (GA), 3, 5, 0, 0.37500, 150, 190, -40, 
1967, Savannah St. (GA), 6, 2, 1, 0.72222, 113, 99, 14, 
1968, Savannah St. (GA), 2, 6, 0, 0.25000, 149, 192, -43, 
1988, Winston-Salem St. (NC), 10, 2, 0, 0.83333, 342, 144, 198, 
1989, Winston-Salem St. (NC), 8, 2, 0, 0.80000, 347, 133, 214, 
1990, Winston-Salem St. (NC), 7, 4, 1, 0.62500, 414, 241, 173, 
1991, Winston-Salem St. (NC), 9, 2, 0, 0.81818, 370, 226, 144, 
1992, Winston-Salem St. (NC), 7, 4, 0, 0.63636, 311, 228, 83, 
1993, Southern (LA), 11, 1, 0, 0.91667, 320, 142, 178, 
1994, Southern (LA), 6, 5, 0, 0.54545, 253, 147, 106, 
1995, Southern (LA), 11, 1, 0, 0.91667, 475, 220, 255, 
1996, Southern (LA), 7, 5, 0, 0.58333, 270, 195, 75, 
1997, Southern (LA), 11, 1, 0, 0.91667, 372, 219, 153, 
1998, Southern (LA), 9, 3, 0, 0.75000, 348, 258, 90, 
1999, Southern (LA), 11, 2, 0, 0.84615, 331, 237, 94, 
2000, Southern (LA), 7, 4, 0, 0.63636, 368, 282, 86, 
2001, Southern (LA), 7, 4, 0, 0.63636, 275, 214, 61, 
2002, Southern (LA), 6, 6, 0, 0.50000, 279, 296, -17, 
2003, Southern (LA), 12, 1, 0, 0.92308, 520, 195, 325, 
2004, Southern (LA), 8, 4, 0, 0.66667, 369, 265, 104, 
2005, Southern (LA), 4, 5, 0, 0.44444, 250, 239, 11, 
2006, Southern (LA), 5, 6, 0, 0.45455, 276, 280, -4, 
2007, Southern (LA), 8, 3, 0, 0.72727, 297, 189, 108, 
2008, Southern (LA), 6, 5, 0, 0.54545, 311, 279, 32, 
2009, Southern (LA), 6, 5, 0, 0.54545, 335, 257, 78, 
1929, Savannah St. (GA), 1, 2, 0, 0.33333, 14, 53, -39, 
1930, Savannah St. (GA), 1, 0, 1, 0.75000, 19, 13, 6, 
1931, Savannah St. (GA), 1, 5, 1, 0.21429, 50, 110, -60, 
1932, Savannah St. (GA), 2, 2, 1, 0.50000, 41, 32, 9, 
1933, Savannah St. (GA), 3, 2, 0, 0.60000, 47, 50, -3, 
1934, Savannah St. (GA), 0, 4, 1, 0.10000, 6, 94, -88, 
1953, West Alabama, 2, 7, 0, 0.22222, 90, 214, -124, 
1954, West Alabama, 0, 10, 0, 0.00000, 67, 355, -288, 
1955, West Alabama, 1, 7, 0, 0.12500, 69, 236, -167, 
1956, West Alabama, 1, 7, 1, 0.16667, 99, 251, -152, 
1988, Harding (AR), 4, 6, 0, 0.40000, 151, 206, -55, 
1989, Harding (AR), 7, 4, 0, 0.63636, 154, 125, 29, 
1990, Harding (AR), 6, 4, 0, 0.60000, 173, 135, 38, 
1991, Harding (AR), 7, 3, 1, 0.68182, 223, 197, 26, 
1992, Harding (AR), 7, 4, 0, 0.63636, 221, 164, 57, 
1993, Harding (AR), 6, 4, 0, 0.60000, 190, 178, 12, 
2001, Georgia, 8, 4, 0, 0.66667, 331, 228, 103, 
2002, Georgia, 13, 1, 0, 0.92857, 450, 212, 238, 
2003, Georgia, 11, 3, 0, 0.78571, 371, 203, 168, 
2004, Georgia, 10, 2, 0, 0.83333, 335, 198, 137, 
2005, Georgia, 10, 3, 0, 0.76923, 384, 213, 171, 
2006, Georgia, 9, 4, 0, 0.69231, 327, 229, 98, 
2007, Georgia, 11, 2, 0, 0.84615, 424, 262, 162, 
2008, Georgia, 10, 3, 0, 0.76923, 409, 319, 90, 
2009, Georgia, 8, 5, 0, 0.61538, 376, 337, 39, 
2010, Georgia, 6, 7, 0, 0.46154, 417, 287, 130, 
2011, Georgia, 10, 4, 0, 0.71429, 448, 288, 160, 
2012, Georgia, 12, 2, 0, 0.85714, 529, 275, 254, 
2013, Georgia, 8, 5, 0, 0.61538, 477, 377, 100, 
1904, Allegheny (PA), 5, 5, 0, 0.50000, 67, 268, -201, 
1905, Allegheny (PA), 4, 8, 0, 0.33333, 105, 215, -110, 
2002, Arkansas-Monticello, 2, 8, 0, 0.20000, 191, 352, -161, 
2003, Arkansas-Monticello, 4, 7, 0, 0.36364, 305, 355, -50, 
2004, Arkansas-Monticello, 6, 5, 0, 0.54545, 350, 382, -32, 
1945, North Carolina Central, 6, 4, 0, 0.60000, 231, 75, 156, 
1946, North Carolina Central, 7, 3, 0, 0.70000, 230, 55, 175, 
1947, North Carolina Central, 2, 7, 0, 0.22222, 49, 111, -62, 
1948, North Carolina Central, 6, 3, 1, 0.65000, 133, 65, 68, 
1949, North Carolina Central, 4, 5, 0, 0.44444, 111, 125, -14, 
1950, North Carolina Central, 7, 2, 0, 0.77778, 213, 72, 141, 
1951, North Carolina Central, 6, 2, 2, 0.70000, 165, 119, 46, 
1952, North Carolina Central, 4, 4, 0, 0.50000, 102, 134, -32, 
1953, North Carolina Central, 5, 3, 0, 0.62500, 151, 80, 71, 
1954, North Carolina Central, 7, 1, 1, 0.83333, 180, 57, 123, 
1955, North Carolina Central, 4, 1, 2, 0.71429, 124, 69, 55, 
1956, North Carolina Central, 5, 2, 2, 0.66667, 139, 97, 42, 
1957, North Carolina Central, 5, 4, 0, 0.55556, 119, 84, 35, 
1958, North Carolina Central, 7, 2, 0, 0.77778, 209, 89, 120, 
1959, North Carolina Central, 4, 4, 1, 0.50000, 127, 70, 57, 
1960, North Carolina Central, 7, 2, 0, 0.77778, 172, 85, 87, 
1961, North Carolina Central, 7, 0, 2, 0.88889, 150, 40, 110, 
1962, North Carolina Central, 6, 3, 0, 0.66667, 192, 101, 91, 
1963, North Carolina Central, 8, 1, 0, 0.88889, 152, 80, 72, 
1964, North Carolina Central, 4, 5, 0, 0.44444, 123, 127, -4, 
1888, Wake Forest (NC), 1, 1, 0, 0.50000, 32, 33, -1, 
1889, Wake Forest (NC), 2, 2, 0, 0.50000, 58, 76, -18, 
1898, North Carolina St., 1, 1, 0, 0.50000, 21, 34, -13, 
1899, North Carolina St., 1, 2, 2, 0.40000, 29, 55, -26, 
1915, Hanover (IN), 2, 4, 0, 0.33333, 122, 147, -25, 
1916, Hanover (IN), 1, 5, 0, 0.16667, 24, 290, -266, 
1917, Miami (OH), 6, 0, 2, 0.87500, 202, 0, 202, 
1918, Miami (OH), 5, 0, 1, 0.91667, 195, 13, 182, 
1906, Tennessee-Chattanooga, 3, 3, 0, 0.50000, 46, 130, -84, 
1977, Weber St. (UT), 4, 6, 0, 0.40000, 220, 252, -32, 
1978, Weber St. (UT), 4, 7, 0, 0.36364, 247, 258, -11, 
1979, Weber St. (UT), 3, 8, 0, 0.27273, 143, 244, -101, 
1980, Weber St. (UT), 4, 7, 0, 0.36364, 122, 334, -212, 
1963, Rensselaer Tech (NY), 0, 6, 0, 0.00000, 16, 200, -184, 
1964, Rensselaer Tech (NY), 0, 6, 1, 0.07143, 54, 191, -137, 
1965, Rensselaer Tech (NY), 1, 6, 0, 0.14286, 79, 156, -77, 
1966, Rensselaer Tech (NY), 5, 4, 0, 0.55556, 198, 138, 60, 
1967, Rensselaer Tech (NY), 4, 4, 0, 0.50000, 199, 178, 21, 
1968, Rensselaer Tech (NY), 2, 7, 0, 0.22222, 124, 202, -78, 
1969, Rensselaer Tech (NY), 1, 7, 1, 0.16667, 178, 313, -135, 
1970, Rensselaer Tech (NY), 2, 7, 0, 0.22222, 106, 190, -84, 
1971, Rensselaer Tech (NY), 4, 5, 0, 0.44444, 209, 181, 28, 
1972, Rensselaer Tech (NY), 1, 8, 0, 0.11111, 86, 228, -142, 
1911, Virginia Tech, 6, 1, 2, 0.77778, 176, 52, 124, 
1956, Shepherd (WV), 6, 2, 0, 0.75000, 119, 43, 76, 
1957, Shepherd (WV), 3, 4, 0, 0.42857, 84, 91, -7, 
1958, Shepherd (WV), 5, 2, 1, 0.68750, 188, 80, 108, 
1959, Shepherd (WV), 4, 4, 0, 0.50000, 101, 93, 8, 
1960, Shepherd (WV), 4, 4, 0, 0.50000, 131, 71, 60, 
1961, Shepherd (WV), 5, 2, 0, 0.71429, 180, 65, 115, 
1962, Shepherd (WV), 4, 2, 2, 0.62500, 167, 77, 90, 
1963, Shepherd (WV), 7, 1, 1, 0.83333, 154, 107, 47, 
1964, Shepherd (WV), 3, 5, 0, 0.37500, 86, 113, -27, 
1965, Shepherd (WV), 2, 5, 0, 0.28571, 94, 199, -105, 
1966, Shepherd (WV), 1, 8, 0, 0.11111, 96, 208, -112, 
1896, Clemson (SC), 2, 1, 0, 0.66667, 36, 18, 18, 
1899, Clemson (SC), 4, 2, 0, 0.66667, 95, 50, 45, 
1921, Pacific (CA), 3, 3, 0, 0.50000, 117, 130, -13, 
1922, Pacific (CA), 6, 1, 0, 0.85714, 105, 19, 86, 
1923, Pacific (CA), 7, 0, 0, 1.00000, 171, 12, 159, 
1924, Pacific (CA), 6, 3, 0, 0.66667, 152, 115, 37, 
1925, Pacific (CA), 5, 2, 0, 0.71429, 71, 46, 25, 
1926, Pacific (CA), 5, 3, 1, 0.61111, 105, 112, -7, 
1927, Pacific (CA), 2, 6, 0, 0.25000, 61, 148, -87, 
1928, Pacific (CA), 5, 2, 0, 0.71429, 95, 64, 31, 
1929, Pacific (CA), 3, 4, 1, 0.43750, 67, 88, -21, 
1930, Pacific (CA), 3, 6, 0, 0.33333, 101, 104, -3, 
1931, Pacific (CA), 5, 2, 2, 0.66667, 110, 52, 58, 
1932, Pacific (CA), 4, 4, 0, 0.50000, 125, 73, 52, 
1931, New Mexico, 3, 3, 1, 0.50000, 80, 70, 10, 
1932, New Mexico, 1, 6, 1, 0.18750, 24, 184, -160, 
1933, New Mexico, 3, 4, 1, 0.43750, 92, 108, -16, 
1915, North Alabama, 0, 1, 0, 0.00000, 0, 69, -69, 
1988, East Tennessee St., 3, 8, 0, 0.27273, 180, 363, -183, 
1989, East Tennessee St., 4, 7, 0, 0.36364, 218, 325, -107, 
1990, East Tennessee St., 2, 9, 0, 0.18182, 240, 330, -90, 
1991, East Tennessee St., 1, 10, 0, 0.09091, 183, 396, -213, 
1895, Maryland University, 1, 1, 0, 0.50000, 6, 4, 2, 
1986, Florida A&M;, 6, 5, 0, 0.54545, 196, 248, -52, 
1987, Florida A&M;, 5, 5, 1, 0.50000, 154, 160, -6, 
1988, Florida A&M;, 7, 3, 1, 0.68182, 300, 213, 87, 
1989, Florida A&M;, 6, 5, 0, 0.54545, 229, 187, 42, 
1990, Florida A&M;, 7, 4, 0, 0.63636, 349, 289, 60, 
1991, Florida A&M;, 6, 5, 0, 0.54545, 325, 238, 87, 
1992, Florida A&M;, 7, 5, 0, 0.58333, 236, 264, -28, 
1993, Florida A&M;, 5, 6, 0, 0.45455, 216, 257, -41, 
1997, Oregon St., 3, 8, 0, 0.27273, 195, 285, -90, 
1998, Oregon St., 5, 6, 0, 0.45455, 286, 291, -5, 
2003, Oregon St., 8, 5, 0, 0.61538, 433, 301, 132, 
2004, Oregon St., 7, 5, 0, 0.58333, 320, 294, 26, 
2005, Oregon St., 5, 6, 0, 0.45455, 293, 365, -72, 
2006, Oregon St., 10, 4, 0, 0.71429, 389, 311, 78, 
2007, Oregon St., 9, 4, 0, 0.69231, 362, 294, 68, 
2008, Oregon St., 9, 4, 0, 0.69231, 397, 300, 97, 
2009, Oregon St., 8, 5, 0, 0.61538, 409, 325, 84, 
2010, Oregon St., 5, 7, 0, 0.41667, 293, 322, -29, 
2011, Oregon St., 3, 9, 0, 0.25000, 262, 370, -108, 
2012, Oregon St., 9, 4, 0, 0.69231, 423, 268, 155, 
2013, Oregon St., 7, 6, 0, 0.53846, 452, 408, 44, 
1912, Maine, 7, 1, 0, 0.87500, 126, 13, 113, 
1913, Maine, 5, 2, 1, 0.68750, 102, 53, 49, 
1914, Amherst (MA), 2, 4, 2, 0.37500, 39, 55, -16, 
1915, Amherst (MA), 6, 3, 0, 0.66667, 95, 73, 22, 
1916, Amherst (MA), 1, 6, 0, 0.14286, 37, 160, -123, 
1930, Fort Hays St. (KS), 2, 5, 2, 0.33333, 33, 91, -58, 
1931, Fort Hays St. (KS), 3, 5, 1, 0.38889, 28, 130, -102, 
1932, Fort Hays St. (KS), 4, 5, 0, 0.44444, 58, 57, 1, 
1933, Fort Hays St. (KS), 6, 2, 2, 0.70000, 146, 63, 83, 
1934, Fort Hays St. (KS), 6, 2, 1, 0.72222, 133, 65, 68, 
1901, Marquette (WI), 4, 0, 1, 0.90000, 53, 0, 53, 
1903, Marquette (WI), 7, 1, 0, 0.87500, 169, 28, 141, 
1987, Western Connecticut St., 1, 8, 1, 0.15000, 122, 206, -84, 
1988, Western Connecticut St., 3, 7, 0, 0.30000, 150, 192, -42, 
1989, Western Connecticut St., 2, 8, 0, 0.20000, 140, 266, -126, 
2007, North Carolina Central, 6, 4, 0, 0.60000, 176, 195, -19, 
2008, North Carolina Central, 4, 7, 0, 0.36364, 191, 349, -158, 
2009, North Carolina Central, 4, 7, 0, 0.36364, 282, 301, -19, 
2010, North Carolina Central, 2, 4, 0, 0.33333, 159, 141, 18, 
1963, South Dakota, 1, 7, 0, 0.12500, 28, 297, -269, 
1964, South Dakota, 3, 6, 0, 0.33333, 95, 193, -98, 
1965, South Dakota, 2, 8, 0, 0.20000, 61, 326, -265, 
1902, Iowa St., 6, 3, 1, 0.65000, 246, 56, 190, 
1903, Iowa St., 8, 1, 0, 0.88889, 202, 59, 143, 
1904, Iowa St., 7, 2, 0, 0.77778, 248, 48, 200, 
1905, Iowa St., 6, 3, 0, 0.66667, 203, 93, 110, 
1906, Iowa St., 9, 1, 0, 0.90000, 268, 30, 238, 
1898, Franklin & Marshall (PA), 4, 4, 2, 0.50000, 75, 152, -77, 
1901, Baylor (TX), 5, 3, 0, 0.62500, 173, 61, 112, 
2001, Middlebury (VT), 4, 4, 0, 0.50000, 113, 111, 2, 
2002, Middlebury (VT), 4, 4, 0, 0.50000, 192, 138, 54, 
2003, Middlebury (VT), 4, 4, 0, 0.50000, 148, 156, -8, 
2004, Middlebury (VT), 4, 4, 0, 0.50000, 167, 169, -2, 
2005, Middlebury (VT), 3, 5, 0, 0.37500, 153, 141, 12, 
2006, Middlebury (VT), 6, 2, 0, 0.75000, 103, 91, 12, 
2007, Middlebury (VT), 7, 1, 0, 0.87500, 191, 89, 102, 
2008, Middlebury (VT), 5, 3, 0, 0.62500, 275, 216, 59, 
2009, Middlebury (VT), 5, 3, 0, 0.62500, 239, 170, 69, 
2010, Middlebury (VT), 4, 4, 0, 0.50000, 203, 218, -15, 
2011, Middlebury (VT), 4, 4, 0, 0.50000, 227, 250, -23, 
2012, Middlebury (VT), 7, 1, 0, 0.87500, 268, 149, 119, 
2013, Middlebury (VT), 7, 1, 0, 0.87500, 238, 130, 108, 
1935, Fort Valley St. (GA), 7, 0, 1, 0.93750, 195, 19, 176, 
1914, Southwestern (TX), 4, 4, 0, 0.50000, 56, 174, -118, 
1915, Southwestern (TX), 4, 3, 0, 0.57143, 46, 82, -36, 
1916, Southwestern (TX), 3, 5, 1, 0.38889, 82, 133, -51, 
1917, Southern Methodist (TX), 3, 2, 3, 0.56250, 74, 49, 25, 
1918, Southern Methodist (TX), 4, 3, 0, 0.57143, 40, 46, -6, 
1919, Southern Methodist (TX), 5, 4, 1, 0.55000, 162, 86, 76, 
1920, Southern Methodist (TX), 3, 5, 2, 0.40000, 125, 90, 35, 
1929, Miami (FL), 3, 2, 0, 0.60000, 45, 26, 19, 
1999, New Haven (CT), 5, 5, 0, 0.50000, 313, 299, 14, 
2000, New Haven (CT), 5, 5, 0, 0.50000, 335, 218, 117, 
2001, New Haven (CT), 5, 4, 0, 0.55556, 218, 187, 31, 
2008, Rhode Island, 3, 9, 0, 0.25000, 226, 384, -158, 
1987, Wyoming, 10, 3, 0, 0.76923, 426, 271, 155, 
1988, Wyoming, 11, 2, 0, 0.84615, 511, 280, 231, 
1989, Wyoming, 5, 6, 0, 0.45455, 281, 299, -18, 
1990, Wyoming, 9, 4, 0, 0.69231, 327, 297, 30, 
1963, Central Missouri St., 1, 8, 0, 0.11111, 33, 287, -254, 
1964, Central Missouri St., 1, 8, 0, 0.11111, 41, 236, -195, 
1965, Central Missouri St., 2, 6, 1, 0.27778, 103, 211, -108, 
1903, Louisiana Tech, 1, 1, 0, 0.50000, 16, 21, -5, 
1970, Idaho, 4, 7, 0, 0.36364, 226, 335, -109, 
1971, Idaho, 8, 3, 0, 0.72727, 227, 171, 56, 
1972, Idaho, 4, 7, 0, 0.36364, 165, 278, -113, 
1973, Idaho, 4, 7, 0, 0.36364, 262, 319, -57, 
1915, Mississippi, 2, 6, 0, 0.25000, 51, 334, -283, 
1916, Mississippi, 3, 6, 0, 0.33333, 128, 188, -60, 
2011, Concordia (MI), 0, 11, 0, 0.00000, 47, 546, -499, 
1915, Miami (OH), 6, 2, 0, 0.75000, 137, 87, 50, 
1984, Western Kentucky, 2, 9, 0, 0.18182, 193, 345, -152, 
1985, Western Kentucky, 4, 7, 0, 0.36364, 232, 313, -81, 
1986, Western Kentucky, 4, 6, 1, 0.40909, 228, 258, -30, 
1987, Western Kentucky, 7, 4, 0, 0.63636, 263, 217, 46, 
1988, Western Kentucky, 9, 4, 0, 0.69231, 311, 220, 91, 
1989, Louisiana-Monroe, 5, 5, 1, 0.50000, 201, 257, -56, 
1990, Louisiana-Monroe, 7, 5, 0, 0.58333, 208, 218, -10, 
1991, Louisiana-Monroe, 7, 3, 1, 0.68182, 237, 175, 62, 
1992, Louisiana-Monroe, 10, 3, 0, 0.76923, 490, 295, 195, 
1993, Louisiana-Monroe, 9, 3, 0, 0.75000, 462, 275, 187, 
1997, Baylor (TX), 2, 9, 0, 0.18182, 200, 375, -175, 
1998, Baylor (TX), 2, 9, 0, 0.18182, 195, 323, -128, 
1901, Oklahoma, 3, 2, 0, 0.60000, 93, 35, 58, 
1980, Saint Francis (PA), 2, 7, 0, 0.22222, 64, 203, -139, 
1941, Central Arkansas, 3, 6, 0, 0.33333, 33, 88, -55, 
1947, East Tennessee St., 5, 4, 0, 0.55556, 148, 129, 19, 
1948, East Tennessee St., 6, 2, 1, 0.72222, 98, 73, 25, 
1949, East Tennessee St., 5, 4, 0, 0.55556, 125, 135, -10, 
1950, East Tennessee St., 3, 5, 1, 0.38889, 126, 125, 1, 
1951, East Tennessee St., 4, 5, 0, 0.44444, 115, 148, -33, 
2007, Delta St. (MS), 10, 2, 0, 0.83333, 375, 167, 208, 
2008, Delta St. (MS), 10, 2, 0, 0.83333, 435, 316, 119, 
2009, Delta St. (MS), 5, 5, 0, 0.50000, 271, 215, 56, 
2010, Delta St. (MS), 11, 4, 0, 0.73333, 478, 389, 89, 
2011, Delta St. (MS), 11, 3, 0, 0.78571, 468, 365, 103, 
2012, Southeastern Louisiana, 5, 6, 0, 0.45455, 207, 382, -175, 
2013, Southeastern Louisiana, 11, 3, 0, 0.78571, 538, 318, 220, 
1965, Lawrence (WI), 5, 3, 0, 0.62500, 155, 114, 41, 
1966, Lawrence (WI), 7, 1, 0, 0.87500, 205, 74, 131, 
1967, Lawrence (WI), 8, 0, 0, 1.00000, 213, 67, 146, 
1968, Lawrence (WI), 2, 6, 0, 0.25000, 116, 114, 2, 
1969, Lawrence (WI), 6, 3, 0, 0.66667, 230, 99, 131, 
1970, Lawrence (WI), 3, 6, 0, 0.33333, 136, 173, -37, 
1971, Lawrence (WI), 6, 3, 0, 0.66667, 199, 148, 51, 
1972, Lawrence (WI), 1, 6, 1, 0.18750, 80, 201, -121, 
1973, Lawrence (WI), 4, 4, 0, 0.50000, 126, 140, -14, 
1974, Lawrence (WI), 7, 2, 0, 0.77778, 251, 152, 99, 
1975, Lawrence (WI), 8, 1, 0, 0.88889, 224, 99, 125, 
1976, Lawrence (WI), 7, 2, 0, 0.77778, 222, 115, 107, 
1977, Lawrence (WI), 8, 1, 0, 0.88889, 344, 129, 215, 
1978, Lawrence (WI), 7, 2, 0, 0.77778, 289, 133, 156, 
1979, Lawrence (WI), 9, 1, 0, 0.90000, 283, 89, 194, 
1980, Lawrence (WI), 8, 1, 0, 0.88889, 249, 93, 156, 
1981, Lawrence (WI), 10, 1, 0, 0.90909, 339, 136, 203, 
1982, Lawrence (WI), 6, 2, 0, 0.75000, 269, 115, 154, 
1983, Lawrence (WI), 7, 2, 0, 0.77778, 188, 114, 74, 
1992, Lawrence (WI), 2, 7, 0, 0.22222, 151, 268, -117, 
1994, Southern Arkansas, 1, 7, 1, 0.16667, 128, 184, -56, 
1995, Southern Arkansas, 4, 6, 0, 0.40000, 146, 219, -73, 
1996, Southern Arkansas, 4, 6, 0, 0.40000, 158, 218, -60, 
1997, Southern Arkansas, 9, 2, 0, 0.81818, 218, 118, 100, 
1998, Southern Arkansas, 8, 2, 0, 0.80000, 330, 137, 193, 
1999, Southern Arkansas, 9, 1, 0, 0.90000, 270, 169, 101, 
2000, Northwestern St. (LA), 4, 7, 0, 0.36364, 256, 236, 20, 
2001, Northwestern St. (LA), 8, 4, 0, 0.66667, 319, 232, 87, 
2002, Arkansas St., 6, 7, 0, 0.46154, 259, 361, -102, 
2003, Arkansas St., 5, 7, 0, 0.41667, 242, 401, -159, 
2004, Arkansas St., 3, 8, 0, 0.27273, 215, 365, -150, 
2005, Arkansas St., 6, 6, 0, 0.50000, 294, 303, -9, 
2006, Arkansas St., 6, 6, 0, 0.50000, 182, 289, -107, 
2007, Arkansas St., 5, 7, 0, 0.41667, 291, 331, -40, 
2008, Arkansas St., 6, 6, 0, 0.50000, 324, 285, 39, 
2009, Arkansas St., 4, 8, 0, 0.33333, 272, 279, -7, 
2010, Arkansas St., 4, 8, 0, 0.33333, 360, 369, -9, 
1919, Fort Hays St. (KS), 3, 6, 0, 0.33333, 74, 62, 12, 
2013, Montana Western, 4, 6, 0, 0.40000, 216, 315, -99, 
2009, Salve Regina (RI), 4, 6, 0, 0.40000, 246, 233, 13, 
2010, Worcester Tech (MA), 3, 7, 0, 0.30000, 177, 182, -5, 
2011, Worcester Tech (MA), 2, 7, 0, 0.22222, 188, 259, -71, 
2012, Worcester Tech (MA), 2, 8, 0, 0.20000, 159, 325, -166, 
2013, Worcester Tech (MA), 3, 7, 0, 0.30000, 197, 278, -81, 
1924, Oglethorpe (GA), 6, 3, 1, 0.65000, 140, 86, 54, 
1925, Oglethorpe (GA), 8, 3, 0, 0.72727, 119, 92, 27, 
1926, Oglethorpe (GA), 3, 7, 1, 0.31818, 79, 204, -125, 
1927, Oglethorpe (GA), 2, 6, 0, 0.25000, 38, 138, -100, 
1928, Oglethorpe (GA), 3, 5, 1, 0.38889, 161, 122, 39, 
1929, Oglethorpe (GA), 5, 4, 1, 0.55000, 93, 78, 15, 
1930, Oglethorpe (GA), 4, 4, 1, 0.50000, 75, 72, 3, 
1931, Oglethorpe (GA), 3, 6, 0, 0.33333, 72, 94, -22, 
1932, Oglethorpe (GA), 1, 6, 0, 0.14286, 38, 109, -71, 
1933, Oglethorpe (GA), 4, 5, 0, 0.44444, 75, 133, -58, 
1923, Oglethorpe (GA), 4, 6, 0, 0.40000, 106, 139, -33, 
1980, Louisiana-Lafayette, 7, 4, 0, 0.63636, 194, 144, 50, 
1981, Louisiana-Lafayette, 1, 9, 1, 0.13636, 135, 229, -94, 
1982, Louisiana-Lafayette, 7, 3, 1, 0.68182, 248, 196, 52, 
1983, Louisiana-Lafayette, 4, 6, 0, 0.40000, 194, 212, -18, 
1984, Louisiana-Lafayette, 6, 5, 0, 0.54545, 207, 198, 9, 
1985, Louisiana-Lafayette, 4, 7, 0, 0.36364, 162, 306, -144, 
2013, Massachusetts-Dartmouth, 3, 6, 0, 0.33333, 199, 248, -49, 
1914, Mercer (GA), 5, 4, 0, 0.55556, 180, 208, -28, 
1901, Rutgers (NJ), 0, 7, 0, 0.00000, 5, 133, -128, 
1956, Western Carolina (NC), 1, 9, 0, 0.10000, 87, 246, -159, 
1957, Western Carolina (NC), 2, 5, 1, 0.31250, 60, 118, -58, 
1958, Western Carolina (NC), 1, 8, 1, 0.15000, 114, 186, -72, 
1959, Western Carolina (NC), 7, 2, 1, 0.75000, 238, 96, 142, 
1960, Western Carolina (NC), 6, 5, 0, 0.54545, 181, 143, 38, 
1961, Western Carolina (NC), 4, 6, 0, 0.40000, 136, 171, -35, 
1962, Western Carolina (NC), 3, 5, 1, 0.38889, 97, 141, -44, 
1963, Western Carolina (NC), 2, 6, 1, 0.27778, 82, 127, -45, 
1964, Western Carolina (NC), 5, 4, 0, 0.55556, 120, 120, 0, 
1965, Western Carolina (NC), 7, 2, 0, 0.77778, 148, 66, 82, 
1966, Western Carolina (NC), 5, 5, 0, 0.50000, 255, 167, 88, 
1967, Western Carolina (NC), 4, 5, 1, 0.45000, 169, 150, 19, 
1968, Western Carolina (NC), 4, 5, 0, 0.44444, 232, 228, 4, 
1906, Butler (IN), 1, 0, 0, 1.00000, 17, 0, 17, 
1898, Pittsburgh (PA), 5, 3, 4, 0.58333, 85, 57, 28, 
1899, Pittsburgh (PA), 3, 2, 0, 0.60000, 43, 23, 20, 
1941, Grambling St. (LA), 2, 6, 1, 0.27778, 122, 92, 30, 
1942, Grambling St. (LA), 6, 0, 0, 1.00000, 188, 0, 188, 
1945, Grambling St. (LA), 9, 2, 0, 0.81818, 327, 90, 237, 
1946, Grambling St. (LA), 5, 6, 0, 0.45455, 248, 145, 103, 
1947, Grambling St. (LA), 11, 2, 0, 0.84615, 427, 86, 341, 
1948, Grambling St. (LA), 9, 2, 0, 0.81818, 326, 111, 215, 
1949, Grambling St. (LA), 8, 3, 2, 0.69231, 261, 112, 149, 
1950, Grambling St. (LA), 7, 4, 1, 0.62500, 199, 220, -21, 
1951, Grambling St. (LA), 3, 5, 1, 0.38889, 147, 154, -7, 
1952, Grambling St. (LA), 7, 3, 1, 0.68182, 208, 184, 24, 
1953, Grambling St. (LA), 8, 2, 0, 0.80000, 246, 88, 158, 
1954, Grambling St. (LA), 4, 3, 2, 0.55556, 206, 140, 66, 
1955, Grambling St. (LA), 10, 0, 0, 1.00000, 330, 54, 276, 
1956, Grambling St. (LA), 8, 1, 0, 0.88889, 312, 97, 215, 
1957, Grambling St. (LA), 4, 4, 0, 0.50000, 212, 187, 25, 
1958, Grambling St. (LA), 6, 3, 0, 0.66667, 238, 132, 106, 
1959, Grambling St. (LA), 4, 6, 0, 0.40000, 268, 145, 123, 
1960, Grambling St. (LA), 9, 1, 0, 0.90000, 417, 78, 339, 
1961, Grambling St. (LA), 8, 2, 0, 0.80000, 375, 110, 265, 
1962, Grambling St. (LA), 6, 2, 2, 0.70000, 281, 144, 137, 
1963, Grambling St. (LA), 5, 3, 1, 0.61111, 249, 151, 98, 
1964, Grambling St. (LA), 9, 2, 0, 0.81818, 314, 181, 133, 
1965, Grambling St. (LA), 8, 3, 0, 0.72727, 352, 195, 157, 
1966, Grambling St. (LA), 6, 2, 1, 0.72222, 267, 199, 68, 
1967, Grambling St. (LA), 9, 1, 0, 0.90000, 318, 145, 173, 
1968, Grambling St. (LA), 9, 2, 0, 0.81818, 314, 201, 113, 
1969, Grambling St. (LA), 6, 4, 0, 0.60000, 324, 196, 128, 
1970, Grambling St. (LA), 9, 2, 0, 0.81818, 384, 183, 201, 
1971, Grambling St. (LA), 9, 2, 0, 0.81818, 343, 147, 196, 
1972, Grambling St. (LA), 11, 2, 0, 0.84615, 347, 123, 224, 
1973, Grambling St. (LA), 10, 3, 0, 0.76923, 339, 176, 163, 
1974, Grambling St. (LA), 11, 1, 0, 0.91667, 308, 120, 188, 
1975, Grambling St. (LA), 10, 2, 0, 0.83333, 324, 153, 171, 
1976, Grambling St. (LA), 8, 4, 0, 0.66667, 313, 202, 111, 
1977, Grambling St. (LA), 10, 1, 0, 0.90909, 462, 175, 287, 
1978, Grambling St. (LA), 9, 1, 1, 0.86364, 247, 120, 127, 
1979, Grambling St. (LA), 8, 3, 0, 0.72727, 281, 144, 137, 
1980, Grambling St. (LA), 10, 2, 0, 0.83333, 415, 166, 249, 
1981, Grambling St. (LA), 6, 4, 1, 0.59091, 235, 208, 27, 
1982, Grambling St. (LA), 8, 3, 0, 0.72727, 322, 193, 129, 
1983, Grambling St. (LA), 8, 1, 2, 0.81818, 286, 95, 191, 
1984, Grambling St. (LA), 7, 4, 0, 0.63636, 278, 203, 75, 
1985, Grambling St. (LA), 9, 3, 0, 0.75000, 317, 168, 149, 
1986, Grambling St. (LA), 7, 4, 0, 0.63636, 249, 195, 54, 
1987, Grambling St. (LA), 5, 6, 0, 0.45455, 278, 208, 70, 
1988, Grambling St. (LA), 8, 3, 0, 0.72727, 314, 185, 129, 
1989, Grambling St. (LA), 9, 3, 0, 0.75000, 464, 215, 249, 
1990, Grambling St. (LA), 8, 3, 0, 0.72727, 364, 227, 137, 
1991, Grambling St. (LA), 5, 6, 0, 0.45455, 330, 338, -8, 
1992, Grambling St. (LA), 10, 2, 0, 0.83333, 483, 242, 241, 
1993, Grambling St. (LA), 7, 4, 0, 0.63636, 337, 206, 131, 
1994, Grambling St. (LA), 9, 3, 0, 0.75000, 479, 262, 217, 
1995, Grambling St. (LA), 5, 6, 0, 0.45455, 340, 191, 149, 
1996, Grambling St. (LA), 3, 8, 0, 0.27273, 161, 218, -57, 
1997, Grambling St. (LA), 3, 8, 0, 0.27273, 187, 258, -71, 
1896, Nebraska, 6, 3, 1, 0.65000, 102, 64, 38, 
1897, Nebraska, 5, 1, 0, 0.83333, 84, 15, 69, 
1898, Brown (RI), 6, 4, 0, 0.60000, 136, 96, 40, 
1899, Brown (RI), 7, 3, 1, 0.68182, 175, 57, 118, 
1900, Brown (RI), 7, 3, 1, 0.68182, 155, 67, 88, 
1901, Brown (RI), 4, 7, 1, 0.37500, 70, 212, -142, 
1902, Maine, 6, 2, 0, 0.75000, 94, 33, 61, 
1904, Brown (RI), 6, 5, 0, 0.54545, 181, 51, 130, 
1905, Brown (RI), 7, 4, 0, 0.63636, 281, 58, 223, 
1906, Brown (RI), 6, 3, 0, 0.66667, 113, 32, 81, 
1907, Brown (RI), 7, 3, 0, 0.70000, 166, 50, 116, 
1910, Brown (RI), 7, 2, 1, 0.75000, 198, 47, 151, 
1911, Brown (RI), 7, 3, 1, 0.68182, 187, 53, 134, 
1912, Brown (RI), 6, 4, 0, 0.60000, 117, 107, 10, 
1913, Brown (RI), 4, 5, 0, 0.44444, 70, 111, -41, 
1914, Brown (RI), 5, 2, 2, 0.66667, 105, 65, 40, 
1915, Brown (RI), 5, 4, 1, 0.55000, 166, 46, 120, 
1916, Brown (RI), 8, 1, 0, 0.88889, 254, 37, 217, 
1917, Brown (RI), 8, 2, 0, 0.80000, 160, 62, 98, 
1918, Brown (RI), 2, 3, 0, 0.40000, 48, 98, -50, 
1919, Brown (RI), 5, 4, 1, 0.55000, 74, 61, 13, 
1920, Brown (RI), 6, 3, 0, 0.66667, 149, 62, 87, 
1921, Brown (RI), 5, 3, 1, 0.61111, 107, 89, 18, 
1922, Brown (RI), 6, 2, 1, 0.72222, 92, 47, 45, 
1923, Brown (RI), 6, 4, 0, 0.60000, 159, 71, 88, 
1924, Brown (RI), 5, 4, 0, 0.55556, 154, 65, 89, 
1925, Brown (RI), 5, 4, 1, 0.55000, 215, 80, 135, 
1941, Monmouth (IL), 5, 2, 1, 0.68750, 69, 48, 21, 
1942, Monmouth (IL), 2, 6, 0, 0.25000, 32, 135, -103, 
1945, Monmouth (IL), 2, 0, 0, 1.00000, 32, 13, 19, 
1946, Monmouth (IL), 4, 4, 0, 0.50000, 104, 66, 38, 
1947, Monmouth (IL), 5, 2, 1, 0.68750, 78, 30, 48, 
1948, Monmouth (IL), 4, 5, 0, 0.44444, 89, 99, -10, 
1949, Monmouth (IL), 5, 3, 1, 0.61111, 129, 75, 54, 
1950, Monmouth (IL), 3, 5, 0, 0.37500, 117, 129, -12, 
1951, Monmouth (IL), 3, 3, 2, 0.50000, 75, 75, 0, 
1952, Monmouth (IL), 6, 2, 0, 0.75000, 199, 88, 111, 
1953, Monmouth (IL), 5, 3, 0, 0.62500, 157, 120, 37, 
1954, Monmouth (IL), 2, 6, 0, 0.25000, 75, 141, -66, 
1955, Monmouth (IL), 0, 7, 0, 0.00000, 30, 233, -203, 
1956, Monmouth (IL), 1, 6, 1, 0.18750, 89, 238, -149, 
2005, Syracuse (NY), 1, 10, 0, 0.09091, 152, 295, -143, 
2006, Syracuse (NY), 4, 8, 0, 0.33333, 209, 295, -86, 
2007, Syracuse (NY), 2, 10, 0, 0.16667, 197, 418, -221, 
2008, Syracuse (NY), 3, 9, 0, 0.25000, 217, 392, -175, 
1893, Missouri, 4, 3, 0, 0.57143, 154, 136, 18, 
1894, Missouri, 4, 3, 0, 0.57143, 134, 108, 26, 
1896, Texas, 4, 5, 2, 0.45455, 104, 84, 20, 
1897, Maine, 1, 2, 0, 0.33333, 24, 13, 11, 
1953, Tennessee, 6, 4, 1, 0.59091, 240, 153, 87, 
1954, Tennessee, 4, 6, 0, 0.40000, 105, 164, -59, 
1976, Southern California, 11, 1, 0, 0.91667, 386, 139, 247, 
1977, Southern California, 8, 4, 0, 0.66667, 357, 212, 145, 
1978, Southern California, 12, 1, 0, 0.92308, 318, 153, 165, 
1979, Southern California, 11, 0, 1, 0.95833, 389, 171, 218, 
1980, Southern California, 8, 2, 1, 0.77273, 265, 134, 131, 
1981, Southern California, 9, 3, 0, 0.75000, 294, 170, 124, 
1982, Southern California, 8, 3, 0, 0.72727, 302, 143, 159, 
1993, Southern California, 8, 5, 0, 0.61538, 348, 252, 96, 
1994, Southern California, 8, 3, 1, 0.70833, 356, 243, 113, 
1995, Southern California, 9, 2, 1, 0.79167, 355, 212, 143, 
1996, Southern California, 6, 6, 0, 0.50000, 325, 267, 58, 
1997, Southern California, 6, 5, 0, 0.54545, 233, 233, 0, 
1999, Nevada-Las Vegas, 3, 8, 0, 0.27273, 160, 324, -164, 
2000, Nevada-Las Vegas, 8, 5, 0, 0.61538, 370, 275, 95, 
2001, Nevada-Las Vegas, 4, 7, 0, 0.36364, 284, 270, 14, 
2002, Nevada-Las Vegas, 5, 7, 0, 0.41667, 292, 366, -74, 
2003, Nevada-Las Vegas, 6, 6, 0, 0.50000, 256, 272, -16, 
2004, Nevada-Las Vegas, 2, 9, 0, 0.18182, 229, 357, -128, 
1925, East Tennessee St., 3, 4, 0, 0.42857, 57, 109, -52, 
1926, East Tennessee St., 2, 5, 1, 0.31250, 52, 177, -125, 
1927, East Tennessee St., 3, 7, 0, 0.30000, 60, 168, -108, 
1928, East Tennessee St., 4, 4, 0, 0.50000, 65, 143, -78, 
1929, East Tennessee St., 2, 5, 1, 0.31250, 31, 116, -85, 
1908, Howard (DC), 5, 1, 1, 0.78571, 197, 5, 192, 
1918, Howard (DC), 0, 3, 0, 0.00000, 2, 29, -27, 
1919, Howard (DC), 3, 0, 3, 0.75000, 88, 14, 74, 
1973, Swarthmore (PA), 0, 7, 0, 0.00000, 39, 313, -274, 
1935, Clark Atlanta (GA), 2, 2, 3, 0.50000, 29, 32, -3, 
1936, Clark Atlanta (GA), 2, 6, 0, 0.25000, 30, 92, -62, 
1937, Clark Atlanta (GA), 1, 6, 0, 0.14286, 53, 124, -71, 
1938, Clark Atlanta (GA), 0, 6, 1, 0.07143, 14, 162, -148, 
1939, Clark Atlanta (GA), 3, 4, 0, 0.42857, 86, 46, 40, 
1940, Clark Atlanta (GA), 1, 3, 0, 0.25000, 20, 40, -20, 
1916, Wheaton (IL), 3, 5, 0, 0.37500, 33, 99, -66, 
1917, Mississippi St., 7, 1, 0, 0.87500, 184, 39, 145, 
1918, Mississippi St., 3, 2, 0, 0.60000, 65, 13, 52, 
1919, Mississippi St., 6, 2, 0, 0.75000, 158, 34, 124, 
1923, Mercer (GA), 4, 5, 0, 0.44444, 57, 66, -9, 
1924, Mercer (GA), 5, 3, 2, 0.60000, 110, 89, 21, 
1925, Mercer (GA), 3, 6, 0, 0.33333, 59, 138, -79, 
1927, Morehouse (GA), 5, 5, 1, 0.50000, 94, 151, -57, 
1896, Detroit (MI), 2, 2, 1, 0.50000, 66, 40, 26, 
1897, Detroit (MI), 1, 2, 0, 0.33333, 8, 38, -30, 
1898, Detroit (MI), 5, 0, 0, 1.00000, 91, 12, 79, 
1899, Detroit (MI), 5, 1, 1, 0.78571, 101, 15, 86, 
1964, Hanover (IN), 2, 7, 0, 0.22222, 116, 197, -81, 
1965, Hanover (IN), 1, 8, 0, 0.11111, 116, 233, -117, 
1966, Hanover (IN), 4, 5, 0, 0.44444, 177, 145, 32, 
1967, Hanover (IN), 5, 4, 1, 0.55000, 203, 226, -23, 
2006, Liberty (VA), 6, 5, 0, 0.54545, 259, 172, 87, 
2007, Liberty (VA), 8, 3, 0, 0.72727, 469, 245, 224, 
2008, Liberty (VA), 10, 2, 0, 0.83333, 404, 224, 180, 
2009, Liberty (VA), 8, 3, 0, 0.72727, 400, 210, 190, 
2010, Liberty (VA), 8, 3, 0, 0.72727, 401, 222, 179, 
2011, Liberty (VA), 7, 4, 0, 0.63636, 395, 242, 153, 
2012, Richmond (VA), 8, 3, 0, 0.72727, 365, 237, 128, 
2013, Richmond (VA), 6, 6, 0, 0.50000, 332, 286, 46, 
1927, Rutgers (NJ), 4, 4, 0, 0.50000, 103, 179, -76, 
1928, Rutgers (NJ), 6, 3, 0, 0.66667, 97, 116, -19, 
1929, Rutgers (NJ), 5, 4, 0, 0.55556, 109, 94, 15, 
1930, Rutgers (NJ), 4, 5, 0, 0.44444, 159, 154, 5, 
1942, Rutgers (NJ), 3, 4, 1, 0.43750, 100, 113, -13, 
1943, Rutgers (NJ), 3, 2, 0, 0.60000, 61, 21, 40, 
1944, Rutgers (NJ), 3, 2, 0, 0.60000, 58, 82, -24, 
1945, Rutgers (NJ), 5, 2, 0, 0.71429, 140, 61, 79, 
2013, Point (GA), 3, 7, 0, 0.30000, 214, 382, -168, 
1918, Notre Dame (IN), 3, 1, 2, 0.66667, 133, 39, 94, 
1919, Notre Dame (IN), 9, 0, 0, 1.00000, 229, 47, 182, 
1920, Notre Dame (IN), 9, 0, 0, 1.00000, 251, 44, 207, 
1921, Notre Dame (IN), 10, 1, 0, 0.90909, 375, 41, 334, 
1922, Notre Dame (IN), 8, 1, 1, 0.85000, 222, 27, 195, 
1923, Notre Dame (IN), 9, 1, 0, 0.90000, 275, 37, 238, 
1924, Notre Dame (IN), 10, 0, 0, 1.00000, 285, 54, 231, 
1925, Notre Dame (IN), 7, 2, 1, 0.75000, 200, 64, 136, 
1926, Notre Dame (IN), 9, 1, 0, 0.90000, 210, 38, 172, 
1927, Notre Dame (IN), 7, 1, 1, 0.83333, 158, 57, 101, 
1928, Notre Dame (IN), 5, 4, 0, 0.55556, 99, 107, -8, 
1929, Notre Dame (IN), 9, 0, 0, 1.00000, 145, 38, 107, 
1930, Notre Dame (IN), 10, 0, 0, 1.00000, 265, 74, 191, 
1947, Albion (MI), 0, 8, 0, 0.00000, 26, 207, -181, 
1926, North Dakota, 4, 4, 0, 0.50000, 63, 121, -58, 
1927, North Dakota, 4, 4, 0, 0.50000, 88, 103, -15, 
1928, Louisiana Tech, 2, 7, 0, 0.22222, 48, 235, -187, 
1929, Louisiana Tech, 3, 4, 3, 0.45000, 96, 143, -47, 
1906, Yale (CT), 9, 0, 1, 0.95000, 144, 6, 138, 
1909, Tennessee-Chattanooga, 3, 2, 2, 0.57143, 39, 58, -19, 
1899, Yale (CT), 7, 2, 1, 0.75000, 191, 16, 175, 
1967, Kansas, 5, 5, 0, 0.50000, 166, 146, 20, 
1968, Kansas, 9, 2, 0, 0.81818, 394, 190, 204, 
1969, Kansas, 1, 9, 0, 0.10000, 176, 290, -114, 
1970, Kansas, 5, 6, 0, 0.45455, 270, 277, -7, 
1971, UCLA, 2, 7, 1, 0.25000, 166, 243, -77, 
1972, UCLA, 8, 3, 0, 0.72727, 351, 239, 112, 
1973, UCLA, 9, 2, 0, 0.81818, 470, 199, 271, 
1974, Georgia Tech, 6, 5, 0, 0.54545, 238, 212, 26, 
1975, Georgia Tech, 7, 4, 0, 0.63636, 270, 200, 70, 
1976, Georgia Tech, 4, 6, 1, 0.40909, 221, 267, -46, 
1977, Georgia Tech, 6, 5, 0, 0.54545, 224, 221, 3, 
1978, Georgia Tech, 7, 5, 0, 0.58333, 270, 253, 17, 
1979, Georgia Tech, 4, 6, 1, 0.40909, 152, 190, -38, 
1950, Ouachita Baptist (AR), 2, 6, 1, 0.27778, 126, 189, -63, 
1951, Ouachita Baptist (AR), 0, 10, 0, 0.00000, 46, 376, -330, 
1952, Ouachita Baptist (AR), 2, 5, 1, 0.31250, 142, 211, -69, 
1953, Ouachita Baptist (AR), 7, 1, 0, 0.87500, 194, 79, 115, 
1954, Ouachita Baptist (AR), 3, 6, 0, 0.33333, 130, 194, -64, 
1955, Ouachita Baptist (AR), 2, 6, 1, 0.27778, 93, 178, -85, 
1956, Ouachita Baptist (AR), 3, 5, 1, 0.38889, 107, 173, -66, 
1957, Ouachita Baptist (AR), 1, 9, 0, 0.10000, 70, 298, -228, 
1961, Ouachita Baptist (AR), 4, 4, 1, 0.50000, 154, 114, 40, 
1962, Ouachita Baptist (AR), 4, 5, 0, 0.44444, 105, 103, 2, 
1963, Ouachita Baptist (AR), 6, 4, 0, 0.60000, 184, 164, 20, 
1964, Ouachita Baptist (AR), 4, 5, 1, 0.45000, 91, 141, -50, 
1979, Western Illinois, 3, 8, 0, 0.27273, 145, 230, -85, 
1980, Western Illinois, 4, 6, 0, 0.40000, 201, 247, -46, 
1981, Western Illinois, 5, 6, 0, 0.45455, 175, 223, -48, 
1982, Western Illinois, 2, 8, 0, 0.20000, 139, 263, -124, 
1990, Glenville St. (WV), 1, 7, 1, 0.16667, 147, 310, -163, 
1991, Glenville St. (WV), 4, 5, 1, 0.45000, 253, 231, 22, 
1992, Glenville St. (WV), 6, 4, 0, 0.60000, 334, 199, 135, 
1993, Glenville St. (WV), 10, 3, 0, 0.76923, 426, 177, 249, 
1994, Glenville St. (WV), 8, 3, 0, 0.72727, 416, 291, 125, 
1995, Glenville St. (WV), 8, 2, 0, 0.80000, 345, 123, 222, 
1996, Glenville St. (WV), 6, 4, 0, 0.60000, 348, 309, 39, 
2001, West Virginia, 3, 8, 0, 0.27273, 235, 268, -33, 
2002, West Virginia, 9, 4, 0, 0.69231, 396, 302, 94, 
2003, West Virginia, 8, 5, 0, 0.61538, 376, 297, 79, 
2004, West Virginia, 8, 4, 0, 0.66667, 361, 246, 115, 
2005, West Virginia, 11, 1, 0, 0.91667, 385, 214, 171, 
2006, West Virginia, 11, 2, 0, 0.84615, 505, 282, 223, 
2007, West Virginia, 10, 2, 0, 0.83333, 467, 207, 260, 
2008, Michigan, 3, 9, 0, 0.25000, 243, 347, -104, 
2009, Michigan, 5, 7, 0, 0.41667, 354, 330, 24, 
2010, Michigan, 7, 6, 0, 0.53846, 426, 458, -32, 
2012, Arizona, 8, 5, 0, 0.61538, 496, 459, 37, 
2013, Arizona, 8, 5, 0, 0.61538, 435, 315, 120, 
1965, West Liberty St. (WV), 4, 2, 2, 0.62500, 135, 118, 17, 
1966, West Liberty St. (WV), 5, 2, 1, 0.68750, 211, 98, 113, 
1967, West Liberty St. (WV), 4, 5, 0, 0.44444, 143, 122, 21, 
1968, West Liberty St. (WV), 5, 3, 1, 0.61111, 142, 61, 81, 
1969, West Liberty St. (WV), 6, 3, 0, 0.66667, 208, 88, 120, 
1970, West Liberty St. (WV), 8, 1, 1, 0.85000, 204, 57, 147, 
1971, West Liberty St. (WV), 8, 2, 0, 0.80000, 201, 76, 125, 
1972, West Liberty St. (WV), 7, 2, 0, 0.77778, 206, 103, 103, 
1973, West Liberty St. (WV), 3, 5, 1, 0.38889, 165, 129, 36, 
1914, Saint Francis (PA), 4, 2, 0, 0.66667, 162, 45, 117, 
1931, Delaware, 5, 1, 2, 0.75000, 118, 25, 93, 
1932, Delaware, 5, 4, 0, 0.55556, 55, 77, -22, 
1933, Delaware, 2, 4, 2, 0.37500, 46, 102, -56, 
1924, Delaware Valley (PA), 2, 6, 0, 0.25000, 130, 166, -36, 
1966, Fresno St. (CA), 7, 3, 0, 0.70000, 158, 214, -56, 
1967, Fresno St. (CA), 3, 8, 0, 0.27273, 240, 267, -27, 
1968, Fresno St. (CA), 7, 4, 0, 0.63636, 269, 226, 43, 
1969, Fresno St. (CA), 6, 4, 0, 0.60000, 237, 227, 10, 
1970, Fresno St. (CA), 8, 4, 0, 0.66667, 289, 273, 16, 
1971, Fresno St. (CA), 6, 5, 0, 0.54545, 215, 165, 50, 
1972, Fresno St. (CA), 6, 4, 1, 0.59091, 237, 158, 79, 
1973, San Jose St. (CA), 5, 4, 2, 0.54545, 193, 173, 20, 
1974, San Jose St. (CA), 8, 3, 1, 0.70833, 323, 199, 124, 
1975, San Jose St. (CA), 9, 2, 0, 0.81818, 291, 152, 139, 
1976, Michigan St., 4, 6, 1, 0.40909, 236, 278, -42, 
1977, Michigan St., 7, 3, 1, 0.68182, 260, 162, 98, 
1978, Michigan St., 8, 3, 0, 0.72727, 411, 170, 241, 
1979, Michigan St., 5, 6, 0, 0.45455, 240, 253, -13, 
1980, Arizona St., 7, 4, 0, 0.63636, 311, 216, 95, 
1981, Arizona St., 9, 2, 0, 0.81818, 394, 193, 201, 
1982, Arizona St., 10, 2, 0, 0.83333, 294, 145, 149, 
1983, Arizona St., 6, 4, 1, 0.59091, 320, 200, 120, 
1984, Arizona St., 5, 6, 0, 0.45455, 297, 203, 94, 
1904, Carlisle Indian School (PA), 9, 2, 0, 0.81818, 335, 44, 291, 
1896, Drake (IA), 3, 4, 1, 0.43750, 50, 104, -54, 
1913, Citadel (SC), 3, 4, 2, 0.44444, 217, 121, 96, 
1914, Citadel (SC), 3, 5, 0, 0.37500, 52, 70, -18, 
1915, Citadel (SC), 5, 3, 0, 0.62500, 172, 62, 110, 
1919, Citadel (SC), 4, 4, 1, 0.50000, 86, 120, -34, 
1925, West Virginia, 8, 1, 0, 0.88889, 175, 18, 157, 
1926, West Virginia, 6, 4, 0, 0.60000, 141, 93, 48, 
1927, West Virginia, 2, 4, 3, 0.38889, 68, 129, -61, 
1928, West Virginia, 8, 2, 0, 0.80000, 152, 38, 114, 
1929, West Virginia, 4, 3, 3, 0.55000, 77, 96, -19, 
1930, West Virginia, 5, 5, 0, 0.50000, 111, 103, 8, 
1943, West Virginia, 4, 3, 0, 0.57143, 124, 79, 45, 
1944, West Virginia, 5, 3, 1, 0.61111, 191, 130, 61, 
1945, West Virginia, 2, 6, 1, 0.27778, 122, 126, -4, 
1915, Stevens Tech (NJ), 3, 4, 1, 0.43750, 57, 91, -34, 
1916, Stevens Tech (NJ), 3, 2, 2, 0.57143, 51, 21, 30, 
1917, Stevens Tech (NJ), 5, 0, 2, 0.85714, 130, 19, 111, 
1899, Temple (PA), 1, 4, 1, 0.25000, 27, 127, -100, 
1900, Temple (PA), 3, 4, 1, 0.43750, 95, 69, 26, 
1959, Villanova (PA), 1, 5, 0, 0.16667, 54, 129, -75, 
1998, Kalamazoo (MI), 4, 5, 0, 0.44444, 194, 170, 24, 
1999, Kalamazoo (MI), 3, 6, 0, 0.33333, 136, 168, -32, 
2000, Kalamazoo (MI), 5, 4, 0, 0.55556, 213, 200, 13, 
2001, Kalamazoo (MI), 5, 4, 0, 0.55556, 284, 235, 49, 
2002, Kalamazoo (MI), 5, 5, 0, 0.50000, 335, 267, 68, 
2003, Kalamazoo (MI), 6, 4, 0, 0.60000, 248, 185, 63, 
2005, DePauw (IN), 7, 2, 0, 0.77778, 277, 114, 163, 
1951, Wake Forest (NC), 6, 4, 0, 0.60000, 200, 142, 58, 
1952, Wake Forest (NC), 5, 4, 1, 0.55000, 162, 133, 29, 
1953, Wake Forest (NC), 3, 6, 1, 0.35000, 114, 157, -43, 
1954, Wake Forest (NC), 2, 7, 1, 0.25000, 129, 165, -36, 
1955, Wake Forest (NC), 5, 4, 1, 0.55000, 131, 153, -22, 
1924, Northern Arizona, 4, 4, 0, 0.50000, 236, 95, 141, 
1906, Ouachita Baptist (AR), 0, 2, 0, 0.00000, 0, 76, -76, 
1981, Maine, 3, 7, 1, 0.31818, 186, 283, -97, 
1982, Maine, 7, 4, 0, 0.63636, 344, 242, 102, 
1983, Maine, 4, 6, 0, 0.40000, 223, 208, 15, 
1984, Maine, 5, 6, 0, 0.45455, 152, 243, -91, 
1985, Princeton (NJ), 5, 5, 0, 0.50000, 212, 212, 0, 
1986, Princeton (NJ), 2, 8, 0, 0.20000, 123, 262, -139, 
2013, Frostburg St. (MD), 1, 9, 0, 0.10000, 213, 447, -234, 
2013, Hamline (MN), 2, 8, 0, 0.20000, 150, 376, -226, 
1961, Pacific (CA), 5, 4, 0, 0.55556, 200, 187, 13, 
1962, Pacific (CA), 5, 5, 0, 0.50000, 180, 187, -7, 
1963, Pacific (CA), 2, 8, 0, 0.20000, 99, 275, -176, 
1912, Johns Hopkins (MD), 0, 9, 0, 0.00000, 53, 162, -109, 
1926, Glenville St. (WV), 3, 2, 0, 0.60000, 75, 35, 40, 
1927, Glenville St. (WV), 4, 2, 2, 0.62500, 41, 44, -3, 
1928, Glenville St. (WV), 4, 3, 1, 0.56250, 141, 36, 105, 
1929, Glenville St. (WV), 6, 2, 1, 0.72222, 187, 66, 121, 
1930, Glenville St. (WV), 5, 1, 2, 0.75000, 94, 39, 55, 
1931, Glenville St. (WV), 4, 1, 1, 0.75000, 104, 45, 59, 
1932, Glenville St. (WV), 4, 2, 1, 0.64286, 138, 68, 70, 
1933, Glenville St. (WV), 2, 4, 1, 0.35714, 95, 113, -18, 
1934, Glenville St. (WV), 1, 5, 1, 0.21429, 14, 113, -99, 
1935, Glenville St. (WV), 4, 4, 0, 0.50000, 88, 76, 12, 
1936, Glenville St. (WV), 5, 2, 0, 0.71429, 173, 34, 139, 
1937, Glenville St. (WV), 4, 2, 0, 0.66667, 104, 70, 34, 
1938, Glenville St. (WV), 4, 3, 1, 0.56250, 76, 33, 43, 
1939, Glenville St. (WV), 6, 2, 1, 0.72222, 112, 53, 59, 
1940, Glenville St. (WV), 2, 5, 1, 0.31250, 73, 127, -54, 
1941, Glenville St. (WV), 5, 3, 0, 0.62500, 138, 91, 47, 
1942, Glenville St. (WV), 4, 2, 0, 0.66667, 94, 46, 48, 
1908, Glenville St. (WV), 1, 1, 0, 0.50000, 8, 5, 3, 
2001, Belhaven (MS), 4, 6, 0, 0.40000, 193, 235, -42, 
2002, Belhaven (MS), 5, 6, 0, 0.45455, 227, 258, -31, 
2005, Southeastern Louisiana, 4, 6, 0, 0.40000, 279, 275, 4, 
2006, Southeastern Louisiana, 2, 9, 0, 0.18182, 181, 351, -170, 
1901, Furman (SC), 1, 2, 1, 0.37500, 22, 34, -12, 
1902, Furman (SC), 4, 3, 5, 0.54167, 43, 61, -18, 
1907, Virginia Military Institute, 5, 3, 0, 0.62500, 282, 50, 232, 
1908, Virginia Military Institute, 4, 2, 0, 0.66667, 177, 20, 157, 
1917, Harvard (MA), 3, 1, 3, 0.64286, 75, 14, 61, 
1919, Utah St., 5, 2, 0, 0.71429, 234, 44, 190, 
1920, Utah St., 4, 2, 1, 0.64286, 84, 48, 36, 
1921, Utah St., 7, 1, 0, 0.87500, 151, 82, 69, 
1922, Utah St., 5, 4, 0, 0.55556, 132, 83, 49, 
1923, Utah St., 5, 2, 0, 0.71429, 147, 59, 88, 
1924, Utah St., 4, 2, 1, 0.64286, 127, 52, 75, 
1925, Utah St., 6, 1, 0, 0.85714, 111, 39, 72, 
1926, Utah St., 5, 1, 2, 0.75000, 93, 43, 50, 
1927, Utah St., 3, 4, 1, 0.43750, 129, 53, 76, 
1928, Utah St., 5, 3, 1, 0.61111, 182, 87, 95, 
1929, Utah St., 3, 4, 0, 0.42857, 50, 60, -10, 
1930, Utah St., 3, 5, 1, 0.38889, 73, 205, -132, 
1931, Utah St., 6, 2, 0, 0.75000, 147, 72, 75, 
1932, Utah St., 4, 4, 0, 0.50000, 123, 105, 18, 
1933, Utah St., 5, 4, 0, 0.55556, 148, 63, 85, 
1934, Utah St., 6, 1, 1, 0.81250, 162, 42, 120, 
1935, Utah St., 5, 2, 1, 0.68750, 165, 73, 92, 
1936, Utah St., 7, 0, 1, 0.93750, 99, 13, 86, 
1937, Utah St., 2, 4, 2, 0.37500, 47, 152, -105, 
1938, Utah St., 4, 4, 0, 0.50000, 85, 87, -2, 
1939, Utah St., 3, 4, 1, 0.43750, 76, 81, -5, 
1940, Utah St., 2, 5, 1, 0.31250, 48, 104, -56, 
1941, Utah St., 0, 8, 0, 0.00000, 46, 153, -107, 
1942, Utah St., 6, 3, 1, 0.65000, 201, 137, 64, 
1944, Utah St., 3, 3, 0, 0.50000, 88, 109, -21, 
1945, Utah St., 4, 3, 0, 0.57143, 173, 92, 81, 
1946, Utah St., 7, 2, 1, 0.75000, 219, 75, 144, 
1947, Utah St., 6, 5, 0, 0.54545, 228, 210, 18, 
1948, Utah St., 5, 6, 0, 0.45455, 196, 238, -42, 
1922, Montana St., 4, 4, 0, 0.50000, 128, 127, 1, 
1923, Montana St., 5, 4, 0, 0.55556, 272, 76, 196, 
1924, Montana St., 5, 1, 1, 0.78571, 274, 18, 256, 
1925, Montana St., 6, 5, 0, 0.54545, 291, 84, 207, 
1926, Montana St., 4, 2, 1, 0.64286, 52, 43, 9, 
1927, Montana St., 4, 4, 0, 0.50000, 77, 104, -27, 
1928, Brigham Young (UT), 3, 3, 1, 0.50000, 75, 56, 19, 
1929, Brigham Young (UT), 6, 3, 1, 0.65000, 184, 122, 62, 
1930, Brigham Young (UT), 6, 2, 4, 0.66667, 207, 179, 28, 
1931, Brigham Young (UT), 4, 4, 0, 0.50000, 69, 104, -35, 
1932, Brigham Young (UT), 8, 1, 0, 0.88889, 188, 50, 138, 
1933, Brigham Young (UT), 5, 4, 0, 0.55556, 81, 67, 14, 
1934, Brigham Young (UT), 4, 5, 0, 0.44444, 144, 169, -25, 
1935, Brigham Young (UT), 4, 4, 0, 0.50000, 78, 90, -12, 
1936, Brigham Young (UT), 4, 5, 0, 0.44444, 123, 123, 0, 
1951, Utah St., 3, 5, 1, 0.38889, 161, 183, -22, 
1952, Utah St., 3, 7, 1, 0.31818, 121, 209, -88, 
1953, Utah St., 8, 3, 0, 0.72727, 207, 139, 68, 
1954, Utah St., 4, 6, 0, 0.40000, 158, 187, -29, 
1955, Denver (CO), 8, 2, 0, 0.80000, 310, 89, 221, 
1956, Denver (CO), 6, 4, 0, 0.60000, 250, 206, 44, 
1957, Denver (CO), 6, 4, 0, 0.60000, 150, 155, -5, 
1958, Denver (CO), 2, 8, 0, 0.20000, 135, 163, -28, 
1959, Denver (CO), 2, 8, 0, 0.20000, 104, 230, -126, 
1960, Denver (CO), 3, 7, 0, 0.30000, 133, 300, -167, 
2003, Duke (NC), 2, 3, 0, 0.40000, 105, 130, -25, 
2004, Duke (NC), 2, 9, 0, 0.18182, 183, 322, -139, 
2005, Duke (NC), 1, 10, 0, 0.09091, 177, 408, -231, 
2006, Duke (NC), 0, 12, 0, 0.00000, 179, 406, -227, 
2007, Duke (NC), 1, 11, 0, 0.08333, 215, 398, -183, 
1946, Davis & Elkins (WV), 3, 5, 2, 0.40000, 59, 121, -62, 
1964, North Park (IL), 0, 8, 0, 0.00000, 80, 251, -171, 
1965, North Park (IL), 2, 6, 0, 0.25000, 47, 172, -125, 
1966, North Park (IL), 0, 7, 1, 0.06250, 128, 208, -80, 
1968, New Hampshire, 6, 2, 0, 0.75000, 155, 79, 76, 
1969, New Hampshire, 3, 5, 0, 0.37500, 92, 162, -70, 
1970, New Hampshire, 5, 3, 0, 0.62500, 212, 148, 64, 
1971, New Hampshire, 4, 4, 1, 0.50000, 194, 191, 3, 
1972, William & Mary (VA), 5, 6, 0, 0.45455, 261, 191, 70, 
1973, William & Mary (VA), 6, 5, 0, 0.54545, 278, 288, -10, 
1974, William & Mary (VA), 4, 7, 0, 0.36364, 211, 269, -58, 
1975, William & Mary (VA), 2, 9, 0, 0.18182, 95, 261, -166, 
1976, William & Mary (VA), 7, 4, 0, 0.63636, 210, 149, 61, 
1977, William & Mary (VA), 6, 5, 0, 0.54545, 205, 203, 2, 
1978, William & Mary (VA), 5, 5, 1, 0.50000, 170, 161, 9, 
1979, William & Mary (VA), 4, 7, 0, 0.36364, 139, 226, -87, 
1933, Yale (CT), 4, 4, 0, 0.50000, 64, 100, -36, 
1903, Virginia Military Institute, 2, 1, 0, 0.66667, 36, 28, 8, 
1904, Virginia Military Institute, 3, 5, 0, 0.37500, 70, 70, 0, 
1906, Princeton (NJ), 9, 0, 1, 0.95000, 205, 9, 196, 
1907, Princeton (NJ), 7, 2, 0, 0.77778, 282, 23, 259, 
1908, Princeton (NJ), 5, 2, 3, 0.65000, 84, 25, 59, 
1909, Missouri, 7, 0, 1, 0.93750, 86, 36, 50, 
1910, Princeton (NJ), 7, 1, 0, 0.87500, 101, 5, 96, 
1911, Princeton (NJ), 8, 0, 2, 0.90000, 179, 15, 164, 
1915, Swarthmore (PA), 5, 3, 0, 0.62500, 94, 77, 17, 
1916, Swarthmore (PA), 6, 1, 1, 0.81250, 94, 45, 49, 
1919, Princeton (NJ), 4, 2, 1, 0.64286, 94, 54, 40, 
1920, Princeton (NJ), 6, 0, 1, 0.92857, 144, 23, 121, 
1921, Princeton (NJ), 4, 3, 0, 0.57143, 91, 45, 46, 
1922, Princeton (NJ), 8, 0, 0, 1.00000, 127, 34, 93, 
1923, Princeton (NJ), 3, 3, 1, 0.50000, 73, 73, 0, 
1924, Princeton (NJ), 4, 2, 1, 0.64286, 112, 48, 64, 
1925, Princeton (NJ), 5, 1, 1, 0.78571, 125, 44, 81, 
1926, Princeton (NJ), 5, 1, 1, 0.78571, 90, 54, 36, 
1927, Princeton (NJ), 6, 1, 0, 0.85714, 151, 31, 120, 
1928, Princeton (NJ), 5, 1, 2, 0.75000, 143, 29, 114, 
1929, Princeton (NJ), 2, 4, 1, 0.35714, 66, 67, -1, 
1930, Princeton (NJ), 1, 5, 1, 0.21429, 46, 73, -27, 
1904, Charleston (WV), 3, 0, 0, 1.00000, 90, 0, 90, 
1905, Charleston (WV), 0, 1, 0, 0.00000, 0, 39, -39, 
1906, Charleston (WV), 0, 1, 0, 0.00000, 5, 12, -7, 
1907, Charleston (WV), 2, 3, 0, 0.40000, 86, 97, -11, 
1904, George Washington (DC), 4, 2, 2, 0.62500, 52, 68, -16, 
1901, New York (NY), 4, 3, 1, 0.56250, 134, 66, 68, 
1902, New York (NY), 8, 3, 0, 0.72727, 117, 78, 39, 
2009, Hampton (VA), 5, 6, 0, 0.45455, 215, 213, 2, 
2010, Hampton (VA), 6, 5, 0, 0.54545, 192, 202, -10, 
2011, Hampton (VA), 7, 4, 0, 0.63636, 312, 240, 72, 
2012, Hampton (VA), 3, 7, 0, 0.30000, 217, 304, -87, 
2013, Hampton (VA), 4, 8, 0, 0.33333, 261, 368, -107, 
1944, Arkansas, 5, 5, 1, 0.50000, 120, 161, -41, 
1945, Arkansas, 3, 7, 0, 0.30000, 112, 222, -110, 
1981, Livingstone (NC), 3, 7, 0, 0.30000, 113, 171, -58, 
1982, Livingstone (NC), 5, 5, 0, 0.50000, 236, 213, 23, 
1983, Livingstone (NC), 5, 4, 0, 0.55556, 204, 187, 17, 
1984, Livingstone (NC), 3, 7, 0, 0.30000, 232, 213, 19, 
1992, Virginia Union, 3, 5, 1, 0.38889, 161, 328, -167, 
1983, Miami (OH), 4, 7, 0, 0.36364, 152, 189, -37, 
1984, Miami (OH), 4, 7, 0, 0.36364, 175, 221, -46, 
1985, Miami (OH), 8, 2, 1, 0.77273, 266, 211, 55, 
1986, Miami (OH), 8, 4, 0, 0.66667, 346, 228, 118, 
1987, Miami (OH), 5, 6, 0, 0.45455, 180, 235, -55, 
1988, Miami (OH), 0, 10, 1, 0.04545, 167, 361, -194, 
1989, Miami (OH), 2, 8, 1, 0.22727, 122, 262, -140, 
1984, Brown (RI), 4, 5, 0, 0.44444, 165, 231, -66, 
1985, Brown (RI), 5, 4, 1, 0.55000, 200, 128, 72, 
1986, Brown (RI), 5, 4, 1, 0.55000, 188, 181, 7, 
1987, Brown (RI), 7, 3, 0, 0.70000, 144, 160, -16, 
1988, Brown (RI), 0, 9, 1, 0.05000, 125, 285, -160, 
1989, Brown (RI), 2, 8, 0, 0.20000, 170, 265, -95, 
1948, Brooklyn (NY), 7, 2, 0, 0.77778, 234, 89, 145, 
1949, Brooklyn (NY), 1, 6, 1, 0.18750, 102, 182, -80, 
1950, Brooklyn (NY), 1, 5, 0, 0.16667, 44, 201, -157, 
1951, Brooklyn (NY), 0, 5, 0, 0.00000, 13, 239, -226, 
1952, Brooklyn (NY), 0, 6, 1, 0.07143, 53, 262, -209, 
1953, Brooklyn (NY), 0, 7, 0, 0.00000, 14, 229, -215, 
1973, Citadel (SC), 3, 8, 0, 0.27273, 137, 250, -113, 
1974, Citadel (SC), 4, 7, 0, 0.36364, 216, 248, -32, 
1975, Citadel (SC), 6, 5, 0, 0.54545, 144, 97, 47, 
1976, Citadel (SC), 6, 5, 0, 0.54545, 171, 176, -5, 
1977, Citadel (SC), 5, 6, 0, 0.45455, 133, 162, -29, 
1982, Maryland, 8, 4, 0, 0.66667, 373, 220, 153, 
1983, Maryland, 8, 4, 0, 0.66667, 316, 253, 63, 
1984, Maryland, 9, 3, 0, 0.75000, 380, 280, 100, 
1985, Maryland, 9, 3, 0, 0.75000, 326, 192, 134, 
1986, Maryland, 5, 5, 1, 0.50000, 262, 211, 51, 
1987, Georgia Tech, 2, 9, 0, 0.18182, 199, 275, -76, 
1988, Georgia Tech, 3, 8, 0, 0.27273, 200, 194, 6, 
1989, Georgia Tech, 7, 4, 0, 0.63636, 265, 213, 52, 
1990, Georgia Tech, 11, 0, 1, 0.95833, 379, 186, 193, 
1991, Georgia Tech, 8, 5, 0, 0.61538, 283, 214, 69, 
2004, Army (NY), 2, 9, 0, 0.18182, 260, 388, -128, 
2005, Army (NY), 4, 7, 0, 0.36364, 220, 294, -74, 
2006, Army (NY), 3, 9, 0, 0.25000, 232, 335, -103, 
1925, West Virginia Wesleyan, 5, 3, 0, 0.62500, 51, 40, 11, 
1926, West Virginia Wesleyan, 4, 6, 0, 0.40000, 79, 155, -76, 
1927, West Virginia Wesleyan, 3, 6, 1, 0.35000, 123, 181, -58, 
1928, West Virginia Wesleyan, 5, 6, 0, 0.45455, 154, 143, 11, 
1929, West Virginia Wesleyan, 4, 6, 0, 0.40000, 184, 123, 61, 
1930, West Virginia Wesleyan, 4, 5, 2, 0.45455, 134, 202, -68, 
1931, West Virginia Wesleyan, 6, 3, 1, 0.65000, 153, 114, 39, 
1932, West Virginia Wesleyan, 4, 4, 1, 0.50000, 101, 102, -1, 
1933, West Virginia Wesleyan, 4, 7, 0, 0.36364, 113, 158, -45, 
1934, West Virginia Wesleyan, 6, 3, 1, 0.65000, 175, 99, 76, 
1935, West Virginia Wesleyan, 7, 2, 1, 0.75000, 116, 81, 35, 
1936, West Virginia Wesleyan, 8, 2, 0, 0.80000, 135, 52, 83, 
1937, West Virginia Wesleyan, 1, 7, 1, 0.16667, 20, 133, -113, 
1938, West Virginia Wesleyan, 3, 5, 0, 0.37500, 32, 135, -103, 
1939, West Virginia Wesleyan, 1, 8, 0, 0.11111, 53, 270, -217, 
1940, West Virginia Wesleyan, 3, 5, 0, 0.37500, 52, 140, -88, 
1941, West Virginia Wesleyan, 3, 4, 1, 0.43750, 115, 93, 22, 
1942, Charleston (WV), 6, 1, 2, 0.77778, 77, 13, 64, 
1946, West Virginia Wesleyan, 6, 3, 0, 0.66667, 133, 97, 36, 
1947, West Virginia Wesleyan, 6, 2, 0, 0.75000, 104, 20, 84, 
1948, West Virginia Wesleyan, 4, 4, 2, 0.50000, 128, 133, -5, 
1949, West Virginia Wesleyan, 1, 9, 1, 0.13636, 76, 334, -258, 
1950, West Virginia Wesleyan, 1, 8, 0, 0.11111, 100, 317, -217, 
1971, Beloit (WI), 1, 8, 0, 0.11111, 71, 364, -293, 
1972, Beloit (WI), 0, 8, 1, 0.05556, 97, 208, -111, 
1973, Beloit (WI), 1, 8, 0, 0.11111, 64, 258, -194, 
1974, Beloit (WI), 2, 7, 0, 0.22222, 109, 310, -201, 
1975, Beloit (WI), 3, 6, 0, 0.33333, 149, 192, -43, 
2001, Bacone (OK), 5, 5, 0, 0.50000, 169, 323, -154, 
2002, Bacone (OK), 6, 5, 0, 0.54545, 259, 323, -64, 
2003, Bacone (OK), 5, 7, 0, 0.41667, 300, 388, -88, 
2004, Bacone (OK), 7, 3, 0, 0.70000, 303, 222, 81, 
2005, Bacone (OK), 4, 6, 0, 0.40000, 180, 263, -83, 
2012, Misericordia (PA), 0, 10, 0, 0.00000, 54, 516, -462, 
2013, Misericordia (PA), 1, 9, 0, 0.10000, 244, 429, -185, 
1922, Alcorn St. (MS), 0, 1, 0, 0.00000, 12, 49, -37, 
1923, Alcorn St. (MS), 0, 1, 0, 0.00000, 9, 30, -21, 
1924, Alcorn St. (MS), 0, 2, 0, 0.00000, 18, 75, -57, 
1925, Alcorn St. (MS), 0, 1, 1, 0.25000, 0, 38, -38, 
1926, Alcorn St. (MS), 3, 2, 1, 0.58333, 56, 39, 17, 
1927, Alcorn St. (MS), 1, 2, 1, 0.37500, 76, 33, 43, 
1928, Alcorn St. (MS), 8, 0, 1, 0.94444, 245, 18, 227, 
1929, Alcorn St. (MS), 4, 3, 2, 0.55556, 102, 59, 43, 
1930, Alcorn St. (MS), 5, 3, 0, 0.62500, 137, 145, -8, 
1931, Alcorn St. (MS), 1, 4, 1, 0.25000, 68, 96, -28, 
1932, Alcorn St. (MS), 5, 1, 1, 0.78571, 252, 44, 208, 
1933, Alcorn St. (MS), 5, 0, 1, 0.91667, 59, 12, 47, 
2004, Lindenwood (MO), 11, 1, 0, 0.91667, 337, 152, 185, 
2005, Lindenwood (MO), 7, 4, 0, 0.63636, 287, 200, 87, 
2006, Lindenwood (MO), 5, 7, 0, 0.41667, 257, 255, 2, 
2007, Lindenwood (MO), 10, 2, 0, 0.83333, 442, 245, 197, 
2008, Lindenwood (MO), 11, 2, 0, 0.84615, 521, 270, 251, 
2009, Lindenwood (MO), 13, 1, 0, 0.92857, 744, 285, 459, 
2010, Lindenwood (MO), 9, 2, 0, 0.81818, 577, 230, 347, 
2011, Lindenwood (MO), 8, 3, 0, 0.72727, 443, 260, 183, 
2012, Lindenwood (MO), 8, 4, 0, 0.66667, 373, 295, 78, 
2013, Lindenwood (MO), 3, 6, 0, 0.33333, 199, 330, -131, 
1958, West Virginia Wesleyan, 2, 4, 2, 0.37500, 63, 115, -52, 
1959, West Virginia Wesleyan, 6, 2, 0, 0.75000, 121, 65, 56, 
1960, West Virginia Wesleyan, 6, 2, 0, 0.75000, 149, 92, 57, 
1961, West Virginia Wesleyan, 8, 1, 0, 0.88889, 243, 64, 179, 
1991, Southern Methodist (TX), 1, 10, 0, 0.09091, 141, 359, -218, 
1992, Southern Methodist (TX), 5, 6, 0, 0.45455, 212, 276, -64, 
1993, Southern Methodist (TX), 2, 7, 2, 0.27273, 206, 277, -71, 
1994, Southern Methodist (TX), 1, 9, 1, 0.13636, 197, 343, -146, 
1995, Southern Methodist (TX), 1, 10, 0, 0.09091, 132, 352, -220, 
1996, Southern Methodist (TX), 5, 6, 0, 0.45455, 246, 267, -21, 
2009, New Haven (CT), 5, 5, 0, 0.50000, 264, 319, -55, 
2010, New Haven (CT), 8, 2, 0, 0.80000, 316, 214, 102, 
2011, New Haven (CT), 11, 2, 0, 0.84615, 523, 307, 216, 
2012, New Haven (CT), 10, 1, 0, 0.90909, 421, 154, 267, 
2013, New Haven (CT), 8, 3, 0, 0.72727, 447, 273, 174, 
1990, Salisbury (MD), 1, 8, 0, 0.11111, 131, 261, -130, 
1991, Salisbury (MD), 1, 9, 0, 0.10000, 157, 276, -119, 
1992, Salisbury (MD), 2, 7, 0, 0.22222, 147, 310, -163, 
1993, Salisbury (MD), 2, 7, 0, 0.22222, 184, 296, -112, 
1994, Salisbury (MD), 2, 7, 0, 0.22222, 235, 300, -65, 
1995, Salisbury (MD), 7, 3, 0, 0.70000, 231, 166, 65, 
1996, Salisbury (MD), 4, 5, 0, 0.44444, 191, 161, 30, 
1997, Salisbury (MD), 3, 6, 0, 0.33333, 113, 176, -63, 
1998, Salisbury (MD), 3, 7, 0, 0.30000, 213, 252, -39, 
1906, Colorado St., 1, 2, 1, 0.37500, 4, 21, -17, 
1907, Colorado St., 0, 4, 0, 0.00000, 17, 77, -60, 
1908, Colorado St., 1, 3, 0, 0.25000, 30, 58, -28, 
1909, Colorado St., 1, 2, 0, 0.33333, 38, 91, -53, 
1928, Rice (TX), 2, 7, 0, 0.22222, 83, 174, -91, 
1927, Delaware, 2, 5, 1, 0.31250, 18, 104, -86, 
1928, Delaware, 2, 6, 0, 0.25000, 44, 144, -100, 
1903, Colorado St., 5, 1, 0, 0.83333, 67, 24, 43, 
1983, American International (MA), 4, 7, 0, 0.36364, 133, 174, -41, 
1984, American International (MA), 4, 6, 0, 0.40000, 160, 230, -70, 
1985, American International (MA), 8, 2, 0, 0.80000, 259, 122, 137, 
1986, American International (MA), 6, 4, 0, 0.60000, 301, 207, 94, 
1987, American International (MA), 3, 5, 2, 0.40000, 230, 293, -63, 
1988, American International (MA), 5, 5, 0, 0.50000, 266, 265, 1, 
1989, American International (MA), 7, 3, 0, 0.70000, 259, 151, 108, 
1990, American International (MA), 7, 3, 0, 0.70000, 287, 250, 37, 
1991, American International (MA), 4, 5, 1, 0.45000, 222, 198, 24, 
1992, American International (MA), 4, 6, 0, 0.40000, 213, 284, -71, 
1950, Albany St. (GA), 2, 5, 2, 0.33333, 81, 137, -56, 
1958, Louisiana-Monroe, 6, 3, 0, 0.66667, 189, 163, 26, 
1959, Louisiana-Monroe, 2, 8, 0, 0.20000, 116, 216, -100, 
1960, Louisiana-Monroe, 3, 7, 0, 0.30000, 91, 136, -45, 
1961, Louisiana-Monroe, 3, 7, 0, 0.30000, 145, 171, -26, 
1962, Louisiana-Monroe, 2, 6, 0, 0.25000, 74, 106, -32, 
1963, Louisiana-Monroe, 4, 6, 0, 0.40000, 113, 141, -28, 
1904, Idaho St., 1, 3, 0, 0.25000, 10, 54, -44, 
1903, Kalamazoo (MI), 6, 2, 0, 0.75000, 138, 35, 103, 
1909, Elon (NC), 4, 2, 1, 0.64286, 77, 90, -13, 
1910, Wake Forest (NC), 2, 7, 0, 0.22222, 53, 154, -101, 
1941, Howard (DC), 3, 3, 0, 0.50000, 72, 69, 3, 
1942, Howard (DC), 1, 4, 2, 0.28571, 26, 64, -38, 
1925, Henderson St. (AR), 4, 5, 1, 0.45000, 52, 130, -78, 
1926, Henderson St. (AR), 5, 3, 0, 0.62500, 156, 43, 113, 
1927, Henderson St. (AR), 7, 0, 1, 0.93750, 163, 26, 137, 
1928, Henderson St. (AR), 8, 0, 1, 0.94444, 216, 38, 178, 
1929, Henderson St. (AR), 6, 1, 1, 0.81250, 191, 51, 140, 
1930, Henderson St. (AR), 8, 1, 0, 0.88889, 246, 33, 213, 
1931, Ouachita Baptist (AR), 6, 2, 1, 0.72222, 145, 51, 94, 
1940, Citadel (SC), 4, 5, 0, 0.44444, 123, 135, -12, 
1941, Citadel (SC), 4, 3, 1, 0.56250, 175, 89, 86, 
1942, Citadel (SC), 5, 2, 0, 0.71429, 135, 64, 71, 
1948, George Washington (DC), 4, 6, 0, 0.40000, 93, 226, -133, 
1949, George Washington (DC), 4, 5, 0, 0.44444, 135, 184, -49, 
1950, George Washington (DC), 5, 4, 0, 0.55556, 146, 135, 11, 
1951, George Washington (DC), 2, 6, 1, 0.27778, 128, 226, -98, 
1954, Mississippi St., 6, 4, 0, 0.60000, 192, 120, 72, 
1955, Mississippi St., 6, 4, 0, 0.60000, 173, 142, 31, 
1956, Washington, 5, 5, 0, 0.50000, 232, 206, 26, 
1957, Texas, 6, 4, 1, 0.59091, 159, 149, 10, 
1958, Texas, 7, 3, 0, 0.70000, 157, 152, 5, 
1959, Texas, 9, 2, 0, 0.81818, 216, 96, 120, 
1960, Texas, 7, 3, 1, 0.68182, 167, 78, 89, 
1961, Texas, 10, 1, 0, 0.90909, 303, 66, 237, 
1962, Texas, 9, 1, 1, 0.86364, 184, 72, 112, 
1963, Texas, 11, 0, 0, 1.00000, 243, 71, 172, 
1964, Texas, 10, 1, 0, 0.90909, 220, 81, 139, 
1965, Texas, 6, 4, 0, 0.60000, 231, 153, 78, 
1966, Texas, 7, 4, 0, 0.63636, 194, 111, 83, 
1967, Texas, 6, 4, 0, 0.60000, 186, 123, 63, 
1968, Texas, 9, 1, 1, 0.86364, 379, 198, 181, 
1969, Texas, 11, 0, 0, 1.00000, 435, 119, 316, 
1970, Texas, 10, 1, 0, 0.90909, 423, 149, 274, 
1971, Texas, 8, 3, 0, 0.72727, 281, 168, 113, 
1972, Texas, 10, 1, 0, 0.90909, 271, 121, 150, 
1973, Texas, 8, 3, 0, 0.72727, 367, 162, 205, 
1974, Texas, 8, 4, 0, 0.66667, 367, 197, 170, 
1975, Texas, 10, 2, 0, 0.83333, 401, 181, 220, 
1976, Texas, 5, 5, 1, 0.50000, 195, 188, 7, 
1949, West Virginia Tech, 8, 0, 1, 0.94444, 243, 84, 159, 
1950, West Virginia Tech, 6, 3, 1, 0.65000, 222, 172, 50, 
1953, Marshall (WV), 2, 5, 2, 0.33333, 109, 180, -71, 
1954, Marshall (WV), 4, 5, 0, 0.44444, 203, 214, -11, 
1955, Marshall (WV), 3, 6, 0, 0.33333, 159, 192, -33, 
1956, Marshall (WV), 3, 6, 0, 0.33333, 122, 185, -63, 
1957, Marshall (WV), 6, 3, 0, 0.66667, 120, 112, 8, 
1958, Marshall (WV), 3, 6, 0, 0.33333, 111, 165, -54, 
1973, Liberty (VA), 3, 3, 0, 0.50000, 145, 115, 30, 
1970, Adelphi (NY), 2, 6, 1, 0.27778, 93, 267, -174, 
1971, Adelphi (NY), 1, 7, 0, 0.12500, 71, 226, -155, 
2011, Bacone (OK), 5, 6, 0, 0.45455, 281, 284, -3, 
2012, Bacone (OK), 7, 4, 0, 0.63636, 321, 198, 123, 
2013, Bacone (OK), 7, 4, 0, 0.63636, 368, 305, 63, 
1891, Richmond (VA), 0, 2, 0, 0.00000, 8, 24, -16, 
1893, Richmond (VA), 3, 2, 0, 0.60000, 62, 72, -10, 
1894, Richmond (VA), 0, 4, 2, 0.16667, 4, 142, -138, 
1895, Richmond (VA), 0, 5, 1, 0.08333, 4, 196, -192, 
1990, North Park (IL), 1, 8, 0, 0.11111, 175, 426, -251, 
1991, North Park (IL), 0, 9, 0, 0.00000, 61, 368, -307, 
1992, North Park (IL), 1, 6, 2, 0.22222, 87, 216, -129, 
1993, North Park (IL), 4, 4, 1, 0.50000, 179, 213, -34, 
1994, North Park (IL), 3, 6, 0, 0.33333, 102, 242, -140, 
1995, Carthage (WI), 3, 5, 1, 0.38889, 118, 237, -119, 
1996, Carthage (WI), 3, 6, 0, 0.33333, 160, 243, -83, 
1997, Carthage (WI), 5, 4, 0, 0.55556, 196, 157, 39, 
1998, Carthage (WI), 5, 4, 0, 0.55556, 152, 180, -28, 
1999, Carthage (WI), 5, 4, 0, 0.55556, 173, 178, -5, 
2000, Carthage (WI), 4, 6, 0, 0.40000, 250, 274, -24, 
2001, Carthage (WI), 6, 4, 0, 0.60000, 201, 214, -13, 
2002, Carthage (WI), 4, 6, 0, 0.40000, 288, 247, 41, 
2003, Carthage (WI), 3, 7, 0, 0.30000, 232, 257, -25, 
2004, Carthage (WI), 11, 2, 0, 0.84615, 369, 233, 136, 
2005, Carthage (WI), 7, 3, 0, 0.70000, 249, 143, 106, 
2006, Carthage (WI), 6, 4, 0, 0.60000, 215, 198, 17, 
2007, Carthage (WI), 7, 3, 0, 0.70000, 307, 273, 34, 
2008, Carthage (WI), 5, 5, 0, 0.50000, 305, 307, -2, 
2009, Carthage (WI), 7, 3, 0, 0.70000, 370, 344, 26, 
2010, Carthage (WI), 6, 4, 0, 0.60000, 305, 270, 35, 
2011, Carthage (WI), 5, 5, 0, 0.50000, 181, 182, -1, 
2012, Carthage (WI), 3, 4, 0, 0.42857, 130, 190, -60, 
1911, Delaware Valley (PA), 0, 2, 0, 0.00000, 0, 38, -38, 
2013, Minot St. (ND), 2, 9, 0, 0.18182, 167, 374, -207, 
1918, East Stroudsburg (PA), 4, 1, 0, 0.80000, 83, 16, 67, 
1950, Saint Mary's (CA), 2, 7, 1, 0.25000, 95, 235, -140, 
2011, Miles (AL), 7, 5, 0, 0.58333, 277, 253, 24, 
2012, Miles (AL), 8, 3, 0, 0.72727, 377, 204, 173, 
2013, Miles (AL), 6, 4, 0, 0.60000, 248, 251, -3, 
1997, Glenville St. (WV), 9, 3, 0, 0.75000, 465, 311, 154, 
1998, Glenville St. (WV), 6, 5, 0, 0.54545, 275, 210, 65, 
1898, DePauw (IN), 3, 4, 2, 0.44444, 91, 107, -16, 
1986, Saint Mary's (CA), 5, 5, 0, 0.50000, 232, 238, -6, 
1987, Saint Mary's (CA), 8, 3, 0, 0.72727, 281, 195, 86, 
1988, Saint Mary's (CA), 10, 0, 0, 1.00000, 329, 149, 180, 
1989, Saint Mary's (CA), 6, 4, 0, 0.60000, 262, 177, 85, 
1997, Albion (MI), 6, 3, 0, 0.66667, 284, 155, 129, 
1998, Albion (MI), 8, 2, 0, 0.80000, 362, 141, 221, 
1999, Albion (MI), 6, 3, 0, 0.66667, 232, 177, 55, 
2000, Albion (MI), 7, 3, 0, 0.70000, 328, 185, 143, 
2001, Albion (MI), 8, 2, 0, 0.80000, 301, 201, 100, 
2002, Albion (MI), 5, 5, 0, 0.50000, 212, 240, -28, 
2003, Albion (MI), 6, 4, 0, 0.60000, 210, 186, 24, 
2004, Albion (MI), 7, 3, 0, 0.70000, 276, 218, 58, 
2005, Albion (MI), 7, 4, 0, 0.63636, 402, 192, 210, 
2006, Albion (MI), 5, 5, 0, 0.50000, 250, 227, 23, 
2007, Albion (MI), 2, 8, 0, 0.20000, 204, 262, -58, 
2008, Albion (MI), 4, 6, 0, 0.40000, 143, 201, -58, 
2009, Albion (MI), 4, 6, 0, 0.40000, 187, 207, -20, 
2010, Albion (MI), 5, 5, 0, 0.50000, 245, 279, -34, 
2011, Albion (MI), 6, 5, 0, 0.54545, 253, 255, -2, 
2012, Albion (MI), 6, 4, 0, 0.60000, 263, 176, 87, 
2013, Albion (MI), 8, 3, 0, 0.72727, 272, 340, -68, 
1969, Towson (MD), 4, 4, 1, 0.50000, 267, 147, 120, 
1970, Towson (MD), 6, 2, 0, 0.75000, 216, 90, 126, 
1971, Towson (MD), 1, 8, 0, 0.11111, 45, 249, -204, 
1960, Toledo (OH), 2, 7, 0, 0.22222, 126, 192, -66, 
1961, Toledo (OH), 3, 7, 0, 0.30000, 146, 170, -24, 
1962, Toledo (OH), 3, 6, 0, 0.33333, 133, 176, -43, 
1976, Merchant Marine (NY), 8, 1, 0, 0.88889, 170, 85, 85, 
1915, Princeton (NJ), 6, 2, 0, 0.75000, 136, 33, 103, 
1916, Princeton (NJ), 6, 2, 0, 0.75000, 135, 16, 119, 
1919, Cornell (NY), 3, 5, 0, 0.37500, 34, 95, -61, 
1985, Lambuth (TN), 1, 7, 0, 0.12500, 93, 273, -180, 
1986, Lambuth (TN), 1, 8, 0, 0.11111, 98, 228, -130, 
2013, Guilford (NC), 6, 4, 0, 0.60000, 277, 291, -14, 
1982, Clarion (PA), 7, 3, 0, 0.70000, 221, 176, 45, 
1906, Tulane (LA), 0, 4, 1, 0.10000, 0, 92, -92, 
1908, Colorado School of Mines, 2, 3, 0, 0.40000, 42, 59, -17, 
1907, West Virginia, 6, 4, 0, 0.60000, 236, 38, 198, 
1914, New Mexico St., 4, 2, 1, 0.64286, 80, 29, 51, 
1915, New Mexico St., 5, 2, 0, 0.71429, 85, 19, 66, 
1916, New Mexico St., 2, 4, 1, 0.35714, 64, 153, -89, 
1925, Saint Francis (PA), 5, 1, 1, 0.78571, 136, 14, 122, 
1982, Georgia Southern, 7, 3, 1, 0.68182, 290, 190, 100, 
1983, Georgia Southern, 6, 5, 0, 0.54545, 262, 197, 65, 
1984, Georgia Southern, 8, 3, 0, 0.72727, 342, 215, 127, 
1985, Georgia Southern, 13, 2, 0, 0.86667, 460, 293, 167, 
1986, Georgia Southern, 13, 2, 0, 0.86667, 619, 382, 237, 
1987, Georgia Southern, 9, 4, 0, 0.69231, 283, 220, 63, 
1988, Georgia Southern, 12, 3, 0, 0.80000, 469, 214, 255, 
1989, Georgia Southern, 15, 0, 0, 1.00000, 584, 221, 363, 
1912, Illinois St., 0, 4, 1, 0.10000, 10, 140, -130, 
1913, Illinois St., 1, 5, 1, 0.21429, 95, 131, -36, 
1914, Illinois St., 2, 3, 1, 0.41667, 94, 41, 53, 
1915, Illinois St., 2, 4, 1, 0.35714, 61, 71, -10, 
1916, Illinois St., 2, 5, 0, 0.28571, 44, 130, -86, 
1917, Illinois St., 3, 4, 0, 0.42857, 66, 87, -21, 
1919, Illinois St., 0, 6, 1, 0.07143, 16, 164, -148, 
1920, Illinois St., 1, 5, 1, 0.21429, 55, 232, -177, 
1921, Illinois St., 3, 3, 1, 0.50000, 156, 67, 89, 
1922, Illinois St., 1, 4, 3, 0.31250, 24, 56, -32, 
1950, Southern Methodist (TX), 6, 4, 0, 0.60000, 251, 146, 105, 
1951, Southern Methodist (TX), 3, 6, 1, 0.35000, 164, 144, 20, 
1952, Southern Methodist (TX), 4, 5, 1, 0.45000, 136, 163, -27, 
1962, Howard Payne (TX), 1, 8, 1, 0.15000, 98, 227, -129, 
1963, Howard Payne (TX), 3, 7, 0, 0.30000, 97, 213, -116, 
1924, Carson-Newman (TN), 5, 3, 0, 0.62500, 158, 47, 111, 
1925, Carson-Newman (TN), 2, 3, 2, 0.42857, 36, 91, -55, 
1926, Carson-Newman (TN), 5, 2, 0, 0.71429, 174, 42, 132, 
1927, Carson-Newman (TN), 2, 8, 0, 0.20000, 27, 153, -126, 
1928, Carson-Newman (TN), 1, 6, 1, 0.18750, 38, 241, -203, 
1929, Mercer (GA), 2, 7, 0, 0.22222, 92, 133, -41, 
1930, Mercer (GA), 5, 5, 0, 0.50000, 177, 108, 69, 
1931, Mercer (GA), 7, 2, 1, 0.75000, 171, 58, 113, 
1932, Mercer (GA), 7, 2, 0, 0.77778, 219, 35, 184, 
1933, Mercer (GA), 4, 3, 2, 0.55556, 125, 66, 59, 
1934, Mercer (GA), 3, 6, 1, 0.35000, 78, 125, -47, 
1935, Mercer (GA), 4, 5, 0, 0.44444, 73, 128, -55, 
1936, Mercer (GA), 3, 6, 1, 0.35000, 95, 104, -9, 
1937, Mercer (GA), 4, 5, 0, 0.44444, 142, 105, 37, 
1938, Mercer (GA), 3, 6, 0, 0.33333, 122, 147, -25, 
1939, Mercer (GA), 3, 7, 0, 0.30000, 59, 103, -44, 
1940, Mercer (GA), 1, 7, 0, 0.12500, 65, 152, -87, 
1942, North Texas, 3, 5, 0, 0.37500, 123, 129, -6, 
1906, Hendrix (AR), 3, 2, 1, 0.58333, 49, 34, 15, 
1984, Duquesne (PA), 3, 5, 0, 0.37500, 136, 144, -8, 
1985, Duquesne (PA), 3, 6, 0, 0.33333, 103, 147, -44, 
1986, Duquesne (PA), 5, 3, 1, 0.61111, 192, 163, 29, 
1987, Duquesne (PA), 2, 7, 0, 0.22222, 97, 227, -130, 
1978, Wagner (NY), 2, 8, 0, 0.20000, 134, 265, -131, 
1979, Wagner (NY), 5, 5, 0, 0.50000, 167, 183, -16, 
1980, Wagner (NY), 8, 2, 0, 0.80000, 263, 132, 131, 
1981, Lafayette (PA), 9, 2, 0, 0.81818, 300, 111, 189, 
1982, Lafayette (PA), 7, 3, 0, 0.70000, 335, 183, 152, 
1983, Lafayette (PA), 6, 5, 0, 0.54545, 293, 236, 57, 
1984, Lafayette (PA), 5, 5, 0, 0.50000, 191, 200, -9, 
1985, Lafayette (PA), 6, 5, 0, 0.54545, 237, 208, 29, 
1986, Lafayette (PA), 6, 5, 0, 0.54545, 306, 318, -12, 
1987, Lafayette (PA), 4, 7, 0, 0.36364, 264, 257, 7, 
1988, Lafayette (PA), 8, 2, 1, 0.77273, 420, 252, 168, 
1989, Lafayette (PA), 5, 5, 0, 0.50000, 319, 249, 70, 
1990, Lafayette (PA), 4, 7, 0, 0.36364, 223, 318, -95, 
1991, Lafayette (PA), 6, 5, 0, 0.54545, 277, 312, -35, 
1992, Lafayette (PA), 8, 3, 0, 0.72727, 382, 282, 100, 
1993, Lafayette (PA), 5, 4, 2, 0.54545, 270, 214, 56, 
1994, Lafayette (PA), 5, 6, 0, 0.45455, 230, 202, 28, 
1995, Lafayette (PA), 4, 6, 1, 0.40909, 176, 250, -74, 
1996, Lafayette (PA), 5, 5, 0, 0.50000, 192, 214, -22, 
1997, Lafayette (PA), 3, 8, 0, 0.27273, 236, 314, -78, 
1998, Lafayette (PA), 3, 8, 0, 0.27273, 190, 271, -81, 
1999, Lafayette (PA), 4, 7, 0, 0.36364, 207, 271, -64, 
1967, North Texas, 7, 1, 1, 0.83333, 278, 148, 130, 
1968, North Texas, 8, 2, 0, 0.80000, 297, 184, 113, 
1969, North Texas, 7, 3, 0, 0.70000, 316, 174, 142, 
1970, North Texas, 3, 8, 0, 0.27273, 173, 227, -54, 
1971, North Texas, 3, 8, 0, 0.27273, 155, 321, -166, 
1972, North Texas, 1, 10, 0, 0.09091, 148, 354, -206, 
1920, Oregon St., 2, 2, 2, 0.50000, 20, 52, -32, 
1921, Oregon St., 4, 3, 2, 0.55556, 231, 42, 189, 
1922, Oregon St., 3, 4, 0, 0.42857, 44, 42, 2, 
1923, Oregon St., 4, 5, 2, 0.45455, 55, 71, -16, 
1905, Arizona, 4, 2, 0, 0.66667, 84, 96, -12, 
1989, Liberty (VA), 7, 3, 0, 0.70000, 287, 223, 64, 
1990, Liberty (VA), 7, 4, 0, 0.63636, 296, 236, 60, 
1991, Liberty (VA), 4, 7, 0, 0.36364, 233, 248, -15, 
1992, Liberty (VA), 7, 4, 0, 0.63636, 306, 277, 29, 
1993, Liberty (VA), 6, 5, 0, 0.54545, 259, 286, -27, 
1994, Liberty (VA), 5, 6, 0, 0.45455, 353, 290, 63, 
1995, Liberty (VA), 8, 3, 0, 0.72727, 352, 203, 149, 
1996, Liberty (VA), 5, 6, 0, 0.45455, 251, 261, -10, 
1997, Liberty (VA), 9, 2, 0, 0.81818, 356, 195, 161, 
1998, Liberty (VA), 5, 6, 0, 0.45455, 287, 277, 10, 
1999, Liberty (VA), 4, 7, 0, 0.36364, 225, 275, -50, 
1980, Coast Guard (CT), 2, 8, 0, 0.20000, 129, 218, -89, 
1981, Coast Guard (CT), 3, 6, 0, 0.33333, 74, 146, -72, 
1982, Coast Guard (CT), 2, 7, 0, 0.22222, 134, 245, -111, 
1968, Southwest St. (MN), 3, 5, 0, 0.37500, 107, 178, -71, 
1969, Southwest St. (MN), 3, 6, 0, 0.33333, 143, 222, -79, 
1970, Southwest St. (MN), 1, 8, 0, 0.11111, 74, 230, -156, 
1908, Ouachita Baptist (AR), 2, 5, 0, 0.28571, 34, 226, -192, 
1902, Detroit (MI), 3, 3, 0, 0.50000, 32, 33, -1, 
1906, Detroit (MI), 4, 2, 1, 0.64286, 52, 21, 31, 
1917, Marquette (WI), 8, 0, 1, 0.94444, 341, 7, 334, 
1918, Marquette (WI), 2, 0, 1, 0.83333, 20, 18, 2, 
1919, Marquette (WI), 5, 1, 2, 0.75000, 131, 19, 112, 
1920, Marquette (WI), 7, 2, 0, 0.77778, 211, 64, 147, 
1921, Marquette (WI), 6, 2, 1, 0.72222, 138, 29, 109, 
1923, Wisconsin, 3, 3, 1, 0.50000, 89, 32, 57, 
1924, Wisconsin, 2, 3, 3, 0.43750, 66, 94, -28, 
2002, Morningside (IA), 5, 5, 0, 0.50000, 213, 286, -73, 
2003, Morningside (IA), 3, 7, 0, 0.30000, 210, 249, -39, 
2004, Morningside (IA), 8, 3, 0, 0.72727, 266, 179, 87, 
2005, Morningside (IA), 12, 1, 0, 0.92308, 550, 192, 358, 
2006, Morningside (IA), 9, 3, 0, 0.75000, 287, 189, 98, 
2007, Morningside (IA), 9, 3, 0, 0.75000, 433, 158, 275, 
2008, Morningside (IA), 10, 2, 0, 0.83333, 576, 185, 391, 
2009, Morningside (IA), 10, 2, 0, 0.83333, 541, 204, 337, 
2010, Morningside (IA), 10, 2, 0, 0.83333, 404, 152, 252, 
2011, Morningside (IA), 9, 2, 0, 0.81818, 374, 175, 199, 
2012, Morningside (IA), 13, 1, 0, 0.92857, 618, 185, 433, 
2013, Morningside (IA), 11, 2, 0, 0.84615, 591, 255, 336, 
1892, Ohio St., 5, 3, 0, 0.62500, 260, 144, 116, 
1893, Ohio St., 4, 5, 0, 0.44444, 196, 178, 18, 
1894, Ohio St., 6, 5, 0, 0.54545, 168, 114, 54, 
1895, Ohio St., 4, 4, 2, 0.50000, 56, 102, -46, 
1898, Ohio St., 3, 5, 1, 0.38889, 80, 122, -42, 
1900, Hamilton (NY), 8, 1, 0, 0.88889, 252, 16, 236, 
1901, Hamilton (NY), 5, 3, 0, 0.62500, 97, 96, 1, 
1917, Eastern Michigan, 3, 4, 0, 0.42857, 111, 82, 29, 
1919, Eastern Michigan, 4, 2, 1, 0.64286, 73, 44, 29, 
1920, Eastern Michigan, 6, 2, 0, 0.75000, 155, 88, 67, 
1925, Eastern Michigan, 8, 0, 0, 1.00000, 106, 6, 100, 
1926, Eastern Michigan, 6, 1, 0, 0.85714, 113, 12, 101, 
1927, Eastern Michigan, 8, 0, 0, 1.00000, 186, 13, 173, 
1928, Eastern Michigan, 7, 1, 0, 0.87500, 233, 43, 190, 
1929, Eastern Michigan, 5, 1, 2, 0.75000, 156, 45, 111, 
1930, Eastern Michigan, 6, 1, 0, 0.85714, 145, 14, 131, 
1931, Eastern Michigan, 3, 2, 1, 0.58333, 98, 54, 44, 
1932, Eastern Michigan, 5, 2, 0, 0.71429, 145, 31, 114, 
1933, Eastern Michigan, 6, 2, 0, 0.75000, 115, 71, 44, 
1934, Eastern Michigan, 5, 2, 0, 0.71429, 109, 79, 30, 
1935, Eastern Michigan, 4, 2, 2, 0.62500, 43, 41, 2, 
1936, Eastern Michigan, 6, 2, 0, 0.75000, 76, 53, 23, 
1937, Eastern Michigan, 5, 2, 1, 0.68750, 156, 59, 97, 
1938, Eastern Michigan, 6, 1, 1, 0.81250, 166, 36, 130, 
1939, Eastern Michigan, 3, 3, 1, 0.50000, 68, 64, 4, 
1940, Eastern Michigan, 1, 5, 1, 0.21429, 34, 125, -91, 
1941, Eastern Michigan, 0, 5, 2, 0.14286, 12, 65, -53, 
1942, Eastern Michigan, 3, 3, 1, 0.50000, 64, 81, -17, 
1943, Eastern Michigan, 2, 0, 0, 1.00000, 28, 0, 28, 
1945, Eastern Michigan, 5, 0, 1, 0.91667, 46, 13, 33, 
1946, Eastern Michigan, 3, 4, 1, 0.43750, 65, 80, -15, 
1947, Eastern Michigan, 1, 6, 0, 0.14286, 29, 106, -77, 
1948, Eastern Michigan, 3, 5, 0, 0.37500, 66, 114, -48, 
2012, Gannon (PA), 3, 8, 0, 0.27273, 248, 322, -74, 
2013, Gannon (PA), 6, 5, 0, 0.54545, 361, 369, -8, 
1955, Northwestern (IL), 0, 8, 1, 0.05556, 66, 241, -175, 
1957, Western Illinois, 5, 4, 0, 0.55556, 154, 150, 4, 
1958, Western Illinois, 6, 1, 1, 0.81250, 222, 109, 113, 
1959, Western Illinois, 9, 0, 0, 1.00000, 303, 104, 199, 
1966, Maryland, 4, 6, 0, 0.40000, 180, 204, -24, 
1977, Miami (FL), 3, 8, 0, 0.27273, 125, 245, -120, 
1978, Miami (FL), 6, 5, 0, 0.54545, 194, 193, 1, 
1979, Army (NY), 2, 8, 1, 0.22727, 96, 308, -212, 
1983, Central Florida, 5, 6, 0, 0.45455, 283, 306, -23, 
1984, Central Florida, 1, 6, 0, 0.14286, 154, 270, -116, 
2001, Chowan (NC), 3, 7, 0, 0.30000, 241, 281, -40, 
2002, Chowan (NC), 0, 10, 0, 0.00000, 69, 274, -205, 
1990, Toledo (OH), 9, 2, 0, 0.81818, 284, 178, 106, 
1995, Michigan St., 6, 5, 1, 0.54167, 287, 338, -51, 
1996, Michigan St., 6, 6, 0, 0.50000, 358, 302, 56, 
1997, Michigan St., 7, 5, 0, 0.58333, 342, 237, 105, 
1998, Michigan St., 6, 6, 0, 0.50000, 336, 294, 42, 
1999, Michigan St., 9, 2, 0, 0.81818, 341, 211, 130, 
2000, Louisiana St., 8, 4, 0, 0.66667, 320, 235, 85, 
2001, Louisiana St., 10, 3, 0, 0.76923, 418, 302, 116, 
2002, Louisiana St., 8, 5, 0, 0.61538, 323, 238, 85, 
2003, Louisiana St., 13, 1, 0, 0.92857, 475, 154, 321, 
2004, Louisiana St., 9, 3, 0, 0.75000, 344, 205, 139, 
2007, Alabama, 2, 6, 0, 0.25000, 352, 286, 66, 
2008, Alabama, 12, 2, 0, 0.85714, 422, 200, 222, 
2009, Alabama, 14, 0, 0, 1.00000, 449, 164, 285, 
2010, Alabama, 10, 3, 0, 0.76923, 464, 176, 288, 
2011, Alabama, 12, 1, 0, 0.92308, 453, 106, 347, 
2012, Alabama, 13, 1, 0, 0.92857, 542, 153, 389, 
2013, Alabama, 11, 2, 0, 0.84615, 496, 181, 315, 
1953, Adelphi (NY), 2, 4, 0, 0.33333, 84, 114, -30, 
1991, Northern Illinois, 2, 9, 0, 0.18182, 143, 364, -221, 
1992, Northern Illinois, 5, 6, 0, 0.45455, 203, 193, 10, 
1993, Northern Illinois, 4, 7, 0, 0.36364, 227, 334, -107, 
1994, Northern Illinois, 4, 7, 0, 0.36364, 301, 294, 7, 
1995, Northern Illinois, 3, 8, 0, 0.27273, 220, 420, -200, 
1892, DePauw (IN), 2, 4, 0, 0.33333, 73, 108, -35, 
1893, DePauw (IN), 6, 3, 0, 0.66667, 206, 130, 76, 
2005, Augustana (SD), 6, 5, 0, 0.54545, 295, 289, 6, 
2006, Augustana (SD), 5, 6, 0, 0.45455, 255, 281, -26, 
2007, Augustana (SD), 4, 7, 0, 0.36364, 229, 285, -56, 
2008, Augustana (SD), 8, 4, 0, 0.66667, 369, 255, 114, 
2009, Augustana (SD), 8, 4, 0, 0.66667, 362, 266, 96, 
1966, South Dakota, 5, 5, 0, 0.50000, 225, 160, 65, 
1967, South Dakota, 2, 8, 0, 0.20000, 127, 226, -99, 
1968, South Dakota, 9, 1, 0, 0.90000, 299, 173, 126, 
1969, South Dakota, 3, 7, 0, 0.30000, 208, 228, -20, 
1970, South Dakota, 4, 4, 2, 0.50000, 290, 227, 63, 
1971, South Dakota, 3, 7, 0, 0.30000, 172, 191, -19, 
1972, South Dakota, 9, 1, 0, 0.90000, 296, 144, 152, 
1973, South Dakota, 8, 3, 0, 0.72727, 347, 193, 154, 
1974, South Dakota, 8, 3, 0, 0.72727, 297, 198, 99, 
1975, Northern Arizona, 1, 9, 0, 0.10000, 155, 268, -113, 
1976, Northern Arizona, 8, 3, 0, 0.72727, 249, 184, 65, 
1977, Northern Arizona, 9, 3, 0, 0.75000, 324, 204, 120, 
1978, Northern Arizona, 8, 2, 0, 0.80000, 259, 174, 85, 
1979, Minnesota, 4, 6, 1, 0.40909, 264, 271, -7, 
1980, Minnesota, 5, 6, 0, 0.45455, 210, 250, -40, 
1981, Minnesota, 6, 5, 0, 0.54545, 274, 264, 10, 
1982, Minnesota, 3, 8, 0, 0.27273, 247, 295, -48, 
1983, Minnesota, 1, 10, 0, 0.09091, 181, 518, -337, 
1946, Jacksonville St. (AL), 3, 5, 1, 0.38889, 72, 158, -86, 
1947, Jacksonville St. (AL), 9, 0, 0, 1.00000, 224, 38, 186, 
1948, Jacksonville St. (AL), 8, 1, 1, 0.85000, 190, 47, 143, 
1949, Jacksonville St. (AL), 6, 3, 0, 0.66667, 170, 96, 74, 
1950, Jacksonville St. (AL), 6, 2, 1, 0.72222, 141, 61, 80, 
1951, Jacksonville St. (AL), 3, 3, 2, 0.50000, 77, 91, -14, 
1952, Jacksonville St. (AL), 3, 6, 0, 0.33333, 121, 148, -27, 
1954, Jacksonville St. (AL), 7, 2, 1, 0.75000, 251, 78, 173, 
1955, Jacksonville St. (AL), 10, 1, 0, 0.90909, 246, 67, 179, 
1956, Jacksonville St. (AL), 5, 3, 0, 0.62500, 142, 93, 49, 
1957, Jacksonville St. (AL), 4, 4, 0, 0.50000, 92, 89, 3, 
1958, Jacksonville St. (AL), 5, 4, 0, 0.55556, 131, 151, -20, 
1959, Jacksonville St. (AL), 6, 2, 1, 0.72222, 166, 84, 82, 
1960, Jacksonville St. (AL), 3, 6, 0, 0.33333, 95, 137, -42, 
1961, Jacksonville St. (AL), 5, 4, 0, 0.55556, 128, 134, -6, 
1962, Jacksonville St. (AL), 4, 3, 2, 0.55556, 111, 125, -14, 
1963, Jacksonville St. (AL), 4, 4, 1, 0.50000, 90, 82, 8, 
1964, Jacksonville St. (AL), 4, 4, 1, 0.50000, 149, 138, 11, 
1904, Notre Dame (IN), 5, 3, 0, 0.62500, 94, 127, -33, 
1959, Arkansas Tech, 5, 3, 0, 0.62500, 140, 81, 59, 
1960, Arkansas Tech, 10, 1, 0, 0.90909, 244, 98, 146, 
1961, Arkansas Tech, 8, 0, 1, 0.94444, 256, 49, 207, 
1962, Arkansas Tech, 8, 1, 1, 0.85000, 175, 70, 105, 
1963, Arkansas Tech, 3, 5, 2, 0.40000, 133, 117, 16, 
1964, Arkansas Tech, 9, 1, 0, 0.90000, 182, 81, 101, 
1965, Arkansas Tech, 7, 3, 0, 0.70000, 193, 128, 65, 
1966, Arkansas Tech, 3, 6, 1, 0.35000, 141, 180, -39, 
1956, American International (MA), 4, 4, 1, 0.50000, 102, 103, -1, 
1957, American International (MA), 4, 5, 0, 0.44444, 111, 169, -58, 
1958, American International (MA), 3, 4, 1, 0.43750, 146, 229, -83, 
1959, American International (MA), 6, 3, 0, 0.66667, 180, 126, 54, 
1960, American International (MA), 3, 5, 0, 0.37500, 95, 60, 35, 
1961, American International (MA), 5, 4, 0, 0.55556, 137, 135, 2, 
1962, American International (MA), 4, 5, 0, 0.44444, 133, 152, -19, 
1963, American International (MA), 1, 8, 0, 0.11111, 84, 253, -169, 
1964, American International (MA), 3, 5, 1, 0.38889, 140, 130, 10, 
1965, American International (MA), 0, 9, 0, 0.00000, 83, 372, -289, 
1966, American International (MA), 1, 8, 0, 0.11111, 140, 321, -181, 
1967, American International (MA), 6, 3, 0, 0.66667, 188, 176, 12, 
1968, American International (MA), 3, 4, 1, 0.43750, 179, 178, 1, 
1969, American International (MA), 4, 5, 0, 0.44444, 185, 155, 30, 
1970, American International (MA), 2, 6, 1, 0.27778, 155, 142, 13, 
1987, Sewanee (TN), 5, 4, 0, 0.55556, 207, 174, 33, 
1988, Sewanee (TN), 3, 6, 0, 0.33333, 122, 170, -48, 
1989, Sewanee (TN), 2, 7, 0, 0.22222, 132, 188, -56, 
1990, Sewanee (TN), 6, 3, 0, 0.66667, 127, 89, 38, 
1991, Sewanee (TN), 7, 1, 1, 0.83333, 180, 101, 79, 
1992, Sewanee (TN), 8, 1, 0, 0.88889, 210, 135, 75, 
1993, Sewanee (TN), 4, 5, 0, 0.44444, 134, 190, -56, 
1913, Hamilton (NY), 3, 4, 1, 0.43750, 51, 82, -31, 
2013, Montana St.-Northern, 4, 6, 0, 0.40000, 258, 304, -46, 
1904, Emporia St. (KS), 6, 5, 0, 0.54545, 106, 110, -4, 
1905, Emporia St. (KS), 4, 5, 0, 0.44444, 114, 114, 0, 
1906, Emporia St. (KS), 4, 4, 0, 0.50000, 48, 43, 5, 
1908, Emporia St. (KS), 3, 5, 0, 0.37500, 66, 109, -43, 
1997, New Mexico St., 2, 9, 0, 0.18182, 221, 398, -177, 
1998, New Mexico St., 3, 8, 0, 0.27273, 331, 424, -93, 
1999, New Mexico St., 6, 5, 0, 0.54545, 311, 274, 37, 
2000, New Mexico St., 3, 8, 0, 0.27273, 295, 357, -62, 
2001, New Mexico St., 5, 7, 0, 0.41667, 286, 400, -114, 
2002, New Mexico St., 7, 5, 0, 0.58333, 327, 328, -1, 
2003, New Mexico St., 3, 9, 0, 0.25000, 262, 341, -79, 
2004, New Mexico St., 5, 6, 0, 0.45455, 273, 355, -82, 
2006, Southeast Missouri St., 4, 7, 0, 0.36364, 203, 307, -104, 
2007, Southeast Missouri St., 3, 8, 0, 0.27273, 225, 387, -162, 
2008, Southeast Missouri St., 4, 8, 0, 0.33333, 262, 364, -102, 
2009, Southeast Missouri St., 2, 9, 0, 0.18182, 240, 299, -59, 
2010, Southeast Missouri St., 9, 3, 0, 0.75000, 323, 258, 65, 
2011, Southeast Missouri St., 3, 8, 0, 0.27273, 255, 413, -158, 
2012, Southeast Missouri St., 3, 8, 0, 0.27273, 283, 366, -83, 
2013, Southeast Missouri St., 3, 9, 0, 0.25000, 262, 441, -179, 
1907, Emporia St. (KS), 1, 6, 0, 0.14286, 12, 101, -89, 
1925, Delaware Valley (PA), 7, 1, 0, 0.87500, 168, 22, 146, 
1926, Delaware Valley (PA), 5, 2, 1, 0.68750, 233, 40, 193, 
1927, Delaware Valley (PA), 7, 1, 0, 0.87500, 206, 24, 182, 
1928, Delaware Valley (PA), 7, 1, 1, 0.83333, 206, 18, 188, 
1929, Delaware Valley (PA), 10, 0, 0, 1.00000, 325, 35, 290, 
1930, Delaware Valley (PA), 6, 1, 1, 0.81250, 232, 20, 212, 
1931, Delaware Valley (PA), 1, 0, 0, 1.00000, 22, 0, 22, 
1932, Delaware Valley (PA), 1, 0, 0, 1.00000, 26, 0, 26, 
1933, Delaware Valley (PA), 1, 0, 0, 1.00000, 25, 0, 25, 
1934, Delaware Valley (PA), 0, 0, 2, 0.50000, 0, 0, 0, 
1937, Delaware Valley (PA), 0, 1, 0, 0.00000, 0, 6, -6, 
1938, Delaware Valley (PA), 0, 1, 1, 0.25000, 2, 7, -5, 
1941, Delaware Valley (PA), 0, 2, 1, 0.16667, 0, 25, -25, 
1942, Delaware Valley (PA), 1, 0, 0, 1.00000, 20, 0, 20, 
1947, Eastern Kentucky, 5, 4, 0, 0.55556, 165, 89, 76, 
1948, Eastern Kentucky, 8, 3, 0, 0.72727, 184, 93, 91, 
1949, Eastern Kentucky, 4, 4, 1, 0.50000, 148, 130, 18, 
1950, Eastern Kentucky, 6, 4, 0, 0.60000, 242, 103, 139, 
1951, Eastern Kentucky, 7, 3, 0, 0.70000, 201, 94, 107, 
1952, Eastern Kentucky, 3, 4, 1, 0.43750, 128, 165, -37, 
1953, Eastern Kentucky, 8, 2, 0, 0.80000, 220, 128, 92, 
1922, Saint John's (MN), 1, 5, 0, 0.16667, 37, 122, -85, 
1923, Saint John's (MN), 2, 3, 0, 0.40000, 41, 60, -19, 
2013, Saint Joseph's (IN), 8, 3, 0, 0.72727, 314, 227, 87, 
2013, Langston (OK), 6, 4, 0, 0.60000, 252, 222, 30, 
1940, Vanderbilt (TN), 3, 6, 1, 0.35000, 101, 98, 3, 
1941, Vanderbilt (TN), 8, 2, 0, 0.80000, 260, 89, 171, 
1942, Vanderbilt (TN), 6, 4, 0, 0.60000, 232, 113, 119, 
1946, Vanderbilt (TN), 5, 4, 0, 0.55556, 108, 43, 65, 
1947, Vanderbilt (TN), 6, 4, 0, 0.60000, 182, 85, 97, 
1948, Vanderbilt (TN), 8, 2, 1, 0.77273, 328, 73, 255, 
1949, UCLA, 6, 3, 0, 0.66667, 227, 188, 39, 
1950, UCLA, 6, 3, 0, 0.66667, 196, 96, 100, 
1951, UCLA, 5, 3, 1, 0.61111, 188, 120, 68, 
1952, UCLA, 8, 1, 0, 0.88889, 220, 55, 165, 
1953, UCLA, 8, 2, 0, 0.80000, 224, 76, 148, 
1954, UCLA, 9, 0, 0, 1.00000, 367, 40, 327, 
1955, UCLA, 9, 2, 0, 0.81818, 299, 74, 225, 
1956, UCLA, 7, 3, 0, 0.70000, 148, 122, 26, 
1957, UCLA, 8, 2, 0, 0.80000, 190, 90, 100, 
1990, Buffalo (NY), 2, 8, 0, 0.20000, 188, 330, -142, 
1991, Buffalo (NY), 3, 7, 0, 0.30000, 231, 304, -73, 
1982, Cal Poly-San Luis Obispo, 6, 5, 0, 0.54545, 199, 140, 59, 
1983, Cal Poly-San Luis Obispo, 5, 6, 0, 0.45455, 248, 249, -1, 
1984, Cal Poly-San Luis Obispo, 6, 4, 0, 0.60000, 197, 90, 107, 
1985, Cal Poly-San Luis Obispo, 4, 7, 0, 0.36364, 266, 303, -37, 
1986, Cal Poly-San Luis Obispo, 5, 5, 0, 0.50000, 233, 246, -13, 
2013, Indiana St., 1, 11, 0, 0.08333, 248, 431, -183, 
1899, Columbia (NY), 8, 3, 0, 0.72727, 194, 85, 109, 
1900, Columbia (NY), 7, 3, 1, 0.68182, 124, 77, 47, 
1901, Columbia (NY), 8, 5, 0, 0.61538, 157, 91, 66, 
1904, Virginia, 6, 3, 0, 0.66667, 78, 54, 24, 
1913, Rutgers (NJ), 6, 3, 0, 0.66667, 247, 76, 171, 
1914, Rutgers (NJ), 5, 3, 1, 0.61111, 208, 73, 135, 
1915, Rutgers (NJ), 7, 1, 0, 0.87500, 351, 33, 318, 
1916, Rutgers (NJ), 3, 2, 2, 0.57143, 106, 52, 54, 
1917, Rutgers (NJ), 7, 1, 1, 0.83333, 295, 28, 267, 
1918, Rutgers (NJ), 5, 2, 0, 0.71429, 192, 78, 114, 
1919, Rutgers (NJ), 5, 3, 0, 0.62500, 115, 70, 45, 
1920, Rutgers (NJ), 2, 7, 0, 0.22222, 32, 132, -100, 
1921, Rutgers (NJ), 4, 5, 0, 0.44444, 99, 168, -69, 
1922, Rutgers (NJ), 5, 4, 0, 0.55556, 133, 117, 16, 
1923, Rutgers (NJ), 7, 1, 1, 0.83333, 260, 36, 224, 
2005, Nevada-Las Vegas, 2, 9, 0, 0.18182, 207, 381, -174, 
2006, Nevada-Las Vegas, 2, 10, 0, 0.16667, 238, 382, -144, 
2007, Nevada-Las Vegas, 2, 10, 0, 0.16667, 218, 343, -125, 
2008, Nevada-Las Vegas, 5, 7, 0, 0.41667, 307, 391, -84, 
2009, Nevada-Las Vegas, 5, 7, 0, 0.41667, 298, 389, -91, 
1999, Stephen F. Austin (TX), 8, 3, 0, 0.72727, 389, 260, 129, 
2000, Stephen F. Austin (TX), 6, 5, 0, 0.54545, 289, 297, -8, 
2001, Stephen F. Austin (TX), 6, 5, 0, 0.54545, 246, 264, -18, 
2002, Stephen F. Austin (TX), 6, 5, 0, 0.54545, 322, 245, 77, 
2003, Stephen F. Austin (TX), 7, 4, 0, 0.63636, 343, 230, 113, 
2004, Stephen F. Austin (TX), 6, 5, 0, 0.54545, 284, 256, 28, 
2009, Incarnate Word (TX), 4, 5, 0, 0.44444, 249, 272, -23, 
2010, Incarnate Word (TX), 3, 8, 0, 0.27273, 236, 416, -180, 
2011, Incarnate Word (TX), 2, 8, 0, 0.20000, 219, 407, -188, 
1995, Prairie View A&M; (TX), 0, 11, 0, 0.00000, 79, 511, -432, 
1996, Prairie View A&M; (TX), 0, 11, 0, 0.00000, 131, 439, -308, 
1945, Washington St., 6, 2, 1, 0.72222, 157, 70, 87, 
1946, Washington St., 1, 6, 1, 0.18750, 118, 147, -29, 
1947, Washington St., 3, 7, 0, 0.30000, 93, 148, -55, 
1948, Washington St., 4, 5, 1, 0.45000, 164, 219, -55, 
1949, Washington St., 3, 6, 0, 0.33333, 149, 205, -56, 
1966, Hawaii, 4, 6, 0, 0.40000, 110, 245, -135, 
1947, Loyola Marymount (CA), 3, 7, 0, 0.30000, 186, 224, -38, 
1948, Loyola Marymount (CA), 3, 5, 1, 0.38889, 159, 199, -40, 
2009, Washington, 5, 7, 0, 0.41667, 313, 320, -7, 
2010, Washington, 7, 6, 0, 0.53846, 284, 381, -97, 
2011, Washington, 7, 6, 0, 0.53846, 434, 467, -33, 
2012, Washington, 7, 6, 0, 0.53846, 312, 314, -2, 
2013, Washington, 8, 4, 0, 0.66667, 462, 281, 181, 
1943, Boston College (MA), 4, 0, 1, 0.90000, 156, 18, 138, 
1944, Boston College (MA), 4, 3, 0, 0.57143, 132, 134, -2, 
1945, Boston College (MA), 3, 4, 0, 0.42857, 79, 171, -92, 
1930, Army (NY), 9, 1, 1, 0.86364, 268, 22, 246, 
1931, Army (NY), 8, 2, 1, 0.77273, 296, 72, 224, 
1932, Army (NY), 8, 2, 0, 0.80000, 261, 39, 222, 
1935, Mississippi St., 8, 3, 0, 0.72727, 191, 77, 114, 
1936, Mississippi St., 7, 3, 1, 0.68182, 232, 38, 194, 
1937, Mississippi St., 5, 4, 1, 0.55000, 119, 117, 2, 
1977, Wofford (SC), 7, 3, 1, 0.68182, 175, 147, 28, 
1978, Wofford (SC), 3, 8, 0, 0.27273, 194, 272, -78, 
1979, Wofford (SC), 5, 5, 0, 0.50000, 263, 272, -9, 
1980, Wofford (SC), 7, 2, 2, 0.72727, 259, 167, 92, 
1981, Wofford (SC), 6, 5, 0, 0.54545, 266, 245, 21, 
1982, Wofford (SC), 8, 3, 0, 0.72727, 317, 149, 168, 
1983, East Tennessee St., 3, 8, 0, 0.27273, 173, 178, -5, 
1984, East Tennessee St., 6, 5, 0, 0.54545, 144, 167, -23, 
1986, Furman (SC), 7, 3, 2, 0.66667, 338, 176, 162, 
1987, Furman (SC), 7, 4, 0, 0.63636, 314, 168, 146, 
1988, Furman (SC), 13, 2, 0, 0.86667, 360, 142, 218, 
1989, Furman (SC), 12, 2, 0, 0.85714, 430, 189, 241, 
1990, Furman (SC), 9, 4, 0, 0.69231, 425, 237, 188, 
1991, Furman (SC), 7, 4, 0, 0.63636, 363, 217, 146, 
1992, Furman (SC), 6, 5, 0, 0.54545, 258, 213, 45, 
1993, Furman (SC), 5, 5, 1, 0.50000, 247, 232, 15, 
2013, Appalachian St. (NC), 4, 8, 0, 0.33333, 283, 336, -53, 
1974, Wofford (SC), 7, 4, 0, 0.63636, 231, 166, 65, 
1975, Wofford (SC), 7, 3, 1, 0.68182, 169, 150, 19, 
1976, Wofford (SC), 4, 7, 0, 0.36364, 124, 224, -100, 
1937, New Hampshire, 7, 1, 0, 0.87500, 144, 31, 113, 
1938, New Hampshire, 3, 6, 0, 0.33333, 42, 112, -70, 
1939, New Hampshire, 3, 5, 0, 0.37500, 71, 126, -55, 
1940, New Hampshire, 5, 3, 0, 0.62500, 121, 86, 35, 
1941, New Hampshire, 4, 3, 1, 0.56250, 153, 62, 91, 
1946, Kansas, 7, 2, 1, 0.75000, 157, 145, 12, 
1947, Kansas, 8, 1, 2, 0.81818, 304, 102, 202, 
1948, Navy (MD), 0, 8, 1, 0.05556, 77, 227, -150, 
1949, Navy (MD), 3, 5, 1, 0.38889, 151, 238, -87, 
1950, Baylor (TX), 7, 3, 0, 0.70000, 183, 128, 55, 
1951, Baylor (TX), 8, 2, 1, 0.77273, 245, 131, 114, 
1952, Baylor (TX), 4, 4, 2, 0.50000, 187, 181, 6, 
1953, Baylor (TX), 7, 3, 0, 0.70000, 219, 166, 53, 
1954, Baylor (TX), 7, 4, 0, 0.63636, 250, 174, 76, 
1955, Baylor (TX), 5, 5, 0, 0.50000, 146, 143, 3, 
1955, Citadel (SC), 5, 4, 0, 0.55556, 108, 155, -47, 
1956, Citadel (SC), 3, 5, 1, 0.38889, 136, 149, -13, 
1970, Augsburg (MN), 1, 8, 0, 0.11111, 137, 265, -128, 
1971, Augsburg (MN), 0, 9, 0, 0.00000, 65, 234, -169, 
1999, Malone (OH), 4, 6, 0, 0.40000, 137, 171, -34, 
2000, Malone (OH), 4, 7, 0, 0.36364, 249, 321, -72, 
2001, Malone (OH), 2, 8, 0, 0.20000, 160, 325, -165, 
1923, Clemson (SC), 5, 2, 1, 0.68750, 91, 65, 26, 
1924, Clemson (SC), 2, 6, 0, 0.25000, 80, 96, -16, 
1925, Clemson (SC), 1, 7, 0, 0.12500, 27, 160, -133, 
1926, Clemson (SC), 2, 7, 0, 0.22222, 20, 169, -149, 
1928, Southern Mississippi, 4, 5, 0, 0.44444, 62, 234, -172, 
1929, Southern Mississippi, 2, 6, 1, 0.27778, 74, 104, -30, 
1928, Northern Colorado, 4, 4, 0, 0.50000, 184, 86, 98, 
1929, Northern Colorado, 4, 3, 0, 0.57143, 61, 70, -9, 
1930, Northern Colorado, 2, 2, 3, 0.50000, 48, 73, -25, 
1931, Northern Colorado, 2, 4, 1, 0.35714, 52, 69, -17, 
1932, Colorado, 2, 4, 0, 0.33333, 63, 46, 17, 
1933, Colorado, 7, 2, 0, 0.77778, 183, 51, 132, 
1934, Colorado, 6, 1, 2, 0.77778, 167, 40, 127, 
1936, Denver (CO), 7, 1, 1, 0.83333, 141, 88, 53, 
1937, Denver (CO), 6, 3, 0, 0.66667, 122, 61, 61, 
1938, Denver (CO), 4, 4, 1, 0.50000, 65, 86, -21, 
1909, South Dakota St., 1, 3, 0, 0.25000, 61, 28, 33, 
1910, South Dakota St., 4, 2, 2, 0.62500, 76, 64, 12, 
1912, Morningside (IA), 8, 1, 1, 0.85000, 281, 33, 248, 
1913, Morningside (IA), 5, 2, 0, 0.71429, 107, 92, 15, 
1914, Morningside (IA), 4, 3, 0, 0.57143, 102, 77, 25, 
1915, Morningside (IA), 3, 3, 0, 0.50000, 93, 62, 31, 
1916, Morningside (IA), 5, 1, 1, 0.78571, 307, 14, 293, 
1917, Morningside (IA), 5, 1, 0, 0.83333, 207, 27, 180, 
1918, Morningside (IA), 2, 0, 0, 1.00000, 35, 0, 35, 
1919, Morningside (IA), 5, 2, 0, 0.71429, 174, 39, 135, 
1920, Morningside (IA), 6, 2, 0, 0.75000, 144, 44, 100, 
1921, Morningside (IA), 6, 2, 0, 0.75000, 155, 44, 111, 
1922, Morningside (IA), 1, 4, 2, 0.28571, 51, 115, -64, 
1923, Morningside (IA), 5, 2, 0, 0.71429, 152, 50, 102, 
1924, Morningside (IA), 2, 5, 0, 0.28571, 83, 147, -64, 
1925, Morningside (IA), 3, 5, 0, 0.37500, 69, 102, -33, 
1926, Morningside (IA), 6, 2, 0, 0.75000, 197, 59, 138, 
1927, Morningside (IA), 3, 5, 0, 0.37500, 110, 113, -3, 
1928, Morningside (IA), 5, 4, 0, 0.55556, 92, 69, 23, 
1929, Morningside (IA), 4, 4, 0, 0.50000, 97, 134, -37, 
1930, Morningside (IA), 7, 2, 0, 0.77778, 185, 75, 110, 
1931, Morningside (IA), 2, 6, 0, 0.25000, 79, 131, -52, 
1932, Morningside (IA), 2, 6, 0, 0.25000, 92, 109, -17, 
1933, Morningside (IA), 4, 4, 0, 0.50000, 117, 55, 62, 
1934, Morningside (IA), 4, 3, 1, 0.56250, 106, 89, 17, 
1935, Morningside (IA), 0, 6, 1, 0.07143, 32, 152, -120, 
1936, Morningside (IA), 3, 4, 0, 0.42857, 39, 104, -65, 
1937, Morningside (IA), 4, 2, 2, 0.62500, 83, 62, 21, 
1938, Morningside (IA), 4, 3, 1, 0.56250, 84, 67, 17, 
1939, Morningside (IA), 2, 6, 0, 0.25000, 75, 103, -28, 
1940, Morningside (IA), 3, 2, 2, 0.57143, 75, 71, 4, 
1941, Morningside (IA), 3, 5, 0, 0.37500, 124, 80, 44, 
1897, Mercer (GA), 0, 1, 1, 0.25000, 0, 26, -26, 
1899, Georgia, 2, 3, 1, 0.41667, 44, 22, 22, 
2010, Southwest St. (MN), 4, 7, 0, 0.36364, 239, 360, -121, 
2011, Southwest St. (MN), 3, 8, 0, 0.27273, 291, 411, -120, 
2012, Southwest St. (MN), 4, 7, 0, 0.36364, 325, 400, -75, 
2013, Southwest St. (MN), 7, 5, 0, 0.58333, 489, 484, 5, 
1905, Northern Illinois, 3, 1, 1, 0.70000, 25, 12, 13, 
1918, Washington, 1, 1, 0, 0.50000, 6, 7, -1, 
1919, New Mexico St., 2, 3, 1, 0.41667, 83, 69, 14, 
1896, Willamette (OR), 2, 0, 1, 0.83333, 26, 2, 24, 
1911, Saint Francis (PA), 4, 3, 2, 0.55556, 22, 31, -9, 
1912, Saint Francis (PA), 10, 3, 0, 0.76923, 173, 136, 37, 
1917, Saint Francis (PA), 6, 0, 0, 1.00000, 154, 7, 147, 
1919, Saint Francis (PA), 3, 4, 0, 0.42857, 33, 141, -108, 
1962, Henderson St. (AR), 3, 5, 1, 0.38889, 87, 93, -6, 
1963, Henderson St. (AR), 8, 1, 1, 0.85000, 198, 76, 122, 
1964, Henderson St. (AR), 3, 6, 1, 0.35000, 99, 125, -26, 
1965, Henderson St. (AR), 4, 6, 0, 0.40000, 122, 116, 6, 
1966, Henderson St. (AR), 1, 8, 0, 0.11111, 118, 214, -96, 
2013, Winona St. (MN), 6, 5, 0, 0.54545, 401, 353, 48, 
1929, Texas-El Paso, 6, 1, 2, 0.77778, 154, 46, 108, 
1930, Texas-El Paso, 7, 1, 1, 0.83333, 186, 67, 119, 
1931, Texas-El Paso, 7, 1, 0, 0.87500, 146, 83, 63, 
1932, Texas-El Paso, 7, 3, 0, 0.70000, 222, 113, 109, 
1933, Texas-El Paso, 3, 5, 1, 0.38889, 71, 79, -8, 
1934, Texas-El Paso, 4, 4, 0, 0.50000, 128, 104, 24, 
1935, Texas-El Paso, 1, 8, 0, 0.11111, 23, 178, -155, 
1936, Texas-El Paso, 5, 3, 1, 0.61111, 92, 86, 6, 
1937, Texas-El Paso, 7, 1, 2, 0.80000, 215, 91, 124, 
1938, Texas-El Paso, 6, 3, 0, 0.66667, 153, 72, 81, 
1939, Texas-El Paso, 5, 4, 0, 0.55556, 110, 71, 39, 
1940, Texas-El Paso, 4, 4, 1, 0.50000, 129, 115, 14, 
1941, Texas-El Paso, 4, 5, 1, 0.45000, 184, 192, -8, 
1920, North Central (IL), 3, 3, 1, 0.50000, 58, 120, -62, 
1921, North Central (IL), 3, 5, 0, 0.37500, 53, 156, -103, 
1922, North Central (IL), 4, 3, 0, 0.57143, 170, 68, 102, 
1907, Johns Hopkins (MD), 2, 3, 2, 0.42857, 11, 48, -37, 
1908, Johns Hopkins (MD), 5, 2, 1, 0.68750, 65, 46, 19, 
1916, Franklin & Marshall (PA), 1, 7, 0, 0.12500, 41, 189, -148, 
1994, Case Western Reserve (OH), 1, 9, 0, 0.10000, 207, 422, -215, 
1995, Case Western Reserve (OH), 2, 8, 0, 0.20000, 102, 219, -117, 
1996, Case Western Reserve (OH), 5, 5, 0, 0.50000, 178, 153, 25, 
1997, Case Western Reserve (OH), 3, 7, 0, 0.30000, 224, 244, -20, 
1998, Case Western Reserve (OH), 5, 5, 0, 0.50000, 269, 213, 56, 
1927, Wofford (SC), 2, 4, 3, 0.38889, 103, 132, -29, 
1928, Wofford (SC), 7, 2, 1, 0.75000, 111, 79, 32, 
1929, Wofford (SC), 3, 6, 0, 0.33333, 77, 119, -42, 
1930, Wofford (SC), 2, 9, 0, 0.18182, 68, 164, -96, 
1931, Wofford (SC), 4, 5, 0, 0.44444, 72, 133, -61, 
1932, Wofford (SC), 3, 6, 1, 0.35000, 83, 149, -66, 
1933, Wofford (SC), 3, 6, 0, 0.33333, 67, 187, -120, 
1993, Sonoma St. (CA), 2, 7, 0, 0.22222, 193, 308, -115, 
1994, Sonoma St. (CA), 3, 7, 0, 0.30000, 202, 372, -170, 
1995, Sonoma St. (CA), 0, 8, 1, 0.05556, 75, 374, -299, 
1996, Sonoma St. (CA), 2, 8, 0, 0.20000, 134, 280, -146, 
1990, Morehouse (GA), 1, 7, 1, 0.16667, 84, 287, -203, 
1942, Holy Cross (MA), 5, 4, 1, 0.55000, 210, 99, 111, 
1943, Holy Cross (MA), 6, 2, 0, 0.75000, 168, 43, 125, 
1944, Holy Cross (MA), 5, 2, 2, 0.66667, 173, 90, 83, 
1918, Purdue (IN), 3, 3, 0, 0.50000, 87, 78, 9, 
1919, Purdue (IN), 2, 4, 1, 0.35714, 71, 104, -33, 
1920, Purdue (IN), 2, 5, 0, 0.28571, 36, 103, -67, 
1902, New Hampshire, 2, 3, 1, 0.41667, 43, 80, -37, 
1903, New Hampshire, 2, 6, 1, 0.27778, 18, 124, -106, 
1964, Long Island-CW Post (NY), 4, 5, 0, 0.44444, 201, 182, 19, 
1965, Long Island-CW Post (NY), 3, 5, 1, 0.38889, 144, 184, -40, 
1966, Long Island-CW Post (NY), 7, 1, 1, 0.83333, 204, 108, 96, 
1967, Long Island-CW Post (NY), 5, 4, 0, 0.55556, 156, 172, -16, 
1904, Hardin-Simmons (TX), 0, 1, 0, 0.00000, 6, 18, -12, 
1905, Hardin-Simmons (TX), 1, 2, 1, 0.37500, 28, 33, -5, 
1906, Hardin-Simmons (TX), 2, 0, 1, 0.83333, 17, 5, 12, 
1907, Hardin-Simmons (TX), 2, 1, 3, 0.58333, 37, 27, 10, 
1898, Mississippi, 1, 1, 0, 0.50000, 18, 16, 2, 
1896, Cedarville (OH), 6, 0, 2, 0.87500, 112, 8, 104, 
1969, Nevada, 5, 5, 0, 0.50000, 222, 225, -3, 
1970, Nevada, 6, 3, 1, 0.65000, 280, 220, 60, 
1971, Nevada, 5, 5, 0, 0.50000, 181, 165, 16, 
1972, Nevada, 6, 5, 0, 0.54545, 276, 223, 53, 
1973, Nevada, 7, 4, 0, 0.63636, 295, 143, 152, 
1974, Nevada, 5, 6, 0, 0.45455, 209, 254, -45, 
1975, Nevada, 3, 8, 0, 0.27273, 121, 285, -164, 
1998, Tulane (LA), 1, 0, 0, 1.00000, 41, 27, 14, 
1999, Tulane (LA), 3, 8, 0, 0.27273, 279, 399, -120, 
2000, Tulane (LA), 6, 5, 0, 0.54545, 329, 346, -17, 
2001, Tulane (LA), 3, 9, 0, 0.25000, 344, 495, -151, 
2002, Tulane (LA), 8, 5, 0, 0.61538, 361, 282, 79, 
2003, Tulane (LA), 5, 7, 0, 0.41667, 337, 424, -87, 
2004, Tulane (LA), 5, 6, 0, 0.45455, 300, 361, -61, 
2005, Tulane (LA), 2, 9, 0, 0.18182, 234, 348, -114, 
2006, Tulane (LA), 4, 8, 0, 0.33333, 224, 400, -176, 
1983, Kent St. (OH), 1, 10, 0, 0.09091, 157, 260, -103, 
1984, Kent St. (OH), 4, 7, 0, 0.36364, 135, 199, -64, 
1985, Kent St. (OH), 3, 8, 0, 0.27273, 212, 277, -65, 
1904, Kentucky, 9, 1, 0, 0.90000, 276, 15, 261, 
1905, Kentucky, 6, 3, 1, 0.65000, 209, 171, 38, 
1974, Adams St. (CO), 5, 4, 0, 0.55556, 202, 117, 85, 
1975, Adams St. (CO), 6, 3, 0, 0.66667, 241, 97, 144, 
1976, Adams St. (CO), 3, 6, 0, 0.33333, 173, 163, 10, 
1914, Arizona St., 4, 3, 0, 0.57143, 143, 97, 46, 
1915, Arizona St., 3, 2, 0, 0.60000, 125, 36, 89, 
1916, Arizona St., 0, 3, 0, 0.00000, 13, 51, -38, 
1915, California, 9, 5, 0, 0.64286, 262, 190, 72, 
2002, Mercyhurst (PA), 2, 9, 0, 0.18182, 159, 388, -229, 
2003, Mercyhurst (PA), 5, 6, 0, 0.45455, 183, 292, -109, 
2004, Mercyhurst (PA), 4, 7, 0, 0.36364, 249, 384, -135, 
2005, Mercyhurst (PA), 2, 8, 0, 0.20000, 220, 341, -121, 
2006, Mercyhurst (PA), 3, 7, 0, 0.30000, 221, 282, -61, 
2007, Mercyhurst (PA), 4, 7, 0, 0.36364, 353, 421, -68, 
2008, Mercyhurst (PA), 7, 4, 0, 0.63636, 265, 198, 67, 
2009, Mercyhurst (PA), 4, 7, 0, 0.36364, 214, 254, -40, 
2010, Mercyhurst (PA), 10, 3, 0, 0.76923, 354, 265, 89, 
2011, Mercyhurst (PA), 4, 7, 0, 0.36364, 308, 301, 7, 
2012, Mercyhurst (PA), 9, 2, 0, 0.81818, 369, 256, 113, 
2013, Mercyhurst (PA), 7, 4, 0, 0.63636, 361, 230, 131, 
1972, Willamette (OR), 3, 6, 0, 0.33333, 143, 138, 5, 
1973, Willamette (OR), 6, 4, 0, 0.60000, 154, 162, -8, 
1909, Temple (PA), 0, 4, 1, 0.10000, 0, 99, -99, 
1910, Temple (PA), 3, 4, 0, 0.42857, 64, 140, -76, 
1911, Temple (PA), 6, 1, 0, 0.85714, 90, 54, 36, 
1912, Temple (PA), 3, 4, 0, 0.42857, 44, 119, -75, 
1913, Temple (PA), 1, 5, 2, 0.25000, 31, 110, -79, 
2013, Warner (FL), 1, 10, 0, 0.09091, 86, 449, -363, 
2013, Bowling Green (OH), 0, 1, 0, 0.00000, 27, 30, -3, 
1963, Miami (OH), 5, 3, 2, 0.60000, 208, 178, 30, 
1964, Miami (OH), 6, 3, 1, 0.65000, 209, 142, 67, 
1965, Miami (OH), 7, 3, 0, 0.70000, 247, 137, 110, 
1966, Miami (OH), 9, 1, 0, 0.90000, 229, 76, 153, 
1967, Miami (OH), 6, 4, 0, 0.60000, 181, 114, 67, 
1968, Miami (OH), 7, 3, 0, 0.70000, 240, 99, 141, 
1969, Michigan, 8, 3, 0, 0.72727, 352, 148, 204, 
1970, Michigan, 9, 1, 0, 0.90000, 288, 90, 198, 
1971, Michigan, 11, 1, 0, 0.91667, 421, 83, 338, 
1972, Michigan, 10, 1, 0, 0.90909, 264, 57, 207, 
1973, Michigan, 10, 0, 1, 0.95455, 330, 68, 262, 
1974, Michigan, 10, 1, 0, 0.90909, 324, 75, 249, 
1975, Michigan, 8, 2, 2, 0.75000, 324, 130, 194, 
1976, Michigan, 10, 2, 0, 0.83333, 432, 95, 337, 
1977, Michigan, 10, 2, 0, 0.83333, 353, 124, 229, 
1978, Michigan, 10, 2, 0, 0.83333, 372, 105, 267, 
1979, Michigan, 8, 4, 0, 0.66667, 312, 151, 161, 
1980, Michigan, 10, 2, 0, 0.83333, 322, 129, 193, 
1981, Michigan, 9, 3, 0, 0.75000, 355, 162, 193, 
1982, Michigan, 8, 4, 0, 0.66667, 345, 204, 141, 
1983, Michigan, 9, 3, 0, 0.75000, 355, 160, 195, 
1984, Michigan, 6, 6, 0, 0.50000, 214, 200, 14, 
1985, Michigan, 10, 1, 1, 0.87500, 342, 98, 244, 
1986, Michigan, 11, 2, 0, 0.84615, 379, 203, 176, 
1987, Michigan, 8, 4, 0, 0.66667, 331, 172, 159, 
1988, Michigan, 9, 2, 1, 0.79167, 361, 167, 194, 
1989, Michigan, 10, 2, 0, 0.83333, 335, 184, 151, 
1907, Catawba (NC), 3, 3, 0, 0.50000, 71, 54, 17, 
1906, Texas, 9, 1, 0, 0.90000, 201, 60, 141, 
1991, James Madison (VA), 9, 4, 0, 0.69231, 414, 343, 71, 
1992, James Madison (VA), 4, 7, 0, 0.36364, 333, 355, -22, 
1993, James Madison (VA), 6, 5, 0, 0.54545, 375, 253, 122, 
1994, James Madison (VA), 10, 3, 0, 0.76923, 388, 224, 164, 
1995, Memphis (TN), 3, 8, 0, 0.27273, 150, 240, -90, 
1996, Memphis (TN), 4, 7, 0, 0.36364, 141, 219, -78, 
1997, Memphis (TN), 4, 7, 0, 0.36364, 218, 243, -25, 
1998, Memphis (TN), 2, 9, 0, 0.18182, 226, 340, -114, 
1999, Memphis (TN), 5, 6, 0, 0.45455, 232, 182, 50, 
2000, Memphis (TN), 4, 7, 0, 0.36364, 176, 199, -23, 
2001, Rutgers (NJ), 2, 9, 0, 0.18182, 119, 397, -278, 
2002, Rutgers (NJ), 1, 11, 0, 0.08333, 167, 397, -230, 
2003, Rutgers (NJ), 5, 7, 0, 0.41667, 329, 354, -25, 
2004, Rutgers (NJ), 4, 7, 0, 0.36364, 269, 343, -74, 
2005, Rutgers (NJ), 7, 5, 0, 0.58333, 344, 307, 37, 
2006, Rutgers (NJ), 11, 2, 0, 0.84615, 387, 186, 201, 
2007, Rutgers (NJ), 8, 5, 0, 0.61538, 426, 292, 134, 
2008, Rutgers (NJ), 8, 5, 0, 0.61538, 377, 245, 132, 
2009, Rutgers (NJ), 9, 4, 0, 0.69231, 375, 233, 142, 
2010, Rutgers (NJ), 4, 8, 0, 0.33333, 250, 318, -68, 
2011, Rutgers (NJ), 9, 4, 0, 0.69231, 343, 238, 105, 
1909, Maine, 3, 4, 1, 0.43750, 53, 71, -18, 
1910, Oregon St., 3, 3, 1, 0.50000, 27, 49, -22, 
1980, Wheaton (IL), 2, 7, 0, 0.22222, 120, 216, -96, 
1915, Doane (NE), 5, 3, 0, 0.62500, 83, 39, 44, 
1924, Oregon St., 3, 5, 0, 0.37500, 71, 85, -14, 
1925, Oregon St., 7, 2, 0, 0.77778, 268, 81, 187, 
1926, Oregon St., 7, 1, 0, 0.87500, 221, 30, 191, 
1927, Oregon St., 3, 3, 1, 0.50000, 98, 78, 20, 
1928, Oregon St., 6, 3, 0, 0.66667, 206, 53, 153, 
1929, Oregon St., 5, 4, 0, 0.55556, 182, 106, 76, 
1930, Oregon St., 7, 3, 0, 0.70000, 208, 60, 148, 
1931, Oregon St., 6, 3, 1, 0.65000, 198, 62, 136, 
1932, Oregon St., 4, 6, 0, 0.40000, 130, 109, 21, 
2013, Mayville St. (ND), 7, 4, 0, 0.63636, 261, 196, 65, 
1915, Cal Poly-San Luis Obispo, 1, 0, 1, 0.75000, 23, 20, 3, 
1916, Cal Poly-San Luis Obispo, 1, 2, 0, 0.33333, 25, 56, -31, 
1917, Cal Poly-San Luis Obispo, 2, 1, 0, 0.66667, 35, 36, -1, 
1957, Western Michigan, 4, 4, 1, 0.50000, 150, 127, 23, 
1958, Western Michigan, 4, 5, 0, 0.44444, 188, 200, -12, 
1959, Western Michigan, 4, 5, 0, 0.44444, 184, 116, 68, 
1960, Western Michigan, 4, 4, 1, 0.50000, 173, 106, 67, 
1961, Western Michigan, 5, 4, 1, 0.55000, 142, 179, -37, 
1962, Western Michigan, 5, 4, 0, 0.55556, 158, 112, 46, 
1963, Western Michigan, 2, 7, 0, 0.22222, 111, 201, -90, 
1950, Central Michigan, 6, 4, 0, 0.60000, 209, 125, 84, 
1964, Boston (MA), 2, 7, 0, 0.22222, 77, 213, -136, 
1965, Boston (MA), 5, 3, 1, 0.61111, 140, 140, 0, 
1966, Boston (MA), 5, 5, 0, 0.50000, 182, 155, 27, 
1967, Boston (MA), 3, 6, 0, 0.33333, 114, 151, -37, 
1968, Boston (MA), 5, 3, 1, 0.61111, 117, 125, -8, 
1958, California-Davis, 5, 4, 0, 0.55556, 106, 100, 6, 
1964, California-Davis, 3, 6, 0, 0.33333, 106, 157, -51, 
1965, California-Davis, 4, 6, 0, 0.40000, 157, 187, -30, 
1966, California-Davis, 5, 5, 0, 0.50000, 200, 218, -18, 
1967, California-Davis, 3, 6, 0, 0.33333, 164, 212, -48, 
1968, California-Davis, 5, 4, 0, 0.55556, 158, 147, 11, 
1969, California-Davis, 3, 7, 0, 0.30000, 192, 258, -66, 
1958, Ashland (OH), 1, 8, 0, 0.11111, 65, 202, -137, 
1919, Tulsa (OK), 8, 0, 1, 0.94444, 591, 27, 564, 
1920, Tulsa (OK), 10, 0, 1, 0.95455, 621, 21, 600, 
1921, Tulsa (OK), 6, 3, 0, 0.66667, 257, 95, 162, 
1922, Arkansas, 4, 5, 0, 0.44444, 143, 136, 7, 
1923, Arkansas, 6, 2, 1, 0.72222, 158, 40, 118, 
1924, Arkansas, 7, 2, 1, 0.75000, 227, 69, 158, 
1925, Arkansas, 4, 4, 1, 0.50000, 95, 62, 33, 
1926, Arkansas, 5, 5, 0, 0.50000, 179, 88, 91, 
1927, Arkansas, 8, 1, 0, 0.88889, 218, 76, 142, 
1928, Arkansas, 7, 2, 0, 0.77778, 251, 63, 188, 
1929, Texas Christian, 9, 0, 1, 0.95000, 249, 33, 216, 
1930, Texas Christian, 9, 2, 1, 0.79167, 298, 49, 249, 
1931, Texas Christian, 8, 2, 1, 0.77273, 119, 41, 78, 
1932, Texas Christian, 10, 0, 1, 0.95455, 283, 23, 260, 
1933, Texas Christian, 9, 2, 1, 0.79167, 208, 49, 159, 
1934, Ohio St., 7, 1, 0, 0.87500, 267, 34, 233, 
1935, Ohio St., 7, 1, 0, 0.87500, 237, 57, 180, 
1936, Ohio St., 5, 3, 0, 0.62500, 160, 27, 133, 
1937, Ohio St., 6, 2, 0, 0.75000, 125, 23, 102, 
1938, Ohio St., 4, 3, 1, 0.56250, 119, 65, 54, 
1939, Ohio St., 6, 2, 0, 0.75000, 189, 64, 125, 
1940, Ohio St., 4, 4, 0, 0.50000, 99, 113, -14, 
1941, Idaho, 4, 5, 0, 0.44444, 123, 135, -12, 
1942, Idaho, 3, 7, 0, 0.30000, 96, 209, -113, 
1983, Albion (MI), 5, 4, 0, 0.55556, 119, 106, 13, 
1984, Albion (MI), 5, 4, 0, 0.55556, 138, 198, -60, 
1985, Albion (MI), 7, 2, 1, 0.75000, 190, 126, 64, 
1986, Albion (MI), 6, 2, 1, 0.72222, 253, 105, 148, 
1987, Albion (MI), 5, 4, 0, 0.55556, 256, 127, 129, 
1988, Albion (MI), 6, 3, 0, 0.66667, 201, 172, 29, 
1989, Albion (MI), 7, 2, 0, 0.77778, 179, 99, 80, 
1990, Albion (MI), 7, 1, 1, 0.83333, 232, 110, 122, 
1991, Albion (MI), 9, 1, 0, 0.90000, 279, 123, 156, 
1992, Albion (MI), 8, 1, 0, 0.88889, 280, 114, 166, 
1993, Albion (MI), 10, 1, 0, 0.90909, 370, 149, 221, 
1994, Albion (MI), 13, 0, 0, 1.00000, 459, 171, 288, 
1995, Albion (MI), 8, 1, 0, 0.88889, 274, 118, 156, 
1996, Albion (MI), 9, 1, 0, 0.90000, 477, 109, 368, 
2005, Duquesne (PA), 7, 3, 0, 0.70000, 264, 161, 103, 
2006, Duquesne (PA), 7, 3, 0, 0.70000, 285, 155, 130, 
2007, Duquesne (PA), 6, 4, 0, 0.60000, 269, 208, 61, 
2008, Duquesne (PA), 3, 7, 0, 0.30000, 215, 263, -48, 
2009, Duquesne (PA), 3, 8, 0, 0.27273, 202, 296, -94, 
2010, Duquesne (PA), 7, 4, 0, 0.63636, 279, 283, -4, 
2011, Duquesne (PA), 9, 2, 0, 0.81818, 334, 201, 133, 
2012, Duquesne (PA), 5, 6, 0, 0.45455, 298, 270, 28, 
2013, Duquesne (PA), 7, 4, 0, 0.63636, 246, 253, -7, 
1993, Coast Guard (CT), 4, 5, 0, 0.44444, 177, 227, -50, 
1994, Coast Guard (CT), 4, 5, 0, 0.44444, 189, 181, 8, 
1995, Coast Guard (CT), 4, 6, 0, 0.40000, 163, 156, 7, 
1996, Coast Guard (CT), 8, 3, 0, 0.72727, 361, 212, 149, 
1997, Austin Peay St. (TN), 0, 10, 0, 0.00000, 119, 440, -321, 
1998, Austin Peay St. (TN), 4, 7, 0, 0.36364, 199, 326, -127, 
1999, Austin Peay St. (TN), 3, 8, 0, 0.27273, 240, 423, -183, 
2000, Austin Peay St. (TN), 2, 9, 0, 0.18182, 183, 397, -214, 
2001, Austin Peay St. (TN), 3, 7, 0, 0.30000, 236, 265, -29, 
2002, Austin Peay St. (TN), 7, 5, 0, 0.58333, 287, 333, -46, 
1927, Ashland (OH), 4, 3, 0, 0.57143, 101, 120, -19, 
1928, Ashland (OH), 6, 2, 0, 0.75000, 151, 105, 46, 
1929, Ashland (OH), 7, 1, 0, 0.87500, 258, 106, 152, 
1930, Ashland (OH), 4, 2, 3, 0.61111, 64, 87, -23, 
1931, Ashland (OH), 2, 6, 0, 0.25000, 22, 155, -133, 
1932, Ashland (OH), 2, 5, 1, 0.31250, 35, 58, -23, 
1933, Ashland (OH), 3, 4, 1, 0.43750, 60, 60, 0, 
1908, Creighton (NE), 3, 3, 2, 0.50000, 54, 89, -35, 
1909, Creighton (NE), 3, 3, 0, 0.50000, 49, 82, -33, 
2013, Peru St. (NE), 7, 4, 0, 0.63636, 363, 285, 78, 
1979, Miami (FL), 5, 6, 0, 0.45455, 191, 236, -45, 
1980, Miami (FL), 9, 3, 0, 0.75000, 278, 171, 107, 
1981, Miami (FL), 9, 2, 0, 0.81818, 245, 145, 100, 
1982, Miami (FL), 7, 4, 0, 0.63636, 241, 153, 88, 
1983, Miami (FL), 11, 1, 0, 0.91667, 313, 136, 177, 
1985, Louisville (KY), 2, 9, 0, 0.18182, 199, 429, -230, 
1986, Louisville (KY), 3, 8, 0, 0.27273, 179, 303, -124, 
1987, Louisville (KY), 3, 7, 1, 0.31818, 215, 348, -133, 
1988, Louisville (KY), 8, 3, 0, 0.72727, 261, 245, 16, 
1989, Louisville (KY), 6, 5, 0, 0.54545, 312, 222, 90, 
1990, Louisville (KY), 10, 1, 1, 0.87500, 345, 149, 196, 
1991, Louisville (KY), 2, 9, 0, 0.18182, 135, 335, -200, 
1992, Louisville (KY), 5, 6, 0, 0.45455, 214, 243, -29, 
1993, Louisville (KY), 9, 3, 0, 0.75000, 350, 243, 107, 
1994, Louisville (KY), 6, 5, 0, 0.54545, 255, 253, 2, 
1995, Oklahoma, 5, 5, 1, 0.50000, 233, 275, -42, 
2001, Florida Atlantic, 4, 6, 0, 0.40000, 177, 245, -68, 
2002, Florida Atlantic, 2, 9, 0, 0.18182, 176, 339, -163, 
2003, Florida Atlantic, 11, 3, 0, 0.78571, 404, 306, 98, 
2004, Florida Atlantic, 9, 3, 0, 0.75000, 299, 207, 92, 
2005, Florida Atlantic, 2, 9, 0, 0.18182, 148, 339, -191, 
2006, Florida Atlantic, 5, 7, 0, 0.41667, 181, 299, -118, 
2007, Florida Atlantic, 8, 5, 0, 0.61538, 405, 432, -27, 
2008, Florida Atlantic, 7, 6, 0, 0.53846, 326, 373, -47, 
2009, Florida Atlantic, 5, 7, 0, 0.41667, 329, 405, -76, 
2010, Florida Atlantic, 4, 8, 0, 0.33333, 202, 351, -149, 
2011, Florida Atlantic, 1, 11, 0, 0.08333, 155, 416, -261, 
1907, Cornell (NY), 8, 2, 0, 0.80000, 176, 45, 131, 
1908, Cornell (NY), 7, 1, 1, 0.83333, 96, 43, 53, 
1905, Dayton (OH), 0, 3, 0, 0.00000, 10, 53, -43, 
1929, Fort Hays St. (KS), 2, 5, 0, 0.28571, 38, 61, -23, 
2013, Greenville (IL), 9, 2, 0, 0.81818, 395, 301, 94, 
1997, Fort Valley St. (GA), 5, 6, 0, 0.45455, 160, 171, -11, 
1998, Fort Valley St. (GA), 11, 2, 0, 0.84615, 377, 222, 155, 
1999, Fort Valley St. (GA), 10, 2, 0, 0.83333, 316, 233, 83, 
2000, Fort Valley St. (GA), 7, 4, 0, 0.63636, 270, 310, -40, 
2001, Fort Valley St. (GA), 8, 3, 0, 0.72727, 363, 244, 119, 
2006, Rockford (IL), 7, 3, 0, 0.70000, 291, 120, 171, 
2007, Rockford (IL), 7, 3, 0, 0.70000, 355, 157, 198, 
2008, Rockford (IL), 2, 8, 0, 0.20000, 188, 306, -118, 
2009, Rockford (IL), 1, 9, 0, 0.10000, 64, 398, -334, 
1930, Ithaca (NY), 1, 3, 1, 0.30000, 32, 56, -24, 
1990, Lindenwood (MO), 6, 4, 0, 0.60000, 246, 199, 47, 
1991, Lindenwood (MO), 5, 4, 1, 0.55000, 233, 158, 75, 
1968, Coast Guard (CT), 3, 7, 0, 0.30000, 178, 307, -129, 
1969, Coast Guard (CT), 2, 8, 0, 0.20000, 86, 251, -165, 
1970, Coast Guard (CT), 5, 5, 0, 0.50000, 182, 176, 6, 
1971, Coast Guard (CT), 8, 2, 0, 0.80000, 262, 193, 69, 
1972, Coast Guard (CT), 3, 7, 0, 0.30000, 156, 224, -68, 
1973, Coast Guard (CT), 8, 2, 0, 0.80000, 211, 104, 107, 
1985, Ball St. (IN), 4, 7, 0, 0.36364, 203, 283, -80, 
1986, Ball St. (IN), 6, 5, 0, 0.54545, 199, 201, -2, 
1987, Ball St. (IN), 4, 7, 0, 0.36364, 226, 255, -29, 
1988, Ball St. (IN), 8, 3, 0, 0.72727, 286, 170, 116, 
1989, Ball St. (IN), 7, 3, 2, 0.66667, 274, 239, 35, 
1990, Ball St. (IN), 7, 4, 0, 0.63636, 204, 121, 83, 
1991, Ball St. (IN), 6, 5, 0, 0.54545, 159, 150, 9, 
1992, Ball St. (IN), 5, 6, 0, 0.45455, 171, 243, -72, 
1993, Ball St. (IN), 8, 3, 1, 0.70833, 301, 265, 36, 
1994, Ball St. (IN), 5, 5, 1, 0.50000, 276, 296, -20, 
2001, Central Connecticut St., 2, 7, 0, 0.22222, 146, 233, -87, 
2002, Central Connecticut St., 5, 6, 0, 0.45455, 139, 251, -112, 
2003, Central Connecticut St., 3, 8, 0, 0.27273, 231, 359, -128, 
1905, Montana, 2, 3, 0, 0.40000, 117, 75, 42, 
1906, Montana, 2, 4, 0, 0.33333, 49, 75, -26, 
1906, Eastern Michigan, 5, 0, 1, 0.91667, 52, 11, 41, 
1907, Eastern Michigan, 3, 2, 0, 0.60000, 72, 13, 59, 
1908, Eastern Michigan, 1, 4, 0, 0.20000, 15, 40, -25, 
1914, Missouri, 5, 3, 0, 0.62500, 128, 48, 80, 
1915, Missouri, 2, 5, 1, 0.31250, 72, 102, -30, 
1916, Missouri, 6, 1, 1, 0.81250, 112, 21, 91, 
1917, Missouri, 3, 5, 0, 0.37500, 98, 124, -26, 
1919, Nebraska, 3, 3, 2, 0.50000, 56, 60, -4, 
1920, Nebraska, 5, 3, 1, 0.61111, 151, 84, 67, 
1923, Detroit (MI), 4, 3, 2, 0.55556, 140, 39, 101, 
1999, Mary (ND), 11, 2, 0, 0.84615, 460, 117, 343, 
2000, Mary (ND), 7, 3, 0, 0.70000, 362, 211, 151, 
2001, Mary (ND), 9, 1, 0, 0.90000, 345, 149, 196, 
2002, Mary (ND), 9, 2, 0, 0.81818, 318, 159, 159, 
2003, Mary (ND), 10, 2, 0, 0.83333, 373, 115, 258, 
2004, Mary (ND), 9, 2, 0, 0.81818, 283, 157, 126, 
2005, Mary (ND), 7, 2, 0, 0.77778, 228, 107, 121, 
2006, Mary (ND), 6, 4, 0, 0.60000, 204, 183, 21, 
2007, Mary (ND), 7, 4, 0, 0.63636, 298, 216, 82, 
2008, Mary (ND), 4, 7, 0, 0.36364, 208, 302, -94, 
2009, Mary (ND), 5, 6, 0, 0.45455, 251, 284, -33, 
2010, Mary (ND), 4, 7, 0, 0.36364, 262, 282, -20, 
2011, Mary (ND), 5, 6, 0, 0.45455, 373, 308, 65, 
2012, Mary (ND), 4, 7, 0, 0.36364, 274, 385, -111, 
2013, Mary (ND), 6, 5, 0, 0.54545, 277, 263, 14, 
2013, Washburn (KS), 8, 3, 0, 0.72727, 450, 235, 215, 
1947, San Diego St. (CA), 7, 3, 1, 0.68182, 191, 156, 35, 
1948, San Diego St. (CA), 4, 7, 0, 0.36364, 158, 190, -32, 
1949, San Diego St. (CA), 6, 3, 0, 0.66667, 195, 200, -5, 
1950, San Diego St. (CA), 5, 3, 1, 0.61111, 212, 186, 26, 
1951, San Diego St. (CA), 10, 0, 1, 0.95455, 386, 133, 253, 
1952, San Diego St. (CA), 4, 5, 0, 0.44444, 238, 267, -29, 
1953, San Diego St. (CA), 5, 3, 1, 0.61111, 230, 142, 88, 
1954, San Diego St. (CA), 5, 4, 0, 0.55556, 177, 141, 36, 
1955, San Diego St. (CA), 2, 8, 0, 0.20000, 65, 231, -166, 
1931, Mesa St. (CO), 5, 1, 0, 0.83333, 124, 17, 107, 
1932, Mesa St. (CO), 4, 2, 0, 0.66667, 59, 53, 6, 
1933, Mesa St. (CO), 3, 3, 0, 0.50000, 81, 65, 16, 
1925, Arkansas St., 4, 3, 1, 0.56250, 76, 120, -44, 
1926, Arkansas St., 4, 3, 1, 0.56250, 60, 69, -9, 
1927, Arkansas St., 4, 3, 0, 0.57143, 61, 67, -6, 
1928, Arkansas St., 3, 3, 1, 0.50000, 105, 65, 40, 
1929, Arkansas St., 2, 5, 0, 0.28571, 60, 137, -77, 
1930, Arkansas St., 1, 4, 3, 0.31250, 20, 84, -64, 
1935, Creighton (NE), 3, 5, 1, 0.38889, 58, 112, -54, 
1936, Creighton (NE), 4, 4, 0, 0.50000, 102, 72, 30, 
1937, Creighton (NE), 2, 7, 0, 0.22222, 45, 141, -96, 
1938, Creighton (NE), 6, 1, 1, 0.81250, 179, 40, 139, 
1939, Creighton (NE), 4, 5, 0, 0.44444, 164, 143, 21, 
1942, Stanford (CA), 6, 4, 0, 0.60000, 204, 121, 83, 
1946, Stanford (CA), 6, 3, 1, 0.65000, 222, 147, 75, 
1947, Stanford (CA), 0, 9, 0, 0.00000, 73, 214, -141, 
1948, Stanford (CA), 4, 6, 0, 0.40000, 164, 159, 5, 
1949, Stanford (CA), 7, 3, 1, 0.68182, 366, 121, 245, 
1950, Stanford (CA), 5, 3, 2, 0.60000, 188, 124, 64, 
1928, Manhattan (NY), 4, 3, 0, 0.57143, 86, 121, -35, 
1929, Manhattan (NY), 3, 5, 0, 0.37500, 86, 116, -30, 
1949, Syracuse (NY), 4, 5, 0, 0.44444, 207, 215, -8, 
1950, Syracuse (NY), 5, 5, 0, 0.50000, 199, 139, 60, 
1951, Syracuse (NY), 5, 4, 0, 0.55556, 180, 147, 33, 
1952, Syracuse (NY), 7, 3, 0, 0.70000, 203, 202, 1, 
1953, Syracuse (NY), 5, 3, 1, 0.61111, 197, 99, 98, 
1954, Syracuse (NY), 4, 4, 0, 0.50000, 135, 147, -12, 
1955, Syracuse (NY), 5, 3, 0, 0.62500, 180, 130, 50, 
1956, Syracuse (NY), 7, 2, 0, 0.77778, 230, 117, 113, 
1957, Syracuse (NY), 5, 3, 1, 0.61111, 183, 110, 73, 
1958, Syracuse (NY), 8, 2, 0, 0.80000, 270, 80, 190, 
1959, Syracuse (NY), 11, 0, 0, 1.00000, 413, 73, 340, 
1960, Syracuse (NY), 7, 2, 0, 0.77778, 203, 74, 129, 
1961, Syracuse (NY), 8, 3, 0, 0.72727, 268, 131, 137, 
1962, Syracuse (NY), 5, 5, 0, 0.50000, 159, 110, 49, 
1963, Syracuse (NY), 8, 2, 0, 0.80000, 255, 101, 154, 
1964, Syracuse (NY), 7, 4, 0, 0.63636, 264, 157, 107, 
1965, Syracuse (NY), 7, 3, 0, 0.70000, 237, 146, 91, 
1966, Syracuse (NY), 8, 3, 0, 0.72727, 266, 156, 110, 
1967, Syracuse (NY), 8, 2, 0, 0.80000, 210, 127, 83, 
1968, Syracuse (NY), 6, 4, 0, 0.60000, 252, 154, 98, 
1969, Syracuse (NY), 5, 5, 0, 0.50000, 169, 126, 43, 
1970, Syracuse (NY), 6, 4, 0, 0.60000, 248, 208, 40, 
1971, Syracuse (NY), 5, 5, 1, 0.50000, 197, 179, 18, 
1972, Syracuse (NY), 5, 6, 0, 0.45455, 141, 229, -88, 
1973, Syracuse (NY), 2, 9, 0, 0.18182, 129, 288, -159, 
1984, Doane (NE), 6, 4, 0, 0.60000, 224, 163, 61, 
1985, Doane (NE), 6, 3, 1, 0.65000, 154, 128, 26, 
1986, Doane (NE), 5, 5, 0, 0.50000, 168, 176, -8, 
1987, Doane (NE), 5, 5, 0, 0.50000, 170, 155, 15, 
1988, Doane (NE), 4, 5, 0, 0.44444, 232, 199, 33, 
1989, Doane (NE), 5, 4, 1, 0.55000, 191, 187, 4, 
1990, Doane (NE), 3, 7, 0, 0.30000, 144, 293, -149, 
1991, Doane (NE), 5, 4, 0, 0.55556, 214, 228, -14, 
1992, Doane (NE), 5, 3, 1, 0.61111, 230, 182, 48, 
1993, Doane (NE), 10, 1, 0, 0.90909, 409, 151, 258, 
1994, Doane (NE), 4, 5, 0, 0.44444, 148, 146, 2, 
1995, Doane (NE), 3, 6, 0, 0.33333, 140, 130, 10, 
1996, Doane (NE), 6, 3, 0, 0.66667, 259, 147, 112, 
1997, Doane (NE), 11, 1, 0, 0.91667, 400, 199, 201, 
1998, Doane (NE), 5, 4, 0, 0.55556, 176, 187, -11, 
1999, Doane (NE), 7, 3, 0, 0.70000, 266, 189, 77, 
2000, Doane (NE), 5, 4, 0, 0.55556, 202, 145, 57, 
2001, Doane (NE), 6, 3, 0, 0.66667, 155, 109, 46, 
2002, Doane (NE), 7, 3, 0, 0.70000, 271, 197, 74, 
2003, Doane (NE), 4, 6, 0, 0.40000, 250, 241, 9, 
2004, Doane (NE), 2, 8, 0, 0.20000, 110, 274, -164, 
1970, Tuskegee (AL), 9, 1, 0, 0.90000, 222, 85, 137, 
1971, Tuskegee (AL), 4, 5, 0, 0.44444, 181, 135, 46, 
1972, Tuskegee (AL), 7, 4, 0, 0.63636, 238, 153, 85, 
1973, Tuskegee (AL), 7, 4, 0, 0.63636, 243, 163, 80, 
1974, Tuskegee (AL), 11, 1, 0, 0.91667, 418, 130, 288, 
1975, Tuskegee (AL), 5, 5, 0, 0.50000, 206, 199, 7, 
1976, Tuskegee (AL), 6, 3, 1, 0.65000, 219, 210, 9, 
1977, Tuskegee (AL), 3, 7, 0, 0.30000, 126, 190, -64, 
1978, Tuskegee (AL), 3, 7, 0, 0.30000, 178, 206, -28, 
1979, Tuskegee (AL), 5, 6, 0, 0.45455, 164, 193, -29, 
1980, Tuskegee (AL), 5, 5, 0, 0.50000, 203, 230, -27, 
2002, Morehouse (GA), 6, 5, 0, 0.54545, 219, 180, 39, 
2003, Morehouse (GA), 4, 7, 0, 0.36364, 262, 308, -46, 
2004, Morehouse (GA), 5, 5, 0, 0.50000, 187, 295, -108, 
1972, Azusa Pacific (CA), 2, 7, 0, 0.22222, 181, 216, -35, 
1973, Azusa Pacific (CA), 5, 4, 0, 0.55556, 210, 220, -10, 
1974, Azusa Pacific (CA), 3, 6, 0, 0.33333, 111, 127, -16, 
1975, Azusa Pacific (CA), 7, 3, 0, 0.70000, 186, 193, -7, 
1976, Azusa Pacific (CA), 4, 5, 0, 0.44444, 180, 180, 0, 
1977, Azusa Pacific (CA), 4, 5, 0, 0.44444, 105, 168, -63, 
1994, South Carolina, 7, 5, 0, 0.58333, 300, 276, 24, 
1995, South Carolina, 4, 6, 1, 0.40909, 401, 393, 8, 
1996, South Carolina, 6, 5, 0, 0.54545, 245, 238, 7, 
1997, South Carolina, 5, 6, 0, 0.45455, 258, 279, -21, 
1998, South Carolina, 1, 10, 0, 0.09091, 207, 330, -123, 
1932, Clark Atlanta (GA), 2, 3, 1, 0.41667, 43, 39, 4, 
1933, Clark Atlanta (GA), 1, 4, 1, 0.25000, 12, 51, -39, 
1934, Clark Atlanta (GA), 3, 4, 2, 0.44444, 52, 75, -23, 
1927, Valparaiso (IN), 1, 5, 0, 0.16667, 21, 148, -127, 
1928, Valparaiso (IN), 1, 6, 0, 0.14286, 30, 81, -51, 
1934, Colorado School of Mines, 1, 6, 0, 0.14286, 24, 229, -205, 
1935, Colorado School of Mines, 3, 7, 0, 0.30000, 85, 234, -149, 
1963, Samford (AL), 5, 3, 1, 0.61111, 80, 112, -32, 
1964, Samford (AL), 4, 4, 1, 0.50000, 149, 121, 28, 
1965, Samford (AL), 4, 6, 0, 0.40000, 119, 143, -24, 
1970, Eastern New Mexico, 2, 8, 0, 0.20000, 125, 254, -129, 
1971, Eastern New Mexico, 4, 5, 1, 0.45000, 189, 219, -30, 
1972, Eastern New Mexico, 2, 8, 0, 0.20000, 94, 243, -149, 
1973, Eastern New Mexico, 6, 4, 0, 0.60000, 167, 137, 30, 
1974, Eastern New Mexico, 7, 4, 0, 0.63636, 222, 171, 51, 
1975, Eastern New Mexico, 8, 3, 0, 0.72727, 278, 164, 114, 
1976, Eastern New Mexico, 7, 3, 1, 0.68182, 240, 181, 59, 
1977, Eastern New Mexico, 4, 6, 0, 0.40000, 169, 184, -15, 
2006, Webber International (FL), 5, 5, 0, 0.50000, 199, 177, 22, 
2007, Webber International (FL), 3, 6, 0, 0.33333, 173, 273, -100, 
2008, Webber International (FL), 3, 8, 0, 0.27273, 133, 296, -163, 
2009, Webber International (FL), 4, 6, 0, 0.40000, 206, 241, -35, 
2010, Webber International (FL), 7, 4, 0, 0.63636, 269, 225, 44, 
2011, Webber International (FL), 4, 6, 0, 0.40000, 272, 230, 42, 
2012, Webber International (FL), 4, 6, 0, 0.40000, 169, 210, -41, 
2013, Webber International (FL), 5, 5, 0, 0.50000, 235, 185, 50, 
2010, Richmond (VA), 6, 5, 0, 0.54545, 171, 226, -55, 
2013, Virginia St., 9, 1, 0, 0.90000, 323, 174, 149, 
1985, Carthage (WI), 1, 8, 0, 0.11111, 143, 242, -99, 
1986, Carthage (WI), 3, 6, 0, 0.33333, 127, 232, -105, 
1987, Carthage (WI), 2, 7, 0, 0.22222, 126, 246, -120, 
1947, Carthage (WI), 5, 2, 1, 0.68750, 98, 95, 3, 
1948, Carthage (WI), 4, 4, 0, 0.50000, 96, 82, 14, 
1949, Carthage (WI), 2, 6, 1, 0.27778, 117, 164, -47, 
1930, Old Dominion (VA), 3, 1, 0, 0.75000, 66, 14, 52, 
1931, Old Dominion (VA), 1, 0, 1, 0.75000, 7, 0, 7, 
1932, Old Dominion (VA), 6, 3, 1, 0.65000, 133, 31, 102, 
1933, Old Dominion (VA), 5, 3, 0, 0.62500, 68, 58, 10, 
1934, Old Dominion (VA), 3, 5, 1, 0.38889, 64, 128, -64, 
1935, Old Dominion (VA), 8, 1, 0, 0.88889, 173, 38, 135, 
1936, Old Dominion (VA), 4, 4, 0, 0.50000, 57, 102, -45, 
1937, Old Dominion (VA), 5, 3, 0, 0.62500, 144, 53, 91, 
1938, Old Dominion (VA), 3, 5, 1, 0.38889, 49, 54, -5, 
1939, Old Dominion (VA), 4, 5, 0, 0.44444, 110, 106, 4, 
1940, Old Dominion (VA), 0, 6, 0, 0.00000, 0, 166, -166, 
1919, Alabama, 8, 1, 0, 0.88889, 280, 22, 258, 
1920, Alabama, 10, 1, 0, 0.90909, 377, 35, 342, 
1921, Alabama, 5, 4, 2, 0.54545, 241, 104, 137, 
1922, Alabama, 6, 3, 1, 0.65000, 300, 81, 219, 
1966, Pacific (CA), 4, 7, 0, 0.36364, 211, 303, -92, 
1967, Pacific (CA), 4, 5, 0, 0.44444, 201, 158, 43, 
1968, Pacific (CA), 6, 4, 0, 0.60000, 179, 158, 21, 
1969, Pacific (CA), 7, 3, 0, 0.70000, 284, 146, 138, 
1981, San Diego St. (CA), 6, 5, 0, 0.54545, 279, 227, 52, 
1982, San Diego St. (CA), 7, 5, 0, 0.58333, 308, 320, -12, 
1983, San Diego St. (CA), 2, 9, 1, 0.20833, 221, 352, -131, 
1984, San Diego St. (CA), 4, 7, 1, 0.37500, 265, 250, 15, 
1985, San Diego St. (CA), 5, 6, 1, 0.45833, 342, 317, 25, 
1922, Tennessee St., 1, 1, 0, 0.50000, 9, 13, -4, 
1923, Tennessee St., 2, 1, 0, 0.66667, 32, 26, 6, 
1924, Tennessee St., 4, 1, 1, 0.75000, 123, 7, 116, 
1996, Elon (NC), 4, 7, 0, 0.36364, 246, 332, -86, 
1997, Elon (NC), 7, 4, 0, 0.63636, 338, 268, 70, 
1998, Elon (NC), 5, 6, 0, 0.45455, 289, 214, 75, 
1999, Elon (NC), 9, 2, 0, 0.81818, 344, 193, 151, 
2000, Elon (NC), 7, 4, 0, 0.63636, 278, 223, 55, 
2001, Elon (NC), 2, 9, 0, 0.18182, 199, 346, -147, 
2002, Elon (NC), 4, 7, 0, 0.36364, 249, 352, -103, 
2003, Elon (NC), 2, 10, 0, 0.16667, 119, 314, -195, 
1970, Wichita St. (KS), 0, 6, 0, 0.00000, 71, 244, -173, 
1971, Wichita St. (KS), 3, 8, 0, 0.27273, 149, 268, -119, 
1972, Wichita St. (KS), 6, 5, 0, 0.54545, 156, 228, -72, 
1973, Wichita St. (KS), 4, 7, 0, 0.36364, 165, 280, -115, 
1979, Emporia St. (KS), 4, 6, 0, 0.40000, 126, 132, -6, 
1980, Emporia St. (KS), 2, 8, 0, 0.20000, 115, 193, -78, 
1981, Emporia St. (KS), 1, 9, 0, 0.10000, 107, 187, -80, 
1982, Emporia St. (KS), 3, 7, 0, 0.30000, 147, 210, -63, 
1919, California (PA), 4, 1, 1, 0.75000, 46, 21, 25, 
1919, Northern Colorado, 0, 1, 0, 0.00000, 0, 20, -20, 
1920, Northern Colorado, 0, 6, 0, 0.00000, 0, 122, -122, 
1921, Northern Colorado, 1, 3, 1, 0.30000, 30, 104, -74, 
1898, Montana, 3, 2, 0, 0.60000, 32, 24, 8, 
1899, Arkansas, 3, 1, 1, 0.70000, 37, 21, 16, 
1900, Arkansas, 2, 1, 1, 0.62500, 36, 23, 13, 
2012, Weber St. (UT), 2, 9, 0, 0.18182, 239, 352, -113, 
2013, Weber St. (UT), 2, 10, 0, 0.16667, 190, 497, -307, 
1962, Howard (DC), 1, 8, 0, 0.11111, 76, 197, -121, 
1963, Howard (DC), 4, 5, 0, 0.44444, 134, 158, -24, 
1964, Howard (DC), 8, 2, 0, 0.80000, 241, 68, 173, 
1965, Howard (DC), 5, 3, 0, 0.62500, 152, 108, 44, 
1966, Howard (DC), 4, 4, 0, 0.50000, 111, 112, -1, 
1967, Howard (DC), 2, 6, 0, 0.25000, 121, 181, -60, 
1968, Howard (DC), 3, 5, 0, 0.37500, 54, 175, -121, 
1970, Howard (DC), 7, 2, 0, 0.77778, 177, 95, 82, 
1971, Howard (DC), 4, 5, 0, 0.44444, 148, 115, 33, 
1972, Howard (DC), 6, 4, 0, 0.60000, 136, 85, 51, 
1956, Missouri St., 3, 6, 0, 0.33333, 82, 120, -38, 
1957, Missouri St., 4, 4, 1, 0.50000, 118, 130, -12, 
1958, Missouri St., 4, 5, 0, 0.44444, 113, 173, -60, 
1959, Missouri St., 4, 5, 0, 0.44444, 126, 141, -15, 
1960, Missouri St., 2, 7, 0, 0.22222, 52, 137, -85, 
1946, Alma (MI), 2, 5, 0, 0.28571, 59, 117, -58, 
1947, Alma (MI), 5, 2, 1, 0.68750, 113, 85, 28, 
1948, Alma (MI), 8, 0, 0, 1.00000, 170, 57, 113, 
1954, Pennsylvania, 0, 9, 0, 0.00000, 73, 308, -235, 
1955, Pennsylvania, 0, 9, 0, 0.00000, 34, 270, -236, 
1956, Pennsylvania, 4, 5, 0, 0.44444, 96, 216, -120, 
1957, Pennsylvania, 3, 6, 0, 0.33333, 121, 138, -17, 
1958, Pennsylvania, 4, 5, 0, 0.44444, 153, 177, -24, 
1959, Pennsylvania, 7, 1, 1, 0.83333, 195, 74, 121, 
1925, Florida, 8, 2, 0, 0.80000, 222, 80, 142, 
1926, Florida, 2, 6, 2, 0.30000, 94, 137, -43, 
1927, Florida, 7, 3, 0, 0.70000, 164, 96, 68, 
2000, Louisiana College, 2, 8, 0, 0.20000, 196, 302, -106, 
2001, Louisiana College, 4, 6, 0, 0.40000, 207, 258, -51, 
2002, Louisiana College, 4, 6, 0, 0.40000, 268, 307, -39, 
2003, Louisiana College, 4, 6, 0, 0.40000, 180, 327, -147, 
1915, Akron (OH), 1, 7, 1, 0.16667, 20, 239, -219, 
1916, Akron (OH), 2, 7, 0, 0.22222, 90, 183, -93, 
1917, Akron (OH), 5, 3, 0, 0.62500, 143, 84, 59, 
1918, Akron (OH), 2, 2, 1, 0.50000, 69, 47, 22, 
1919, Akron (OH), 6, 1, 1, 0.81250, 139, 38, 101, 
1920, Akron (OH), 4, 4, 0, 0.50000, 99, 93, 6, 
1921, Akron (OH), 5, 3, 0, 0.62500, 117, 69, 48, 
1922, Akron (OH), 5, 3, 0, 0.62500, 141, 53, 88, 
1923, Akron (OH), 4, 3, 1, 0.56250, 92, 37, 55, 
1975, Cornell (NY), 1, 8, 0, 0.11111, 151, 247, -96, 
1976, Cornell (NY), 2, 7, 0, 0.22222, 109, 177, -68, 
1949, North Alabama, 4, 5, 0, 0.44444, 180, 134, 46, 
1950, North Alabama, 5, 4, 0, 0.55556, 116, 72, 44, 
1951, North Alabama, 6, 3, 0, 0.66667, 195, 117, 78, 
1952, North Alabama, 8, 1, 0, 0.88889, 280, 106, 174, 
1953, North Alabama, 6, 1, 1, 0.81250, 180, 59, 121, 
1954, North Alabama, 8, 2, 0, 0.80000, 213, 102, 111, 
1955, North Alabama, 7, 3, 0, 0.70000, 209, 112, 97, 
1956, North Alabama, 6, 3, 0, 0.66667, 201, 154, 47, 
1957, North Alabama, 6, 4, 0, 0.60000, 239, 116, 123, 
1958, North Alabama, 4, 5, 0, 0.44444, 126, 175, -49, 
1959, North Alabama, 5, 4, 1, 0.55000, 179, 188, -9, 
1960, North Alabama, 7, 3, 0, 0.70000, 164, 151, 13, 
1961, North Alabama, 7, 3, 0, 0.70000, 144, 102, 42, 
1962, North Alabama, 5, 4, 1, 0.55000, 167, 149, 18, 
1963, North Alabama, 3, 5, 2, 0.40000, 110, 171, -61, 
1964, North Alabama, 2, 6, 1, 0.27778, 61, 130, -69, 
1965, North Alabama, 4, 6, 0, 0.40000, 150, 206, -56, 
1966, North Alabama, 4, 4, 1, 0.50000, 164, 196, -32, 
1967, North Alabama, 2, 6, 1, 0.27778, 188, 194, -6, 
1968, North Alabama, 5, 5, 0, 0.50000, 243, 178, 65, 
1969, North Alabama, 5, 4, 0, 0.55556, 186, 120, 66, 
1955, Indiana St., 2, 7, 0, 0.22222, 112, 198, -86, 
1975, Miami (FL), 2, 8, 0, 0.20000, 157, 239, -82, 
1976, Miami (FL), 3, 8, 0, 0.27273, 207, 213, -6, 
2013, Occidental (CA), 5, 4, 0, 0.55556, 298, 316, -18, 
1980, New York Tech, 4, 5, 2, 0.45455, 142, 207, -65, 
1981, New York Tech, 5, 4, 1, 0.55000, 165, 176, -11, 
1900, Wisconsin-Oshkosh, 2, 5, 1, 0.31250, 37, 45, -8, 
1953, Ball St. (IN), 5, 2, 1, 0.68750, 163, 125, 38, 
1954, Ball St. (IN), 6, 2, 0, 0.75000, 218, 113, 105, 
1955, Ball St. (IN), 3, 5, 0, 0.37500, 97, 144, -47, 
1983, Boise St. (ID), 6, 5, 0, 0.54545, 281, 194, 87, 
1984, Boise St. (ID), 6, 5, 0, 0.54545, 256, 227, 29, 
1985, Boise St. (ID), 7, 4, 0, 0.63636, 288, 211, 77, 
1986, Boise St. (ID), 5, 6, 0, 0.45455, 262, 183, 79, 
1987, Cal Poly-San Luis Obispo, 7, 3, 0, 0.70000, 275, 173, 102, 
1988, Cal Poly-San Luis Obispo, 5, 4, 1, 0.55000, 238, 145, 93, 
1989, Cal Poly-San Luis Obispo, 5, 5, 0, 0.50000, 230, 227, 3, 
1990, Cal Poly-San Luis Obispo, 10, 2, 0, 0.83333, 304, 167, 137, 
1991, Cal Poly-San Luis Obispo, 4, 6, 0, 0.40000, 271, 272, -1, 
1992, Cal Poly-San Luis Obispo, 4, 5, 1, 0.45000, 253, 217, 36, 
1993, Cal Poly-San Luis Obispo, 6, 4, 0, 0.60000, 365, 201, 164, 
2002, Georgia Southern, 11, 3, 0, 0.78571, 493, 190, 303, 
2003, Georgia Southern, 7, 4, 0, 0.63636, 311, 232, 79, 
2004, Georgia Southern, 9, 3, 0, 0.75000, 564, 221, 343, 
2005, Georgia Southern, 8, 4, 0, 0.66667, 456, 277, 179, 
1943, Maine, 0, 1, 0, 0.00000, 6, 20, -14, 
1975, Western Connecticut St., 2, 6, 0, 0.25000, 97, 160, -63, 
1976, Western Connecticut St., 5, 4, 0, 0.55556, 133, 104, 29, 
1923, Valparaiso (IN), 5, 2, 1, 0.68750, 215, 32, 183, 
1924, Valparaiso (IN), 4, 3, 2, 0.55556, 86, 43, 43, 
2002, Webber International (FL), 3, 1, 0, 0.75000, 85, 68, 17, 
2003, Webber International (FL), 3, 7, 0, 0.30000, 236, 324, -88, 
2004, Webber International (FL), 4, 5, 0, 0.44444, 192, 243, -51, 
2005, Webber International (FL), 6, 2, 0, 0.75000, 244, 153, 91, 
2013, Syracuse (NY), 7, 6, 0, 0.53846, 295, 330, -35, 
2000, Glenville St. (WV), 3, 8, 0, 0.27273, 171, 288, -117, 
2001, Glenville St. (WV), 6, 3, 0, 0.66667, 209, 252, -43, 
2002, Glenville St. (WV), 4, 7, 0, 0.36364, 259, 362, -103, 
2003, Glenville St. (WV), 5, 6, 0, 0.45455, 288, 307, -19, 
2004, Buffalo St. (NY), 4, 6, 0, 0.40000, 141, 259, -118, 
2005, Buffalo St. (NY), 3, 6, 0, 0.33333, 186, 264, -78, 
2006, Buffalo St. (NY), 3, 7, 0, 0.30000, 190, 325, -135, 
2007, Buffalo St. (NY), 2, 8, 0, 0.20000, 208, 292, -84, 
2008, Buffalo St. (NY), 1, 9, 0, 0.10000, 225, 344, -119, 
1976, Western Illinois, 7, 3, 0, 0.70000, 219, 222, -3, 
1977, Western Illinois, 3, 7, 0, 0.30000, 165, 236, -71, 
1978, Western Illinois, 3, 6, 1, 0.35000, 153, 235, -82, 
1982, West Liberty St. (WV), 3, 6, 1, 0.35000, 174, 243, -69, 
1983, West Liberty St. (WV), 4, 4, 2, 0.50000, 150, 202, -52, 
1984, West Liberty St. (WV), 1, 9, 0, 0.10000, 117, 251, -134, 
1985, West Liberty St. (WV), 2, 8, 0, 0.20000, 141, 227, -86, 
1986, West Liberty St. (WV), 4, 6, 0, 0.40000, 186, 222, -36, 
1987, West Liberty St. (WV), 6, 4, 0, 0.60000, 170, 152, 18, 
1988, West Liberty St. (WV), 4, 6, 0, 0.40000, 106, 162, -56, 
1989, West Liberty St. (WV), 4, 6, 0, 0.40000, 153, 181, -28, 
2007, Miami (FL), 5, 7, 0, 0.41667, 247, 312, -65, 
2008, Miami (FL), 7, 6, 0, 0.53846, 352, 314, 38, 
2009, Miami (FL), 9, 4, 0, 0.69231, 394, 288, 106, 
2010, Miami (FL), 7, 5, 0, 0.58333, 325, 236, 89, 
1912, Connecticut, 5, 5, 0, 0.50000, 74, 124, -50, 
1912, Cornell (NY), 3, 7, 0, 0.30000, 63, 136, -73, 
1913, Cornell (NY), 5, 4, 1, 0.55000, 132, 89, 43, 
1914, Cornell (NY), 8, 2, 0, 0.80000, 257, 54, 203, 
1915, Cornell (NY), 9, 0, 0, 1.00000, 287, 50, 237, 
1916, Cornell (NY), 6, 2, 0, 0.75000, 165, 73, 92, 
1917, Cornell (NY), 3, 6, 0, 0.33333, 78, 146, -68, 
1919, Yale (CT), 5, 3, 0, 0.62500, 148, 35, 113, 
1974, Virginia Tech, 4, 7, 0, 0.36364, 278, 261, 17, 
1975, Virginia Tech, 8, 3, 0, 0.72727, 238, 151, 87, 
1976, Virginia Tech, 6, 5, 0, 0.54545, 223, 176, 47, 
1977, Virginia Tech, 3, 7, 1, 0.31818, 174, 210, -36, 
1915, Tulane (LA), 4, 4, 0, 0.50000, 118, 78, 40, 
1916, Tulane (LA), 4, 3, 1, 0.56250, 126, 149, -23, 
1917, Tulane (LA), 5, 3, 0, 0.62500, 159, 105, 54, 
1918, Tulane (LA), 4, 1, 1, 0.75000, 133, 16, 117, 
1919, Tulane (LA), 6, 2, 1, 0.72222, 224, 55, 169, 
1920, Tulane (LA), 6, 2, 1, 0.72222, 181, 28, 153, 
1922, Tulane (LA), 4, 4, 0, 0.50000, 136, 100, 36, 
1923, Tulane (LA), 6, 3, 1, 0.65000, 117, 89, 28, 
1924, Tulane (LA), 8, 1, 0, 0.88889, 201, 59, 142, 
1925, Tulane (LA), 9, 0, 1, 0.95000, 246, 23, 223, 
1926, Tulane (LA), 3, 5, 1, 0.38889, 71, 60, 11, 
1927, Loyola (LA), 6, 2, 2, 0.70000, 130, 41, 89, 
1928, Loyola (LA), 7, 3, 0, 0.70000, 220, 85, 135, 
1929, Loyola (LA), 4, 5, 2, 0.45455, 150, 129, 21, 
1930, Loyola (LA), 9, 1, 0, 0.90000, 217, 52, 165, 
1931, Loyola (LA), 5, 4, 0, 0.55556, 154, 91, 63, 
1932, Loyola (LA), 6, 4, 1, 0.59091, 134, 77, 57, 
1933, Chicago (IL), 3, 3, 2, 0.50000, 118, 56, 62, 
1934, Chicago (IL), 4, 4, 0, 0.50000, 113, 106, 7, 
1935, Chicago (IL), 4, 4, 0, 0.50000, 102, 110, -8, 
1936, Chicago (IL), 2, 5, 1, 0.31250, 68, 166, -98, 
1937, Chicago (IL), 1, 6, 0, 0.14286, 45, 143, -98, 
1938, Chicago (IL), 1, 6, 1, 0.18750, 75, 241, -166, 
1939, Chicago (IL), 2, 6, 0, 0.25000, 37, 308, -271, 
1940, Stanford (CA), 10, 0, 0, 1.00000, 196, 85, 111, 
1941, Stanford (CA), 6, 3, 0, 0.66667, 160, 95, 65, 
1942, Maryland, 7, 2, 0, 0.77778, 198, 124, 74, 
1943, Pittsburgh (PA), 3, 5, 0, 0.37500, 114, 180, -66, 
1944, Pittsburgh (PA), 4, 5, 0, 0.44444, 147, 293, -146, 
1945, Pittsburgh (PA), 3, 7, 0, 0.30000, 87, 141, -54, 
1946, Maryland, 3, 6, 0, 0.33333, 136, 193, -57, 
1965, Hawaii, 1, 8, 1, 0.15000, 85, 227, -142, 
1907, Clemson (SC), 4, 4, 0, 0.50000, 67, 45, 22, 
1980, Catawba (NC), 1, 9, 0, 0.10000, 152, 198, -46, 
1981, Catawba (NC), 5, 5, 0, 0.50000, 224, 230, -6, 
1982, Catawba (NC), 2, 9, 0, 0.18182, 189, 226, -37, 
1977, Southwest St. (MN), 1, 8, 0, 0.11111, 67, 302, -235, 
1978, Southwest St. (MN), 2, 8, 0, 0.20000, 79, 268, -189, 
2011, Stanford (CA), 11, 2, 0, 0.84615, 561, 285, 276, 
2012, Stanford (CA), 12, 2, 0, 0.85714, 390, 241, 149, 
2013, Stanford (CA), 11, 3, 0, 0.78571, 452, 266, 186, 
1952, Indianapolis (IN), 5, 3, 0, 0.62500, 149, 114, 35, 
1953, Indianapolis (IN), 8, 0, 0, 1.00000, 154, 52, 102, 
1918, Presbyterian (SC), 2, 0, 0, 1.00000, 33, 7, 26, 
1976, Arkansas-Pine Bluff, 5, 5, 0, 0.50000, 196, 176, 20, 
1977, Arkansas-Pine Bluff, 5, 5, 0, 0.50000, 206, 223, -17, 
1978, Arkansas-Pine Bluff, 4, 6, 0, 0.40000, 191, 252, -61, 
1979, Arkansas-Pine Bluff, 2, 8, 0, 0.20000, 131, 245, -114, 
1924, North Carolina St., 2, 6, 2, 0.30000, 43, 147, -104, 
1925, Nevada, 4, 3, 1, 0.56250, 107, 115, -8, 
1926, Nevada, 4, 4, 0, 0.50000, 116, 119, -3, 
1927, Nevada, 2, 6, 1, 0.27778, 54, 209, -155, 
1928, Nevada, 0, 7, 1, 0.06250, 31, 170, -139, 
1936, Santa Clara (CA), 8, 1, 0, 0.88889, 139, 36, 103, 
1937, Santa Clara (CA), 9, 0, 0, 1.00000, 163, 9, 154, 
1938, Santa Clara (CA), 6, 2, 0, 0.75000, 97, 26, 71, 
1939, Santa Clara (CA), 5, 1, 3, 0.72222, 117, 40, 77, 
1940, Santa Clara (CA), 6, 1, 1, 0.81250, 154, 46, 108, 
1941, Santa Clara (CA), 6, 3, 0, 0.66667, 170, 103, 67, 
1942, Santa Clara (CA), 7, 2, 0, 0.77778, 101, 52, 49, 
1945, California, 4, 5, 1, 0.45000, 93, 107, -14, 
1956, Air Force (CO), 6, 2, 1, 0.72222, 293, 101, 192, 
1957, Air Force (CO), 3, 6, 1, 0.35000, 125, 184, -59, 
1990, San Jose St. (CA), 9, 2, 1, 0.79167, 435, 228, 207, 
1991, San Jose St. (CA), 6, 4, 1, 0.59091, 372, 298, 74, 
1996, Rutgers (NJ), 2, 9, 0, 0.18182, 143, 380, -237, 
1997, Rutgers (NJ), 0, 11, 0, 0.00000, 191, 496, -305, 
1998, Rutgers (NJ), 5, 6, 0, 0.45455, 206, 376, -170, 
1999, Rutgers (NJ), 2, 9, 0, 0.18182, 155, 427, -272, 
2000, Rutgers (NJ), 3, 8, 0, 0.27273, 233, 399, -166, 
1916, Memphis (TN), 2, 3, 1, 0.41667, 152, 90, 62, 
1991, Mary (ND), 7, 2, 0, 0.77778, 261, 157, 104, 
1992, Mary (ND), 6, 2, 1, 0.72222, 289, 191, 98, 
1993, Mary (ND), 8, 3, 0, 0.72727, 395, 194, 201, 
1994, Mary (ND), 6, 3, 0, 0.66667, 289, 160, 129, 
1995, Mary (ND), 11, 2, 0, 0.84615, 437, 195, 242, 
1996, Mary (ND), 7, 4, 0, 0.63636, 221, 206, 15, 
2013, Upper Iowa, 6, 5, 0, 0.54545, 301, 343, -42, 
1970, Carson-Newman (TN), 4, 6, 0, 0.40000, 195, 221, -26, 
1971, Carson-Newman (TN), 10, 2, 0, 0.83333, 282, 129, 153, 
1972, Carson-Newman (TN), 9, 2, 1, 0.79167, 393, 206, 187, 
1973, Carson-Newman (TN), 6, 3, 0, 0.66667, 188, 132, 56, 
1980, Richmond (VA), 5, 6, 0, 0.45455, 218, 255, -37, 
1981, Richmond (VA), 4, 7, 0, 0.36364, 228, 238, -10, 
1982, Richmond (VA), 0, 10, 0, 0.00000, 101, 270, -169, 
1983, Richmond (VA), 3, 8, 0, 0.27273, 169, 287, -118, 
1984, Richmond (VA), 8, 4, 0, 0.66667, 358, 259, 99, 
1985, Richmond (VA), 8, 3, 0, 0.72727, 291, 189, 102, 
1986, Richmond (VA), 4, 7, 0, 0.36364, 272, 215, 57, 
1987, Richmond (VA), 7, 5, 0, 0.58333, 236, 286, -50, 
1988, Richmond (VA), 4, 7, 0, 0.36364, 151, 255, -104, 
1904, Clemson (SC), 3, 3, 1, 0.50000, 50, 45, 5, 
1995, Azusa Pacific (CA), 4, 4, 1, 0.50000, 187, 227, -40, 
1996, Azusa Pacific (CA), 7, 3, 0, 0.70000, 317, 247, 70, 
1997, Azusa Pacific (CA), 4, 5, 0, 0.44444, 163, 215, -52, 
1998, Azusa Pacific (CA), 12, 2, 0, 0.85714, 366, 278, 88, 
2013, Houston Baptist (TX), 3, 4, 0, 0.42857, 171, 260, -89, 
1910, Philadelphia Pharmacy (PA), 0, 3, 0, 0.00000, 5, 83, -78, 
1911, Philadelphia Pharmacy (PA), 0, 3, 0, 0.00000, 0, 99, -99, 
1934, West Virginia Tech, 0, 5, 0, 0.00000, 6, 204, -198, 
1951, Benedict (SC), 7, 3, 0, 0.70000, 196, 167, 29, 
1952, Benedict (SC), 2, 6, 0, 0.25000, 105, 168, -63, 
2013, Defiance (OH), 3, 7, 0, 0.30000, 221, 215, 6, 
1902, Santa Clara (CA), 2, 1, 2, 0.60000, 17, 6, 11, 
1903, Santa Clara (CA), 1, 3, 0, 0.25000, 39, 22, 17, 
1904, Santa Clara (CA), 3, 0, 1, 0.87500, 43, 0, 43, 
1905, Santa Clara (CA), 1, 1, 1, 0.50000, 28, 10, 18, 
1939, Holy Cross (MA), 7, 2, 0, 0.77778, 176, 47, 129, 
1940, Holy Cross (MA), 4, 5, 1, 0.45000, 117, 125, -8, 
1941, Holy Cross (MA), 4, 4, 2, 0.50000, 103, 104, -1, 
1947, Nevada, 9, 2, 0, 0.81818, 321, 154, 167, 
1948, Nevada, 9, 2, 0, 0.81818, 480, 133, 347, 
1949, Nevada, 5, 5, 0, 0.50000, 235, 212, 23, 
1950, Nevada, 1, 9, 0, 0.10000, 117, 363, -246, 
1915, Wabash (IN), 7, 0, 1, 0.93750, 236, 33, 203, 
1916, Wabash (IN), 7, 2, 0, 0.77778, 241, 123, 118, 
1907, Allegheny (PA), 5, 3, 2, 0.60000, 61, 80, -19, 
1908, Allegheny (PA), 3, 4, 1, 0.43750, 55, 83, -28, 
2013, West Virginia Wesleyan, 5, 5, 0, 0.50000, 289, 320, -31, 
1905, Indiana, 8, 1, 1, 0.85000, 240, 38, 202, 
1906, Indiana, 4, 2, 0, 0.66667, 109, 46, 63, 
1907, Indiana, 2, 3, 1, 0.41667, 85, 57, 28, 
1908, Indiana, 3, 4, 0, 0.42857, 43, 70, -27, 
1909, Indiana, 4, 3, 0, 0.57143, 129, 53, 76, 
1910, Indiana, 6, 1, 0, 0.85714, 111, 6, 105, 
1911, Indiana, 3, 3, 1, 0.50000, 74, 46, 28, 
1912, Indiana, 2, 5, 0, 0.28571, 80, 100, -20, 
1913, Indiana, 3, 4, 0, 0.42857, 90, 162, -72, 
1888, Swarthmore (PA), 0, 5, 0, 0.00000, 14, 130, -116, 
1889, Swarthmore (PA), 2, 5, 0, 0.28571, 46, 154, -108, 
1890, Swarthmore (PA), 4, 3, 0, 0.57143, 122, 94, 28, 
1891, Swarthmore (PA), 9, 2, 0, 0.81818, 300, 94, 206, 
1892, Swarthmore (PA), 7, 3, 0, 0.70000, 166, 91, 75, 
1893, Swarthmore (PA), 6, 2, 1, 0.72222, 222, 70, 152, 
1894, Swarthmore (PA), 5, 5, 0, 0.50000, 230, 202, 28, 
1895, Swarthmore (PA), 7, 4, 1, 0.62500, 173, 204, -31, 
1896, Swarthmore (PA), 2, 6, 0, 0.25000, 76, 110, -34, 
1897, Swarthmore (PA), 7, 3, 2, 0.66667, 114, 60, 54, 
1898, Swarthmore (PA), 9, 2, 0, 0.81818, 152, 64, 88, 
1923, Stephen F. Austin (TX), 2, 4, 1, 0.35714, 150, 122, 28, 
1924, Stephen F. Austin (TX), 3, 6, 0, 0.33333, 77, 103, -26, 
1925, Stephen F. Austin (TX), 3, 5, 2, 0.40000, 47, 93, -46, 
1926, Stephen F. Austin (TX), 5, 5, 0, 0.50000, 202, 119, 83, 
1927, Stephen F. Austin (TX), 1, 6, 3, 0.25000, 33, 116, -83, 
1928, Stephen F. Austin (TX), 1, 9, 0, 0.10000, 21, 250, -229, 
1977, Drake (IA), 2, 9, 0, 0.18182, 184, 317, -133, 
1978, Drake (IA), 4, 7, 0, 0.36364, 211, 264, -53, 
1979, Drake (IA), 3, 8, 0, 0.27273, 218, 242, -24, 
1980, Drake (IA), 8, 3, 0, 0.72727, 306, 175, 131, 
1981, Drake (IA), 10, 1, 0, 0.90909, 252, 196, 56, 
1982, Drake (IA), 4, 7, 0, 0.36364, 275, 312, -37, 
1983, Drake (IA), 1, 10, 0, 0.09091, 136, 337, -201, 
1984, Drake (IA), 4, 7, 0, 0.36364, 197, 260, -63, 
1985, Drake (IA), 4, 7, 0, 0.36364, 196, 255, -59, 
1986, Utah St., 3, 8, 0, 0.27273, 134, 243, -109, 
1987, Utah St., 5, 6, 0, 0.45455, 205, 306, -101, 
1988, Utah St., 4, 7, 0, 0.36364, 215, 362, -147, 
1989, Utah St., 4, 7, 0, 0.36364, 191, 355, -164, 
1990, Utah St., 5, 5, 1, 0.50000, 287, 310, -23, 
1991, Utah St., 5, 6, 0, 0.45455, 219, 265, -46, 
1992, Pacific (CA), 3, 8, 0, 0.27273, 253, 287, -34, 
1993, Pacific (CA), 3, 8, 0, 0.27273, 184, 260, -76, 
1994, Pacific (CA), 6, 5, 0, 0.54545, 252, 275, -23, 
1995, Pacific (CA), 3, 8, 0, 0.27273, 240, 439, -199, 
1960, Murray St. (KY), 5, 5, 0, 0.50000, 146, 137, 9, 
1961, Murray St. (KY), 4, 6, 0, 0.40000, 161, 172, -11, 
1962, Murray St. (KY), 5, 5, 0, 0.50000, 121, 131, -10, 
1963, Murray St. (KY), 5, 5, 0, 0.50000, 153, 203, -50, 
1964, Murray St. (KY), 5, 4, 1, 0.55000, 198, 168, 30, 
1965, Murray St. (KY), 2, 6, 2, 0.30000, 158, 188, -30, 
1966, Murray St. (KY), 0, 10, 0, 0.00000, 88, 321, -233, 
1935, Davis & Elkins (WV), 2, 7, 0, 0.22222, 46, 149, -103, 
1936, Davis & Elkins (WV), 3, 6, 1, 0.35000, 84, 174, -90, 
1937, Davis & Elkins (WV), 2, 6, 0, 0.25000, 51, 117, -66, 
1938, Davis & Elkins (WV), 2, 7, 1, 0.25000, 82, 160, -78, 
1939, Davis & Elkins (WV), 5, 4, 1, 0.55000, 82, 66, 16, 
1940, Davis & Elkins (WV), 1, 7, 1, 0.16667, 59, 132, -73, 
1910, Charleston (WV), 0, 2, 1, 0.16667, 6, 20, -14, 
1911, Charleston (WV), 4, 3, 0, 0.57143, 75, 36, 39, 
1912, Charleston (WV), 2, 2, 0, 0.50000, 55, 105, -50, 
1913, Charleston (WV), 2, 2, 2, 0.50000, 38, 34, 4, 
1921, Marshall (WV), 6, 2, 1, 0.72222, 86, 41, 45, 
1922, Marshall (WV), 4, 4, 0, 0.50000, 155, 94, 61, 
1892, Richmond (VA), 2, 3, 0, 0.40000, 46, 64, -18, 
1907, Mercer (GA), 3, 3, 0, 0.50000, 28, 170, -142, 
1943, Kansas, 4, 5, 1, 0.45000, 96, 107, -11, 
1944, Kansas, 3, 6, 1, 0.35000, 128, 153, -25, 
1945, Kansas, 4, 5, 1, 0.45000, 139, 175, -36, 
1892, Kansas, 7, 1, 0, 0.87500, 144, 36, 108, 
1893, Kansas, 2, 5, 0, 0.28571, 85, 108, -23, 
2013, Waynesburg (PA), 7, 4, 0, 0.63636, 318, 259, 59, 
1984, Cal St.-Long Beach, 4, 7, 0, 0.36364, 242, 301, -59, 
1985, Cal St.-Long Beach, 6, 6, 0, 0.50000, 320, 307, 13, 
1986, Cal St.-Long Beach, 6, 5, 0, 0.54545, 250, 260, -10, 
1987, New Mexico, 0, 11, 0, 0.00000, 209, 444, -235, 
1988, New Mexico, 2, 10, 0, 0.16667, 170, 518, -348, 
1989, New Mexico, 2, 10, 0, 0.16667, 298, 378, -80, 
1990, New Mexico, 2, 10, 0, 0.16667, 279, 400, -121, 
1991, New Mexico, 3, 9, 0, 0.25000, 240, 473, -233, 
1914, New Hampshire, 1, 6, 2, 0.22222, 5, 222, -217, 
2013, Wilkes (PA), 4, 6, 0, 0.40000, 224, 241, -17, 
1978, Furman (SC), 8, 3, 0, 0.72727, 322, 195, 127, 
1979, Furman (SC), 5, 6, 0, 0.45455, 281, 313, -32, 
1980, Furman (SC), 9, 1, 1, 0.86364, 284, 177, 107, 
1981, Furman (SC), 8, 3, 0, 0.72727, 293, 210, 83, 
1982, Furman (SC), 9, 3, 0, 0.75000, 290, 158, 132, 
1983, Furman (SC), 10, 2, 1, 0.80769, 422, 137, 285, 
1984, Furman (SC), 8, 3, 0, 0.72727, 363, 180, 183, 
1985, Furman (SC), 12, 2, 0, 0.85714, 520, 231, 289, 
1986, North Carolina St., 8, 3, 1, 0.70833, 328, 274, 54, 
1987, North Carolina St., 4, 7, 0, 0.36364, 212, 302, -90, 
1988, North Carolina St., 8, 3, 1, 0.70833, 312, 165, 147, 
1989, North Carolina St., 7, 5, 0, 0.58333, 290, 230, 60, 
1990, North Carolina St., 7, 5, 0, 0.58333, 298, 189, 109, 
1991, North Carolina St., 9, 3, 0, 0.75000, 304, 222, 82, 
1992, North Carolina St., 9, 3, 1, 0.73077, 335, 211, 124, 
1960, Northern Iowa, 9, 1, 0, 0.90000, 213, 71, 142, 
1961, Northern Iowa, 7, 2, 0, 0.77778, 237, 118, 119, 
1962, Northern Iowa, 7, 1, 1, 0.83333, 191, 89, 102, 
1963, Northern Iowa, 5, 3, 1, 0.61111, 187, 120, 67, 
1964, Northern Iowa, 9, 2, 0, 0.81818, 269, 100, 169, 
1965, Northern Iowa, 4, 5, 0, 0.44444, 160, 146, 14, 
1966, Northern Iowa, 4, 5, 0, 0.44444, 121, 141, -20, 
1967, Northern Iowa, 7, 3, 0, 0.70000, 136, 85, 51, 
1968, Northern Iowa, 5, 5, 0, 0.50000, 195, 173, 22, 
1969, Northern Iowa, 5, 5, 0, 0.50000, 192, 183, 9, 
1970, Northern Iowa, 2, 8, 0, 0.20000, 103, 259, -156, 
1971, Northern Iowa, 4, 5, 0, 0.44444, 106, 117, -11, 
1972, Northern Iowa, 4, 6, 0, 0.40000, 179, 185, -6, 
1973, Northern Iowa, 5, 5, 0, 0.50000, 132, 165, -33, 
1974, Northern Iowa, 5, 4, 1, 0.55000, 268, 248, 20, 
1975, Northern Iowa, 9, 3, 0, 0.75000, 310, 193, 117, 
1976, Northern Iowa, 8, 3, 0, 0.72727, 251, 169, 82, 
1977, Northern Iowa, 6, 5, 0, 0.54545, 233, 270, -37, 
1978, Northern Iowa, 2, 9, 0, 0.18182, 185, 282, -97, 
1979, Northern Iowa, 6, 5, 0, 0.54545, 162, 194, -32, 
1980, Northern Iowa, 7, 4, 0, 0.63636, 334, 187, 147, 
1981, Northern Iowa, 5, 6, 0, 0.45455, 275, 322, -47, 
1982, Northern Iowa, 4, 6, 1, 0.40909, 178, 229, -51, 
1946, Ferris St. (MI), 4, 3, 2, 0.55556, 95, 153, -58, 
1947, Ferris St. (MI), 6, 2, 1, 0.72222, 94, 66, 28, 
1948, Ferris St. (MI), 0, 7, 1, 0.06250, 25, 102, -77, 
1949, Ferris St. (MI), 1, 8, 0, 0.11111, 41, 198, -157, 
1950, Ferris St. (MI), 3, 4, 0, 0.42857, 92, 127, -35, 
1951, Ferris St. (MI), 2, 3, 3, 0.43750, 44, 104, -60, 
1952, Ferris St. (MI), 0, 5, 2, 0.14286, 45, 149, -104, 
1988, Stonehill (MA), 3, 4, 1, 0.43750, 147, 119, 28, 
1989, Stonehill (MA), 6, 3, 0, 0.66667, 207, 174, 33, 
1936, Michigan Tech, 2, 3, 0, 0.40000, 25, 77, -52, 
1937, Michigan Tech, 4, 3, 0, 0.57143, 46, 60, -14, 
1938, Michigan Tech, 1, 5, 0, 0.16667, 27, 140, -113, 
1939, Michigan Tech, 3, 1, 1, 0.70000, 40, 26, 14, 
1940, Michigan Tech, 5, 1, 0, 0.83333, 137, 21, 116, 
1941, Michigan Tech, 3, 3, 0, 0.50000, 58, 53, 5, 
1942, Michigan Tech, 0, 3, 0, 0.00000, 6, 46, -40, 
1931, Henderson St. (AR), 2, 3, 0, 0.40000, 98, 44, 54, 
1932, Henderson St. (AR), 7, 1, 0, 0.87500, 255, 54, 201, 
1933, Henderson St. (AR), 7, 1, 0, 0.87500, 229, 55, 174, 
1934, Henderson St. (AR), 4, 3, 0, 0.57143, 163, 28, 135, 
1935, Arkansas-Monticello, 1, 7, 0, 0.12500, 26, 199, -173, 
1936, Arkansas-Monticello, 2, 5, 0, 0.28571, 31, 87, -56, 
1937, Arkansas-Monticello, 1, 5, 0, 0.16667, 40, 246, -206, 
1952, George Washington (DC), 6, 2, 1, 0.72222, 188, 149, 39, 
1953, George Washington (DC), 5, 4, 0, 0.55556, 166, 124, 42, 
1954, George Washington (DC), 1, 7, 1, 0.16667, 98, 172, -74, 
1955, George Washington (DC), 5, 4, 0, 0.55556, 99, 86, 13, 
1956, George Washington (DC), 8, 1, 1, 0.85000, 171, 81, 90, 
1957, George Washington (DC), 2, 7, 0, 0.22222, 85, 158, -73, 
1958, George Washington (DC), 3, 5, 0, 0.37500, 82, 158, -76, 
1959, George Washington (DC), 1, 8, 0, 0.11111, 53, 191, -138, 
2008, Texas A&M;, 4, 8, 0, 0.33333, 300, 449, -149, 
2009, Texas A&M;, 6, 7, 0, 0.46154, 427, 436, -9, 
2010, Texas A&M;, 9, 4, 0, 0.69231, 406, 285, 121, 
2011, Texas A&M;, 6, 6, 0, 0.50000, 475, 344, 131, 
1894, Iowa, 4, 4, 1, 0.50000, 162, 170, -8, 
1976, Washington St., 3, 8, 0, 0.27273, 240, 331, -91, 
1977, Pittsburgh (PA), 9, 2, 1, 0.79167, 428, 134, 294, 
1978, Pittsburgh (PA), 8, 4, 0, 0.66667, 263, 187, 76, 
1979, Pittsburgh (PA), 11, 1, 0, 0.91667, 291, 116, 175, 
1980, Pittsburgh (PA), 11, 1, 0, 0.91667, 380, 130, 250, 
1981, Pittsburgh (PA), 11, 1, 0, 0.91667, 385, 160, 225, 
1982, Texas A&M;, 5, 6, 0, 0.45455, 286, 314, -28, 
1983, Texas A&M;, 5, 5, 1, 0.50000, 218, 174, 44, 
1984, Texas A&M;, 6, 5, 0, 0.54545, 245, 217, 28, 
1985, Texas A&M;, 10, 2, 0, 0.83333, 375, 196, 179, 
1986, Texas A&M;, 9, 3, 0, 0.75000, 372, 215, 157, 
1987, Texas A&M;, 10, 2, 0, 0.83333, 313, 168, 145, 
1988, Texas A&M;, 7, 5, 0, 0.58333, 293, 253, 40, 
1991, Mississippi St., 7, 5, 0, 0.58333, 291, 194, 97, 
1992, Mississippi St., 7, 5, 0, 0.58333, 252, 197, 55, 
1993, Mississippi St., 4, 5, 2, 0.45455, 241, 245, -4, 
1994, Mississippi St., 8, 4, 0, 0.66667, 373, 262, 111, 
1995, Mississippi St., 3, 8, 0, 0.27273, 261, 357, -96, 
1996, Mississippi St., 5, 6, 0, 0.45455, 249, 229, 20, 
1997, Mississippi St., 7, 4, 0, 0.63636, 226, 215, 11, 
1998, Mississippi St., 8, 5, 0, 0.61538, 350, 256, 94, 
1999, Mississippi St., 10, 2, 0, 0.83333, 255, 156, 99, 
2000, Mississippi St., 8, 4, 0, 0.66667, 390, 306, 84, 
2001, Mississippi St., 3, 8, 0, 0.27273, 196, 288, -92, 
2002, Mississippi St., 3, 9, 0, 0.25000, 227, 339, -112, 
2003, Mississippi St., 2, 10, 0, 0.16667, 225, 471, -246, 
1911, Kansas, 4, 2, 2, 0.62500, 81, 44, 37, 
1901, Mississippi, 2, 4, 0, 0.33333, 34, 129, -95, 
1956, Livingstone (NC), 4, 4, 0, 0.50000, 70, 95, -25, 
1912, Arkansas Tech, 4, 2, 0, 0.66667, 135, 49, 86, 
1913, Arkansas Tech, 7, 2, 1, 0.75000, 166, 73, 93, 
1914, Arkansas Tech, 8, 0, 0, 1.00000, 282, 0, 282, 
1915, Arkansas Tech, 6, 3, 0, 0.66667, 130, 186, -56, 
1999, Azusa Pacific (CA), 9, 3, 0, 0.75000, 429, 384, 45, 
2000, Azusa Pacific (CA), 6, 4, 0, 0.60000, 306, 314, -8, 
2001, Azusa Pacific (CA), 4, 5, 0, 0.44444, 221, 258, -37, 
2002, Azusa Pacific (CA), 9, 1, 0, 0.90000, 314, 150, 164, 
2003, Azusa Pacific (CA), 8, 2, 0, 0.80000, 236, 125, 111, 
2004, Azusa Pacific (CA), 11, 3, 0, 0.78571, 357, 135, 222, 
2005, Azusa Pacific (CA), 6, 4, 0, 0.60000, 221, 214, 7, 
2007, North Carolina-Pembroke, 4, 7, 0, 0.36364, 212, 317, -105, 
2008, North Carolina-Pembroke, 9, 1, 0, 0.90000, 326, 112, 214, 
2009, North Carolina-Pembroke, 9, 2, 0, 0.81818, 369, 166, 203, 
2010, North Carolina-Pembroke, 5, 5, 0, 0.50000, 242, 167, 75, 
2011, North Carolina-Pembroke, 8, 3, 0, 0.72727, 396, 300, 96, 
2012, North Carolina-Pembroke, 6, 4, 0, 0.60000, 273, 241, 32, 
2013, North Carolina-Pembroke, 9, 2, 0, 0.81818, 412, 238, 174, 
1930, Arizona St., 3, 5, 1, 0.38889, 111, 94, 17, 
1931, Arizona St., 6, 2, 0, 0.75000, 170, 66, 104, 
1932, Arizona St., 4, 3, 1, 0.56250, 182, 92, 90, 
1937, New Mexico, 4, 4, 1, 0.50000, 69, 93, -24, 
1938, New Mexico, 8, 3, 0, 0.72727, 199, 72, 127, 
1939, New Mexico, 8, 2, 0, 0.80000, 167, 98, 69, 
1940, New Mexico, 5, 4, 0, 0.55556, 166, 94, 72, 
1941, New Mexico, 5, 4, 1, 0.55000, 116, 135, -19, 
1949, Montana, 5, 4, 0, 0.55556, 179, 200, -21, 
1950, Montana, 5, 5, 0, 0.50000, 227, 147, 80, 
1951, Montana, 2, 7, 0, 0.22222, 108, 266, -158, 
1917, Marshall (WV), 1, 7, 1, 0.16667, 8, 345, -337, 
1919, Delaware, 2, 5, 1, 0.31250, 42, 197, -155, 
1920, Delaware, 3, 5, 1, 0.38889, 55, 201, -146, 
1910, Arizona, 5, 0, 0, 1.00000, 87, 8, 79, 
1911, Arizona, 3, 1, 1, 0.70000, 16, 3, 13, 
1967, Mississippi St., 1, 9, 0, 0.10000, 49, 259, -210, 
1968, Mississippi St., 0, 8, 2, 0.10000, 146, 260, -114, 
1969, Mississippi St., 3, 7, 0, 0.30000, 193, 385, -192, 
1970, Mississippi St., 6, 5, 0, 0.54545, 171, 264, -93, 
1971, Mississippi St., 2, 9, 0, 0.18182, 120, 311, -191, 
1972, Mississippi St., 4, 7, 0, 0.36364, 197, 254, -57, 
1913, West Texas A&M;, 4, 2, 0, 0.66667, 52, 9, 43, 
1914, West Texas A&M;, 3, 3, 0, 0.50000, 149, 51, 98, 
1915, West Texas A&M;, 4, 3, 0, 0.57143, 75, 63, 12, 
1916, West Texas A&M;, 1, 5, 0, 0.16667, 30, 120, -90, 
1917, West Texas A&M;, 2, 3, 1, 0.41667, 46, 117, -71, 
1945, Kentucky, 2, 8, 0, 0.20000, 96, 217, -121, 
1898, Washington St., 0, 0, 1, 0.50000, 0, 0, 0, 
1899, Washington St., 1, 1, 0, 0.50000, 21, 11, 10, 
1989, Bowie St. (MD), 7, 3, 1, 0.68182, 232, 254, -22, 
1990, Bowie St. (MD), 3, 6, 0, 0.33333, 170, 229, -59, 
1991, Bowie St. (MD), 4, 5, 0, 0.44444, 174, 222, -48, 
1992, Bowie St. (MD), 1, 10, 0, 0.09091, 120, 297, -177, 
1909, Lenoir-Rhyne (NC), 3, 5, 0, 0.37500, 49, 80, -31, 
1974, Texas Christian, 1, 10, 0, 0.09091, 79, 345, -266, 
1975, Texas Christian, 1, 10, 0, 0.09091, 103, 325, -222, 
1976, Texas Christian, 0, 11, 0, 0.00000, 128, 430, -302, 
2003, Columbia (NY), 4, 6, 0, 0.40000, 211, 283, -72, 
2004, Columbia (NY), 1, 9, 0, 0.10000, 140, 265, -125, 
2005, Columbia (NY), 2, 8, 0, 0.20000, 116, 337, -221, 
1932, Lenoir-Rhyne (NC), 5, 4, 1, 0.55000, 88, 99, -11, 
1933, Lenoir-Rhyne (NC), 3, 3, 3, 0.50000, 72, 46, 26, 
1934, Lenoir-Rhyne (NC), 5, 4, 1, 0.55000, 176, 59, 117, 
1935, Lenoir-Rhyne (NC), 4, 4, 1, 0.50000, 78, 70, 8, 
1936, Lenoir-Rhyne (NC), 3, 6, 1, 0.35000, 38, 124, -86, 
1938, Lenoir-Rhyne (NC), 4, 3, 2, 0.55556, 117, 64, 53, 
1939, Lenoir-Rhyne (NC), 6, 1, 3, 0.75000, 174, 60, 114, 
1940, Lenoir-Rhyne (NC), 6, 3, 0, 0.66667, 92, 91, 1, 
1941, Lenoir-Rhyne (NC), 4, 6, 0, 0.40000, 99, 127, -28, 
1902, Delaware, 3, 5, 1, 0.38889, 74, 106, -32, 
1906, Delaware, 5, 2, 0, 0.71429, 44, 27, 17, 
1896, Kentucky, 3, 6, 0, 0.33333, 122, 134, -12, 
1900, Colgate (NY), 3, 7, 0, 0.30000, 41, 82, -41, 
1924, Duquesne (PA), 2, 4, 2, 0.37500, 26, 106, -80, 
1904, Nevada, 3, 3, 0, 0.50000, 55, 69, -14, 
1905, Oregon, 4, 2, 2, 0.62500, 65, 39, 26, 
1931, Jacksonville St. (AL), 0, 7, 1, 0.06250, 51, 172, -121, 
1932, Jacksonville St. (AL), 3, 2, 1, 0.58333, 50, 40, 10, 
1933, Jacksonville St. (AL), 1, 5, 1, 0.21429, 72, 115, -43, 
1934, Jacksonville St. (AL), 5, 4, 0, 0.55556, 99, 123, -24, 
1935, Jacksonville St. (AL), 2, 4, 0, 0.33333, 64, 93, -29, 
1936, Jacksonville St. (AL), 1, 2, 1, 0.37500, 47, 74, -27, 
1937, Jacksonville St. (AL), 0, 5, 0, 0.00000, 0, 136, -136, 
1924, Hardin-Simmons (TX), 2, 6, 0, 0.25000, 70, 98, -28, 
1925, Hardin-Simmons (TX), 7, 2, 0, 0.77778, 153, 74, 79, 
1923, West Liberty St. (WV), 1, 4, 2, 0.28571, 7, 39, -32, 
1973, Delaware Valley (PA), 4, 3, 1, 0.56250, 127, 147, -20, 
1974, Delaware Valley (PA), 2, 6, 0, 0.25000, 112, 140, -28, 
1975, Delaware Valley (PA), 0, 8, 0, 0.00000, 56, 152, -96, 
1926, Franklin & Marshall (PA), 0, 8, 1, 0.05556, 12, 190, -178, 
1927, Franklin & Marshall (PA), 1, 7, 1, 0.16667, 27, 140, -113, 
1928, West Virginia Tech, 5, 1, 1, 0.78571, 53, 32, 21, 
1929, West Virginia Tech, 6, 1, 1, 0.81250, 170, 28, 142, 
1930, West Virginia Tech, 5, 2, 1, 0.68750, 129, 40, 89, 
1931, West Virginia Tech, 5, 2, 1, 0.68750, 195, 34, 161, 
1932, West Virginia Tech, 3, 3, 1, 0.50000, 130, 33, 97, 
1933, West Virginia Tech, 4, 2, 0, 0.66667, 96, 79, 17, 
1964, Southern Illinois, 2, 8, 0, 0.20000, 123, 238, -115, 
1965, Southern Illinois, 2, 8, 0, 0.20000, 104, 217, -113, 
1989, Virginia Military Institute, 2, 8, 1, 0.22727, 151, 306, -155, 
1990, Virginia Military Institute, 4, 7, 0, 0.36364, 251, 346, -95, 
1991, Virginia Military Institute, 4, 7, 0, 0.36364, 243, 373, -130, 
1992, Virginia Military Institute, 3, 8, 0, 0.27273, 245, 315, -70, 
1993, Virginia Military Institute, 1, 10, 0, 0.09091, 139, 396, -257, 
2003, Alabama, 4, 9, 0, 0.30769, 331, 333, -2, 
2004, Alabama, 6, 6, 0, 0.50000, 295, 189, 106, 
2005, Alabama, 0, 2, 0, 0.00000, 263, 128, 135, 
2006, Alabama, 0, 6, 0, 0.00000, 267, 216, 51, 
2013, Southwest Baptist (MO), 1, 10, 0, 0.09091, 237, 478, -241, 
1971, Wyoming, 5, 6, 0, 0.45455, 222, 309, -87, 
1972, Wyoming, 4, 7, 0, 0.36364, 223, 309, -86, 
1973, Wyoming, 4, 7, 0, 0.36364, 248, 290, -42, 
1974, Wyoming, 2, 9, 0, 0.18182, 150, 283, -133, 
1920, Kentucky Wesleyan, 2, 4, 1, 0.35714, 34, 108, -74, 
1921, Kentucky Wesleyan, 0, 7, 1, 0.06250, 6, 323, -317, 
1911, Hamilton (NY), 3, 3, 1, 0.50000, 44, 28, 16, 
1912, Hamilton (NY), 2, 4, 1, 0.35714, 76, 84, -8, 
1988, Worcester Tech (MA), 4, 4, 0, 0.50000, 190, 199, -9, 
1989, Worcester Tech (MA), 8, 2, 0, 0.80000, 348, 220, 128, 
1990, Worcester Tech (MA), 8, 0, 1, 0.94444, 297, 140, 157, 
1991, Worcester Tech (MA), 7, 3, 0, 0.70000, 333, 175, 158, 
1992, Worcester Tech (MA), 9, 2, 0, 0.81818, 344, 166, 178, 
1993, Amherst (MA), 3, 5, 0, 0.37500, 83, 143, -60, 
1994, Amherst (MA), 5, 3, 0, 0.62500, 213, 166, 47, 
1995, Amherst (MA), 5, 2, 1, 0.68750, 155, 105, 50, 
1996, Amherst (MA), 7, 1, 0, 0.87500, 200, 67, 133, 
1997, Yale (CT), 2, 8, 0, 0.20000, 113, 250, -137, 
1998, Yale (CT), 6, 4, 0, 0.60000, 228, 259, -31, 
1999, Yale (CT), 9, 1, 0, 0.90000, 315, 160, 155, 
2000, Yale (CT), 7, 3, 0, 0.70000, 276, 183, 93, 
2001, Yale (CT), 3, 6, 0, 0.33333, 214, 249, -35, 
2002, Yale (CT), 6, 4, 0, 0.60000, 257, 188, 69, 
2003, Yale (CT), 6, 4, 0, 0.60000, 354, 284, 70, 
2004, Yale (CT), 5, 5, 0, 0.50000, 179, 207, -28, 
2005, Yale (CT), 4, 6, 0, 0.40000, 228, 207, 21, 
2006, Yale (CT), 8, 2, 0, 0.80000, 257, 208, 49, 
2007, Yale (CT), 9, 1, 0, 0.90000, 294, 137, 157, 
2008, Yale (CT), 6, 4, 0, 0.60000, 197, 105, 92, 
1947, Pacific (CA), 10, 1, 0, 0.90909, 373, 111, 262, 
1948, Pacific (CA), 7, 1, 2, 0.80000, 356, 147, 209, 
1949, Pacific (CA), 11, 0, 0, 1.00000, 575, 66, 509, 
1950, Pacific (CA), 7, 3, 1, 0.68182, 348, 131, 217, 
1951, Arizona St., 6, 3, 1, 0.65000, 308, 176, 132, 
1907, Delaware Valley (PA), 4, 4, 0, 0.50000, 68, 76, -8, 
1891, Wake Forest (NC), 1, 0, 0, 1.00000, 4, 6, -2, 
1892, Wake Forest (NC), 4, 0, 1, 0.90000, 94, 18, 76, 
1893, Wake Forest (NC), 1, 2, 0, 0.33333, 70, 52, 18, 
1948, Kansas, 7, 3, 0, 0.70000, 199, 137, 62, 
1949, Kansas, 5, 5, 0, 0.50000, 259, 183, 76, 
1950, Kansas, 6, 4, 0, 0.60000, 284, 188, 96, 
1951, Kansas, 8, 2, 0, 0.80000, 316, 208, 108, 
1952, Kansas, 7, 3, 0, 0.70000, 214, 110, 104, 
1953, Kansas, 2, 8, 0, 0.20000, 83, 179, -96, 
1894, Louisiana St., 2, 1, 0, 0.66667, 72, 26, 46, 
1895, Louisiana St., 3, 0, 0, 1.00000, 36, 16, 20, 
1952, Alabama St., 4, 5, 0, 0.44444, 137, 194, -57, 
1953, Alabama St., 5, 4, 0, 0.55556, 165, 59, 106, 
1954, Alabama St., 5, 3, 1, 0.61111, 193, 78, 115, 
1955, Alabama St., 7, 2, 0, 0.77778, 187, 92, 95, 
1956, Alabama St., 4, 4, 1, 0.50000, 140, 98, 42, 
1957, Alabama St., 4, 5, 0, 0.44444, 76, 94, -18, 
1958, Alabama St., 6, 2, 0, 0.75000, 116, 72, 44, 
1959, Alabama St., 4, 2, 2, 0.62500, 140, 121, 19, 
1960, Alabama St., 5, 3, 0, 0.62500, 144, 68, 76, 
1961, Alabama St., 1, 7, 0, 0.12500, 70, 163, -93, 
1995, Oklahoma St., 4, 8, 0, 0.33333, 250, 345, -95, 
1996, Oklahoma St., 5, 6, 0, 0.45455, 243, 327, -84, 
1997, Oklahoma St., 8, 4, 0, 0.66667, 352, 233, 119, 
1998, Oklahoma St., 5, 6, 0, 0.45455, 303, 296, 7, 
1999, Oklahoma St., 5, 6, 0, 0.45455, 267, 274, -7, 
2000, Oklahoma St., 3, 8, 0, 0.27273, 202, 303, -101, 
1976, Stephen F. Austin (TX), 1, 9, 1, 0.13636, 83, 343, -260, 
1977, Stephen F. Austin (TX), 2, 8, 0, 0.20000, 106, 224, -118, 
1978, Stephen F. Austin (TX), 3, 8, 0, 0.27273, 143, 213, -70, 
1979, Stephen F. Austin (TX), 8, 3, 0, 0.72727, 313, 147, 166, 
1980, Stephen F. Austin (TX), 4, 6, 0, 0.40000, 157, 219, -62, 
1981, Stephen F. Austin (TX), 1, 10, 0, 0.09091, 122, 313, -191, 
1908, Northern Iowa, 5, 0, 0, 1.00000, 125, 5, 120, 
1909, Northern Iowa, 6, 0, 0, 1.00000, 131, 22, 109, 
1910, Truman St. (MO), 3, 4, 0, 0.42857, 41, 91, -50, 
1911, Truman St. (MO), 0, 5, 0, 0.00000, 6, 62, -56, 
1958, Alcorn St. (MS), 0, 9, 0, 0.00000, 41, 328, -287, 
1959, Alcorn St. (MS), 3, 5, 0, 0.37500, 114, 130, -16, 
1909, Davidson (NC), 3, 4, 2, 0.44444, 64, 96, -32, 
1910, Davidson (NC), 6, 2, 0, 0.75000, 221, 36, 185, 
1920, Central Michigan, 4, 3, 1, 0.56250, 166, 41, 125, 
1951, South Carolina St., 5, 2, 0, 0.71429, 128, 92, 36, 
1952, South Carolina St., 7, 2, 0, 0.77778, 146, 50, 96, 
1961, Tennessee St., 4, 4, 1, 0.50000, 151, 150, 1, 
1962, Tennessee St., 1, 7, 1, 0.16667, 88, 171, -83, 
1994, North Texas, 7, 4, 1, 0.62500, 343, 261, 82, 
1995, North Texas, 2, 9, 0, 0.18182, 200, 424, -224, 
1996, North Texas, 5, 6, 0, 0.45455, 161, 293, -132, 
1997, North Texas, 4, 7, 0, 0.36364, 232, 331, -99, 
1942, Tulane (LA), 4, 5, 0, 0.44444, 121, 154, -33, 
1943, Tulane (LA), 3, 3, 0, 0.50000, 92, 94, -2, 
1944, Tulane (LA), 4, 3, 0, 0.57143, 113, 125, -12, 
1945, Tulane (LA), 2, 6, 1, 0.27778, 93, 212, -119, 
1985, Northern Colorado, 2, 9, 0, 0.18182, 184, 387, -203, 
1986, Northern Colorado, 3, 8, 0, 0.27273, 217, 286, -69, 
1987, Northern Colorado, 3, 8, 0, 0.27273, 221, 288, -67, 
1988, Northern Colorado, 5, 5, 0, 0.50000, 303, 303, 0, 
1946, Southern Oregon, 8, 0, 0, 1.00000, 176, 42, 134, 
1947, Southern Oregon, 7, 2, 0, 0.77778, 205, 81, 124, 
1948, Southern Oregon, 5, 5, 0, 0.50000, 173, 121, 52, 
1949, Southern Oregon, 5, 2, 1, 0.68750, 178, 136, 42, 
1950, Southern Oregon, 2, 7, 0, 0.22222, 119, 219, -100, 
1943, Missouri, 3, 5, 0, 0.37500, 170, 142, 28, 
1944, Missouri, 3, 5, 2, 0.40000, 176, 224, -48, 
1945, Missouri, 6, 4, 0, 0.60000, 170, 174, -4, 
1898, Oregon, 3, 1, 0, 0.75000, 167, 21, 146, 
1899, Oregon, 4, 2, 1, 0.64286, 108, 17, 91, 
1901, California, 9, 0, 1, 0.95000, 106, 15, 91, 
2006, Tennessee-Martin, 9, 3, 0, 0.75000, 298, 188, 110, 
2007, Tennessee-Martin, 4, 7, 0, 0.36364, 367, 333, 34, 
2008, Tennessee-Martin, 8, 4, 0, 0.66667, 448, 316, 132, 
2009, Tennessee-Martin, 5, 6, 0, 0.45455, 300, 323, -23, 
2010, Tennessee-Martin, 6, 5, 0, 0.54545, 237, 254, -17, 
2011, Tennessee-Martin, 5, 6, 0, 0.45455, 381, 306, 75, 
2012, Tennessee-Martin, 8, 3, 0, 0.72727, 369, 323, 46, 
2013, Tennessee-Martin, 7, 5, 0, 0.58333, 283, 330, -47, 
1982, Toledo (OH), 6, 5, 0, 0.54545, 184, 162, 22, 
1983, Toledo (OH), 9, 2, 0, 0.81818, 276, 167, 109, 
1984, Toledo (OH), 8, 3, 1, 0.70833, 187, 164, 23, 
1985, Toledo (OH), 4, 7, 0, 0.36364, 135, 187, -52, 
1986, Toledo (OH), 7, 4, 0, 0.63636, 216, 197, 19, 
1987, Toledo (OH), 3, 7, 1, 0.31818, 165, 245, -80, 
1988, Toledo (OH), 6, 5, 0, 0.54545, 244, 221, 23, 
1989, Toledo (OH), 6, 5, 0, 0.54545, 254, 272, -18, 
1896, Furman (SC), 2, 3, 0, 0.40000, 28, 32, -4, 
1976, Minnesota-Crookston, 6, 2, 0, 0.75000, 162, 121, 41, 
1977, Minnesota-Crookston, 5, 4, 0, 0.55556, 160, 120, 40, 
1978, Minnesota-Crookston, 7, 2, 0, 0.77778, 120, 100, 20, 
1979, Minnesota-Crookston, 6, 3, 0, 0.66667, 139, 151, -12, 
1980, Minnesota-Crookston, 3, 5, 1, 0.38889, 104, 138, -34, 
1981, Minnesota-Crookston, 4, 5, 0, 0.44444, 83, 123, -40, 
1982, Minnesota-Crookston, 7, 3, 0, 0.70000, 189, 151, 38, 
1983, Minnesota-Crookston, 7, 1, 0, 0.87500, 245, 39, 206, 
1984, Minnesota-Crookston, 7, 1, 0, 0.87500, 136, 86, 50, 
1985, Minnesota-Crookston, 4, 4, 0, 0.50000, 142, 125, 17, 
1986, Minnesota-Crookston, 3, 5, 0, 0.37500, 157, 175, -18, 
1987, Minnesota-Crookston, 3, 5, 0, 0.37500, 143, 179, -36, 
1988, Minnesota-Crookston, 4, 4, 0, 0.50000, 155, 110, 45, 
1989, Minnesota-Crookston, 4, 4, 0, 0.50000, 227, 148, 79, 
1990, Minnesota-Crookston, 4, 4, 0, 0.50000, 124, 127, -3, 
1991, Minnesota-Crookston, 4, 4, 0, 0.50000, 125, 166, -41, 
1992, Minnesota-Crookston, 5, 3, 0, 0.62500, 127, 96, 31, 
1993, Minnesota-Crookston, 4, 4, 0, 0.50000, 154, 222, -68, 
1994, Minnesota-Crookston, 4, 4, 0, 0.50000, 154, 171, -17, 
2012, Anna Maria (MA), 2, 8, 0, 0.20000, 251, 413, -162, 
2013, Anna Maria (MA), 2, 8, 0, 0.20000, 207, 369, -162, 
1902, Louisiana Tech, 1, 1, 0, 0.50000, 6, 40, -34, 
1957, Boston (MA), 5, 3, 0, 0.62500, 196, 141, 55, 
1958, Boston (MA), 4, 5, 0, 0.44444, 168, 211, -43, 
1959, Boston (MA), 4, 5, 0, 0.44444, 102, 150, -48, 
1960, Boston (MA), 3, 5, 2, 0.40000, 130, 172, -42, 
1961, Boston (MA), 4, 5, 0, 0.44444, 100, 142, -42, 
1962, Boston (MA), 2, 7, 0, 0.22222, 94, 156, -62, 
1963, Boston (MA), 1, 6, 1, 0.18750, 43, 162, -119, 
2013, Washington & Jefferson (PA), 8, 3, 0, 0.72727, 402, 240, 162, 
1929, North Texas, 4, 3, 2, 0.55556, 179, 76, 103, 
1930, North Texas, 5, 4, 1, 0.55000, 86, 136, -50, 
1931, North Texas, 8, 3, 0, 0.72727, 171, 72, 99, 
1932, North Texas, 8, 1, 1, 0.85000, 180, 26, 154, 
1933, North Texas, 3, 4, 2, 0.44444, 49, 50, -1, 
1934, North Texas, 5, 4, 1, 0.55000, 57, 86, -29, 
1935, North Texas, 5, 3, 1, 0.61111, 134, 103, 31, 
1936, North Texas, 6, 2, 1, 0.72222, 120, 38, 82, 
1937, North Texas, 4, 4, 2, 0.50000, 74, 83, -9, 
1938, North Texas, 7, 4, 0, 0.63636, 184, 92, 92, 
1939, North Texas, 6, 1, 0, 0.85714, 116, 42, 74, 
1940, North Texas, 6, 3, 0, 0.66667, 199, 79, 120, 
1941, North Texas, 7, 1, 0, 0.87500, 165, 77, 88, 
1991, West Alabama, 6, 5, 0, 0.54545, 164, 217, -53, 
1992, West Alabama, 5, 4, 0, 0.55556, 212, 277, -65, 
1993, West Alabama, 2, 7, 1, 0.25000, 303, 420, -117, 
1918, Fordham (NY), 4, 2, 1, 0.64286, 68, 39, 29, 
1943, Bucknell (PA), 6, 4, 0, 0.60000, 113, 83, 30, 
1919, Bowling Green (OH), 0, 3, 0, 0.00000, 0, 28, -28, 
1979, Abilene Christian (TX), 7, 4, 0, 0.63636, 285, 212, 73, 
1980, Abilene Christian (TX), 2, 8, 0, 0.20000, 132, 263, -131, 
1981, Abilene Christian (TX), 8, 2, 0, 0.80000, 293, 187, 106, 
1982, Abilene Christian (TX), 7, 3, 1, 0.68182, 281, 206, 75, 
1983, Abilene Christian (TX), 7, 3, 0, 0.70000, 256, 200, 56, 
1984, Abilene Christian (TX), 3, 7, 0, 0.30000, 173, 208, -35, 
2005, Concordia College (AL), 6, 4, 0, 0.60000, 303, 260, 43, 
2006, Concordia College (AL), 2, 8, 0, 0.20000, 119, 271, -152, 
2007, Concordia College (AL), 3, 8, 0, 0.27273, 196, 357, -161, 
2008, Concordia College (AL), 5, 6, 0, 0.45455, 251, 327, -76, 
2009, Concordia College (AL), 5, 5, 0, 0.50000, 355, 208, 147, 
2010, Concordia College (AL), 5, 4, 0, 0.55556, 178, 235, -57, 
2011, Concordia College (AL), 5, 4, 0, 0.55556, 179, 212, -33, 
2012, Concordia College (AL), 2, 1, 0, 0.66667, 61, 59, 2, 
1904, Marquette (WI), 6, 2, 0, 0.75000, 140, 45, 95, 
1988, Delta St. (MS), 4, 6, 1, 0.40909, 213, 214, -1, 
1989, Delta St. (MS), 6, 3, 1, 0.65000, 214, 202, 12, 
1990, Delta St. (MS), 5, 5, 0, 0.50000, 207, 187, 20, 
1991, Delta St. (MS), 3, 7, 0, 0.30000, 195, 209, -14, 
1992, Delta St. (MS), 3, 6, 1, 0.35000, 159, 299, -140, 
1950, Duquesne (PA), 2, 6, 1, 0.27778, 169, 265, -96, 
1892, Maryland, 0, 3, 0, 0.00000, 0, 128, -128, 
1900, Arizona, 3, 1, 0, 0.75000, 131, 6, 125, 
1901, Arizona, 4, 1, 0, 0.80000, 115, 19, 96, 
1953, Rensselaer Tech (NY), 1, 6, 1, 0.18750, 89, 240, -151, 
2000, Jamestown (ND), 3, 7, 0, 0.30000, 212, 281, -69, 
2001, Jamestown (ND), 5, 5, 0, 0.50000, 270, 251, 19, 
2002, Jamestown (ND), 5, 5, 0, 0.50000, 218, 194, 24, 
2003, Jamestown (ND), 4, 6, 0, 0.40000, 166, 265, -99, 
1893, Franklin & Marshall (PA), 4, 2, 1, 0.64286, 96, 96, 0, 
2006, Tuskegee (AL), 10, 2, 0, 0.83333, 319, 224, 95, 
2007, Tuskegee (AL), 12, 0, 0, 1.00000, 562, 193, 369, 
2008, Tuskegee (AL), 10, 1, 0, 0.90909, 404, 200, 204, 
2009, Tuskegee (AL), 10, 2, 0, 0.83333, 320, 191, 129, 
2010, Tuskegee (AL), 9, 2, 0, 0.81818, 311, 169, 142, 
2011, Tuskegee (AL), 4, 6, 0, 0.40000, 179, 194, -15, 
2012, Tuskegee (AL), 10, 2, 0, 0.83333, 345, 167, 178, 
2013, Tuskegee (AL), 8, 3, 0, 0.72727, 347, 187, 160, 
1912, Southern Mississippi, 2, 1, 0, 0.66667, 36, 6, 30, 
1972, Howard Payne (TX), 5, 4, 0, 0.55556, 156, 156, 0, 
1973, Howard Payne (TX), 9, 3, 0, 0.75000, 291, 133, 158, 
1974, Howard Payne (TX), 5, 6, 0, 0.45455, 225, 224, 1, 
1975, Howard Payne (TX), 5, 5, 1, 0.50000, 180, 257, -77, 
1976, Howard Payne (TX), 1, 8, 1, 0.15000, 133, 288, -155, 
1977, Howard Payne (TX), 2, 8, 0, 0.20000, 196, 268, -72, 
1978, Howard Payne (TX), 2, 8, 0, 0.20000, 122, 297, -175, 
1969, Truman St. (MO), 6, 2, 1, 0.72222, 188, 120, 68, 
1970, Truman St. (MO), 7, 2, 0, 0.77778, 239, 169, 70, 
1971, Truman St. (MO), 9, 1, 0, 0.90000, 213, 135, 78, 
1973, Vanderbilt (TN), 5, 6, 0, 0.45455, 181, 262, -81, 
1974, Vanderbilt (TN), 7, 3, 2, 0.66667, 313, 199, 114, 
1975, Texas Tech, 6, 5, 0, 0.54545, 272, 251, 21, 
1976, Texas Tech, 10, 2, 0, 0.83333, 336, 206, 130, 
1977, Texas Tech, 7, 5, 0, 0.58333, 299, 246, 53, 
1978, Mississippi, 5, 6, 0, 0.45455, 181, 240, -59, 
1979, Mississippi, 4, 7, 0, 0.36364, 251, 298, -47, 
1980, Mississippi, 3, 8, 0, 0.27273, 263, 266, -3, 
1981, Mississippi, 4, 6, 1, 0.40909, 167, 284, -117, 
1982, Mississippi, 4, 7, 0, 0.36364, 208, 262, -54, 
1983, Duke (NC), 3, 8, 0, 0.27273, 246, 350, -104, 
1984, Duke (NC), 2, 9, 0, 0.18182, 128, 301, -173, 
1985, Duke (NC), 4, 7, 0, 0.36364, 193, 252, -59, 
1986, Duke (NC), 4, 7, 0, 0.36364, 200, 284, -84, 
1989, Texas A&M;, 8, 4, 0, 0.66667, 343, 192, 151, 
1990, Texas A&M;, 9, 3, 1, 0.73077, 465, 232, 233, 
1991, Texas A&M;, 10, 2, 0, 0.83333, 404, 154, 250, 
1992, Texas A&M;, 12, 1, 0, 0.92308, 352, 196, 156, 
1993, Texas A&M;, 10, 2, 0, 0.83333, 425, 143, 282, 
1994, Texas A&M;, 10, 0, 1, 0.95455, 319, 147, 172, 
1995, Texas A&M;, 9, 3, 0, 0.75000, 327, 168, 159, 
1996, Texas A&M;, 6, 6, 0, 0.50000, 351, 257, 94, 
1997, Texas A&M;, 9, 4, 0, 0.69231, 445, 236, 209, 
1998, Texas A&M;, 11, 3, 0, 0.78571, 335, 214, 121, 
1999, Texas A&M;, 8, 4, 0, 0.66667, 318, 232, 86, 
2000, Texas A&M;, 7, 5, 0, 0.58333, 348, 239, 109, 
2001, Texas A&M;, 8, 4, 0, 0.66667, 248, 213, 35, 
2002, Texas A&M;, 6, 6, 0, 0.50000, 345, 280, 65, 
1995, Kentucky St., 7, 4, 0, 0.63636, 159, 169, -10, 
1996, Kentucky St., 5, 6, 0, 0.45455, 204, 226, -22, 
1997, Kentucky St., 7, 5, 0, 0.58333, 275, 236, 39, 
1998, Kentucky St., 5, 6, 0, 0.45455, 263, 292, -29, 
1999, Kentucky St., 5, 6, 0, 0.45455, 280, 257, 23, 
2000, Kentucky St., 4, 7, 0, 0.36364, 267, 328, -61, 
2003, North Carolina A&T;, 10, 3, 0, 0.76923, 294, 236, 58, 
2004, North Carolina A&T;, 3, 8, 0, 0.27273, 180, 303, -123, 
2005, North Carolina A&T;, 3, 8, 0, 0.27273, 188, 276, -88, 
1986, Lehigh (PA), 5, 6, 0, 0.45455, 258, 300, -42, 
1987, Lehigh (PA), 5, 5, 1, 0.50000, 221, 201, 20, 
1988, Lehigh (PA), 6, 5, 0, 0.54545, 351, 300, 51, 
1989, Lehigh (PA), 5, 6, 0, 0.45455, 371, 360, 11, 
1990, Lehigh (PA), 7, 4, 0, 0.63636, 329, 211, 118, 
1991, Lehigh (PA), 9, 2, 0, 0.81818, 363, 235, 128, 
1992, Lehigh (PA), 3, 8, 0, 0.27273, 258, 291, -33, 
1993, Lehigh (PA), 7, 4, 0, 0.63636, 309, 336, -27, 
1984, Johnson C. Smith (NC), 3, 7, 0, 0.30000, 128, 251, -123, 
1985, Johnson C. Smith (NC), 1, 9, 0, 0.10000, 134, 228, -94, 
1986, Johnson C. Smith (NC), 5, 5, 0, 0.50000, 134, 134, 0, 
1987, Johnson C. Smith (NC), 4, 5, 2, 0.45455, 129, 123, 6, 
1988, Johnson C. Smith (NC), 2, 7, 1, 0.25000, 151, 239, -88, 
1989, Johnson C. Smith (NC), 4, 5, 0, 0.44444, 169, 267, -98, 
1990, Johnson C. Smith (NC), 0, 9, 0, 0.00000, 95, 305, -210, 
1898, Allegheny (PA), 3, 5, 0, 0.37500, 139, 151, -12, 
1902, Eastern Illinois, 1, 2, 0, 0.33333, 21, 20, 1, 
1909, Pennsylvania, 7, 1, 2, 0.80000, 146, 38, 108, 
1910, Pennsylvania, 9, 1, 1, 0.86364, 184, 19, 165, 
1911, Pennsylvania, 7, 4, 0, 0.63636, 131, 83, 48, 
1912, Pennsylvania, 7, 4, 0, 0.63636, 191, 106, 85, 
1913, Purdue (IN), 4, 1, 2, 0.71429, 171, 20, 151, 
1914, Purdue (IN), 5, 2, 0, 0.71429, 157, 63, 94, 
1915, Purdue (IN), 3, 3, 1, 0.50000, 62, 62, 0, 
1916, California, 6, 4, 1, 0.59091, 192, 103, 89, 
1917, California, 5, 5, 1, 0.50000, 149, 104, 45, 
1918, California, 7, 2, 0, 0.77778, 187, 62, 125, 
1919, California, 6, 2, 1, 0.72222, 147, 64, 83, 
1920, California, 9, 0, 0, 1.00000, 510, 14, 496, 
1921, California, 9, 0, 1, 0.95000, 312, 33, 279, 
1922, California, 9, 0, 0, 1.00000, 398, 34, 364, 
1923, California, 9, 0, 1, 0.95000, 182, 7, 175, 
1924, California, 8, 0, 2, 0.90000, 162, 51, 111, 
1925, California, 6, 3, 0, 0.66667, 192, 49, 143, 
1956, Alma (MI), 2, 7, 0, 0.22222, 98, 181, -83, 
1957, Alma (MI), 5, 2, 2, 0.66667, 163, 109, 54, 
1958, Alma (MI), 5, 3, 0, 0.62500, 169, 116, 53, 
1959, Alma (MI), 5, 4, 0, 0.55556, 188, 101, 87, 
1960, Alma (MI), 2, 7, 0, 0.22222, 133, 143, -10, 
1961, Alma (MI), 2, 6, 0, 0.25000, 71, 159, -88, 
1962, Alma (MI), 0, 8, 0, 0.00000, 64, 271, -207, 
1918, Tulsa (OK), 1, 2, 0, 0.33333, 9, 56, -47, 
1904, Miami (OH), 1, 5, 0, 0.16667, 12, 283, -271, 
1954, Southern Arkansas, 7, 3, 1, 0.68182, 164, 152, 12, 
1955, Southern Arkansas, 6, 4, 0, 0.60000, 163, 139, 24, 
1956, Southern Arkansas, 2, 8, 0, 0.20000, 103, 216, -113, 
1957, Southern Arkansas, 4, 5, 0, 0.44444, 96, 136, -40, 
1958, Southern Arkansas, 2, 8, 0, 0.20000, 64, 247, -183, 
1959, Southern Arkansas, 6, 3, 0, 0.66667, 184, 107, 77, 
1960, Southern Arkansas, 5, 4, 0, 0.55556, 170, 105, 65, 
1961, Southern Arkansas, 6, 3, 0, 0.66667, 207, 120, 87, 
1962, Southern Arkansas, 2, 7, 0, 0.22222, 69, 149, -80, 
1963, Southern Arkansas, 2, 7, 0, 0.22222, 41, 127, -86, 
1964, Southern Arkansas, 4, 6, 0, 0.40000, 105, 102, 3, 
1965, Southern Arkansas, 4, 6, 0, 0.40000, 160, 202, -42, 
1966, Southern Arkansas, 5, 3, 0, 0.62500, 192, 177, 15, 
1967, Southern Arkansas, 5, 3, 1, 0.61111, 165, 151, 14, 
1968, Southern Arkansas, 3, 6, 0, 0.33333, 113, 185, -72, 
1929, Georgia Southern, 3, 3, 2, 0.50000, 102, 44, 58, 
1930, Georgia Southern, 3, 4, 1, 0.43750, 46, 110, -64, 
1931, Georgia Southern, 3, 6, 0, 0.33333, 142, 92, 50, 
1932, Georgia Southern, 6, 2, 0, 0.75000, 137, 57, 80, 
1933, Georgia Southern, 5, 4, 0, 0.55556, 167, 75, 92, 
1934, Georgia Southern, 4, 6, 0, 0.40000, 114, 129, -15, 
1935, Georgia Southern, 3, 3, 2, 0.50000, 98, 89, 9, 
1936, Georgia Southern, 2, 9, 0, 0.18182, 45, 230, -185, 
1937, Georgia Southern, 2, 9, 0, 0.18182, 58, 272, -214, 
1938, Georgia Southern, 3, 5, 1, 0.38889, 35, 100, -65, 
1939, Georgia Southern, 5, 5, 0, 0.50000, 93, 124, -31, 
1940, Georgia Southern, 3, 5, 0, 0.37500, 91, 184, -93, 
1941, Georgia Southern, 2, 8, 0, 0.20000, 37, 229, -192, 
1897, Wisconsin-Oshkosh, 3, 3, 1, 0.50000, 39, 68, -29, 
1949, Virginia Union, 1, 8, 0, 0.11111, 60, 190, -130, 
1916, Oklahoma Baptist University, 1, 3, 1, 0.30000, 32, 89, -57, 
1984, Southeast Missouri St., 1, 10, 0, 0.09091, 140, 332, -192, 
1985, Southeast Missouri St., 4, 7, 0, 0.36364, 274, 293, -19, 
1986, Southeast Missouri St., 6, 5, 0, 0.54545, 252, 250, 2, 
1987, Southeast Missouri St., 6, 4, 1, 0.59091, 266, 208, 58, 
1989, Southern Illinois, 2, 9, 0, 0.18182, 222, 290, -68, 
1990, Southern Illinois, 2, 9, 0, 0.18182, 174, 313, -139, 
1991, Southern Illinois, 7, 4, 0, 0.63636, 238, 271, -33, 
1992, Southern Illinois, 4, 7, 0, 0.36364, 350, 409, -59, 
1993, Southern Illinois, 2, 9, 0, 0.18182, 252, 373, -121, 
1987, Chadron St. (NE), 2, 7, 0, 0.22222, 167, 267, -100, 
1988, Chadron St. (NE), 5, 5, 0, 0.50000, 244, 273, -29, 
1989, Chadron St. (NE), 8, 2, 0, 0.80000, 341, 210, 131, 
1990, Chadron St. (NE), 9, 2, 0, 0.81818, 409, 212, 197, 
1991, Chadron St. (NE), 5, 5, 1, 0.50000, 343, 289, 54, 
1992, Chadron St. (NE), 7, 3, 0, 0.70000, 291, 242, 49, 
1993, Chadron St. (NE), 6, 5, 0, 0.54545, 345, 323, 22, 
1994, Chadron St. (NE), 9, 2, 0, 0.81818, 403, 187, 216, 
1995, Chadron St. (NE), 8, 2, 0, 0.80000, 268, 177, 91, 
1996, Chadron St. (NE), 10, 2, 0, 0.83333, 319, 187, 132, 
1997, Chadron St. (NE), 8, 3, 0, 0.72727, 326, 159, 167, 
1998, Chadron St. (NE), 9, 3, 0, 0.75000, 353, 184, 169, 
1999, Chadron St. (NE), 7, 3, 0, 0.70000, 289, 182, 107, 
2000, Chadron St. (NE), 8, 3, 0, 0.72727, 384, 185, 199, 
2001, Chadron St. (NE), 10, 1, 0, 0.90909, 466, 149, 317, 
2002, Chadron St. (NE), 8, 2, 0, 0.80000, 336, 159, 177, 
2003, Chadron St. (NE), 8, 2, 0, 0.80000, 356, 255, 101, 
2004, Chadron St. (NE), 7, 3, 0, 0.70000, 378, 296, 82, 
2011, Chadron St. (NE), 0, 1, 0, 0.00000, 114, 82, 32, 
2002, North Greenville (SC), 4, 6, 0, 0.40000, 228, 290, -62, 
2003, North Greenville (SC), 6, 5, 0, 0.54545, 349, 337, 12, 
1949, Pittsburg St. (KS), 8, 2, 1, 0.77273, 295, 145, 150, 
1950, Pittsburg St. (KS), 5, 5, 0, 0.50000, 155, 168, -13, 
1951, Pittsburg St. (KS), 7, 3, 0, 0.70000, 201, 79, 122, 
1952, Pittsburg St. (KS), 5, 4, 1, 0.55000, 161, 132, 29, 
1953, Pittsburg St. (KS), 6, 3, 1, 0.65000, 138, 107, 31, 
1954, Pittsburg St. (KS), 6, 2, 0, 0.75000, 188, 89, 99, 
1955, Pittsburg St. (KS), 7, 3, 0, 0.70000, 151, 107, 44, 
1956, Pittsburg St. (KS), 7, 2, 1, 0.75000, 214, 101, 113, 
1957, Pittsburg St. (KS), 11, 0, 0, 1.00000, 347, 79, 268, 
1958, Pittsburg St. (KS), 4, 5, 1, 0.45000, 154, 182, -28, 
1959, Pittsburg St. (KS), 6, 3, 0, 0.66667, 178, 119, 59, 
1960, Pittsburg St. (KS), 8, 1, 0, 0.88889, 307, 103, 204, 
1961, Pittsburg St. (KS), 11, 0, 0, 1.00000, 339, 46, 293, 
1962, Pittsburg St. (KS), 6, 3, 0, 0.66667, 172, 135, 37, 
1963, Pittsburg St. (KS), 5, 3, 1, 0.61111, 191, 121, 70, 
1964, Pittsburg St. (KS), 4, 5, 0, 0.44444, 124, 172, -48, 
1965, Pittsburg St. (KS), 3, 6, 0, 0.33333, 123, 155, -32, 
1966, Pittsburg St. (KS), 7, 2, 0, 0.77778, 197, 189, 8, 
2013, Grove City (PA), 5, 5, 0, 0.50000, 244, 296, -52, 
1948, Indiana, 2, 7, 0, 0.22222, 75, 217, -142, 
1949, Indiana, 1, 8, 0, 0.11111, 117, 254, -137, 
1950, Indiana, 3, 5, 1, 0.38889, 99, 155, -56, 
1951, Indiana, 2, 7, 0, 0.22222, 118, 191, -73, 
1952, Arizona St., 6, 3, 0, 0.66667, 247, 121, 126, 
1953, Arizona St., 4, 5, 1, 0.45000, 207, 203, 4, 
1954, Arizona St., 5, 5, 0, 0.50000, 178, 228, -50, 
1972, Oklahoma St., 7, 4, 0, 0.63636, 259, 203, 56, 
1973, Southern Methodist (TX), 6, 4, 1, 0.59091, 259, 228, 31, 
1974, Southern Methodist (TX), 6, 4, 1, 0.59091, 221, 240, -19, 
1975, Southern Methodist (TX), 4, 7, 0, 0.36364, 208, 301, -93, 
1971, Ferris St. (MI), 5, 5, 0, 0.50000, 204, 172, 32, 
1950, Central Oklahoma, 7, 3, 0, 0.70000, 253, 167, 86, 
1951, Central Oklahoma, 2, 7, 0, 0.22222, 127, 226, -99, 
2001, Kentucky St., 3, 8, 0, 0.27273, 143, 379, -236, 
2002, Kentucky St., 3, 8, 0, 0.27273, 264, 364, -100, 
2003, Kentucky St., 7, 4, 0, 0.63636, 272, 214, 58, 
1914, Wake Forest (NC), 3, 6, 0, 0.33333, 86, 221, -135, 
1915, Wake Forest (NC), 3, 4, 0, 0.42857, 161, 90, 71, 
1941, Alabama A&M;, 6, 4, 0, 0.60000, 230, 67, 163, 
1894, DePauw (IN), 4, 4, 0, 0.50000, 139, 144, -5, 
1902, Connecticut, 4, 3, 0, 0.57143, 84, 66, 18, 
1903, Connecticut, 4, 5, 0, 0.44444, 92, 90, 2, 
1904, Connecticut, 6, 3, 1, 0.65000, 99, 85, 14, 
1905, Connecticut, 2, 2, 0, 0.50000, 27, 59, -32, 
1946, Campbell (NC), 6, 1, 0, 0.85714, 219, 32, 187, 
1947, Campbell (NC), 7, 2, 0, 0.77778, 169, 77, 92, 
1948, Campbell (NC), 6, 2, 0, 0.75000, 182, 102, 80, 
1949, Campbell (NC), 2, 5, 1, 0.31250, 74, 162, -88, 
1950, Campbell (NC), 2, 5, 2, 0.33333, 52, 143, -91, 
1946, Southern Arkansas, 4, 5, 0, 0.44444, 98, 158, -60, 
1947, Southern Arkansas, 9, 2, 1, 0.79167, 224, 90, 134, 
1948, Southern Arkansas, 8, 2, 0, 0.80000, 244, 109, 135, 
1949, Southern Arkansas, 3, 7, 0, 0.30000, 112, 141, -29, 
1950, Southern Arkansas, 6, 4, 1, 0.59091, 206, 122, 84, 
1951, Southern Arkansas, 9, 1, 0, 0.90000, 283, 98, 185, 
1952, Southern Arkansas, 10, 1, 0, 0.90909, 227, 123, 104, 
1953, Southern Arkansas, 5, 5, 0, 0.50000, 125, 194, -69, 
1957, Adams St. (CO), 0, 9, 1, 0.05000, 125, 390, -265, 
1958, Adams St. (CO), 1, 8, 0, 0.11111, 73, 220, -147, 
1897, Montana, 1, 2, 3, 0.41667, 32, 54, -22, 
1900, Illinois, 7, 3, 2, 0.66667, 184, 67, 117, 
1904, Fordham (NY), 4, 1, 1, 0.75000, 70, 12, 58, 
1906, Fordham (NY), 5, 3, 0, 0.62500, 139, 38, 101, 
1907, Fordham (NY), 6, 1, 1, 0.81250, 245, 25, 220, 
1921, Hampton (VA), 2, 3, 0, 0.40000, 36, 69, -33, 
1922, Hampton (VA), 6, 1, 0, 0.85714, 46, 25, 21, 
1923, Hampton (VA), 5, 2, 0, 0.71429, 83, 41, 42, 
1924, Hampton (VA), 5, 2, 1, 0.68750, 76, 37, 39, 
1925, Hampton (VA), 4, 1, 1, 0.75000, 62, 3, 59, 
1926, Hampton (VA), 7, 0, 1, 0.93750, 166, 19, 147, 
1927, Hampton (VA), 5, 1, 1, 0.78571, 115, 33, 82, 
1928, Hampton (VA), 8, 1, 0, 0.88889, 233, 20, 213, 
1929, Hampton (VA), 3, 5, 0, 0.37500, 62, 40, 22, 
1930, Hampton (VA), 5, 2, 1, 0.68750, 124, 68, 56, 
1931, Hampton (VA), 8, 0, 1, 0.94444, 187, 6, 181, 
1932, Hampton (VA), 5, 2, 1, 0.68750, 97, 39, 58, 
1933, Hampton (VA), 7, 1, 1, 0.83333, 186, 33, 153, 
1934, Hampton (VA), 3, 5, 0, 0.37500, 64, 79, -15, 
1935, Hampton (VA), 7, 1, 0, 0.87500, 157, 40, 117, 
1936, Hampton (VA), 5, 2, 1, 0.68750, 126, 31, 95, 
1937, Hampton (VA), 3, 6, 0, 0.33333, 77, 144, -67, 
1938, Hampton (VA), 4, 3, 1, 0.56250, 74, 74, 0, 
1939, Hampton (VA), 3, 3, 1, 0.50000, 63, 46, 17, 
1940, Hampton (VA), 3, 4, 1, 0.43750, 51, 48, 3, 
1922, Monmouth (IL), 2, 6, 0, 0.25000, 59, 126, -67, 
1923, Monmouth (IL), 6, 3, 1, 0.65000, 175, 81, 94, 
1924, Monmouth (IL), 5, 4, 1, 0.55000, 116, 95, 21, 
1904, Eastern Washington, 1, 6, 0, 0.14286, 9, 93, -84, 
1905, Eastern Washington, 4, 3, 0, 0.57143, 136, 34, 102, 
1948, Furman (SC), 2, 6, 1, 0.27778, 40, 148, -108, 
1949, Furman (SC), 3, 6, 0, 0.33333, 122, 160, -38, 
1934, Campbell (NC), 4, 5, 1, 0.45000, 154, 120, 34, 
1935, Campbell (NC), 3, 7, 0, 0.30000, 85, 179, -94, 
1936, Campbell (NC), 4, 6, 0, 0.40000, 88, 111, -23, 
1937, Campbell (NC), 4, 4, 3, 0.50000, 120, 136, -16, 
1938, Campbell (NC), 5, 2, 1, 0.68750, 109, 59, 50, 
1939, Campbell (NC), 7, 2, 0, 0.77778, 190, 26, 164, 
1971, Albany St. (GA), 3, 5, 1, 0.38889, 96, 202, -106, 
1972, Albany St. (GA), 7, 2, 1, 0.75000, 180, 133, 47, 
1973, Albany St. (GA), 6, 3, 1, 0.65000, 207, 129, 78, 
1984, Albany St. (GA), 7, 2, 0, 0.77778, 195, 112, 83, 
1985, Albany St. (GA), 9, 2, 0, 0.81818, 302, 128, 174, 
1986, Albany St. (GA), 9, 2, 0, 0.81818, 275, 97, 178, 
1987, Albany St. (GA), 8, 3, 0, 0.72727, 222, 179, 43, 
1988, Albany St. (GA), 8, 2, 0, 0.80000, 295, 97, 198, 
1989, Albany St. (GA), 5, 5, 0, 0.50000, 218, 133, 85, 
1990, Albany St. (GA), 6, 4, 0, 0.60000, 256, 135, 121, 
1991, Albany St. (GA), 3, 7, 0, 0.30000, 178, 268, -90, 
1992, Albany St. (GA), 6, 3, 1, 0.65000, 284, 137, 147, 
1993, Albany St. (GA), 11, 1, 0, 0.91667, 312, 129, 183, 
1994, Albany St. (GA), 10, 2, 0, 0.83333, 378, 165, 213, 
1995, Albany St. (GA), 8, 4, 0, 0.66667, 464, 213, 251, 
1996, Albany St. (GA), 8, 3, 0, 0.72727, 264, 174, 90, 
1997, Albany St. (GA), 11, 1, 0, 0.91667, 231, 96, 135, 
1998, Albany St. (GA), 9, 2, 0, 0.81818, 309, 140, 169, 
1999, Albany St. (GA), 7, 3, 0, 0.70000, 270, 144, 126, 
1899, Amherst (MA), 4, 8, 1, 0.34615, 72, 211, -139, 
1901, Amherst (MA), 4, 6, 2, 0.41667, 88, 102, -14, 
1902, Amherst (MA), 7, 3, 0, 0.70000, 133, 55, 78, 
1903, Amherst (MA), 7, 3, 0, 0.70000, 102, 72, 30, 
1904, Amherst (MA), 9, 1, 0, 0.90000, 179, 27, 152, 
1905, Amherst (MA), 3, 1, 2, 0.66667, 66, 28, 38, 
1906, Amherst (MA), 3, 3, 1, 0.50000, 30, 50, -20, 
1965, Davidson (NC), 6, 4, 0, 0.60000, 175, 141, 34, 
1966, Davidson (NC), 4, 5, 0, 0.44444, 209, 183, 26, 
1967, Davidson (NC), 4, 5, 0, 0.44444, 213, 222, -9, 
1968, Davidson (NC), 3, 6, 0, 0.33333, 181, 223, -42, 
1969, Davidson (NC), 7, 4, 0, 0.63636, 366, 274, 92, 
1970, Pacific (CA), 5, 6, 0, 0.45455, 166, 231, -65, 
1971, Pacific (CA), 3, 8, 0, 0.27273, 176, 198, -22, 
1974, Army (NY), 3, 8, 0, 0.27273, 156, 306, -150, 
1975, Army (NY), 2, 9, 0, 0.18182, 165, 337, -172, 
1976, Army (NY), 5, 6, 0, 0.45455, 201, 267, -66, 
1977, Army (NY), 7, 4, 0, 0.63636, 287, 245, 42, 
1978, Army (NY), 4, 6, 1, 0.40909, 184, 255, -71, 
1947, Hofstra (NY), 5, 3, 0, 0.62500, 155, 90, 65, 
1948, Hofstra (NY), 0, 6, 2, 0.12500, 44, 203, -159, 
1949, Hofstra (NY), 1, 5, 1, 0.21429, 45, 159, -114, 
1922, Loyola Marymount (CA), 3, 4, 1, 0.43750, 99, 55, 44, 
1897, Oregon, 1, 1, 0, 0.50000, 18, 26, -8, 
1989, Idaho, 9, 3, 0, 0.75000, 407, 314, 93, 
1990, Idaho, 9, 4, 0, 0.69231, 477, 342, 135, 
1991, Idaho, 6, 5, 0, 0.54545, 375, 313, 62, 
1992, Idaho, 9, 3, 0, 0.75000, 466, 247, 219, 
1993, Idaho, 11, 3, 0, 0.78571, 593, 353, 240, 
1994, Idaho, 9, 3, 0, 0.75000, 493, 289, 204, 
1995, Utah St., 4, 7, 0, 0.36364, 293, 287, 6, 
1996, Utah St., 6, 5, 0, 0.54545, 330, 339, -9, 
1997, Utah St., 6, 6, 0, 0.50000, 389, 296, 93, 
1998, Louisville (KY), 7, 5, 0, 0.58333, 473, 435, 38, 
1999, Louisville (KY), 7, 5, 0, 0.58333, 443, 365, 78, 
2000, Louisville (KY), 9, 3, 0, 0.75000, 405, 268, 137, 
2001, Louisville (KY), 11, 2, 0, 0.84615, 394, 223, 171, 
2002, Louisville (KY), 7, 6, 0, 0.53846, 374, 319, 55, 
2003, Michigan St., 8, 5, 0, 0.61538, 363, 293, 70, 
2004, Michigan St., 5, 7, 0, 0.41667, 353, 326, 27, 
2005, Michigan St., 5, 6, 0, 0.45455, 372, 316, 56, 
2006, Michigan St., 4, 8, 0, 0.33333, 302, 341, -39, 
2012, Arkansas, 4, 8, 0, 0.33333, 282, 365, -83, 
2013, Fort Lewis (CO), 4, 7, 0, 0.36364, 161, 334, -173, 
1931, North Carolina St., 3, 6, 0, 0.33333, 60, 104, -44, 
1932, North Carolina St., 6, 1, 2, 0.77778, 97, 29, 68, 
1933, North Carolina St., 1, 5, 3, 0.27778, 23, 62, -39, 
1936, Duquesne (PA), 8, 2, 0, 0.80000, 140, 28, 112, 
1937, Duquesne (PA), 6, 4, 0, 0.60000, 151, 52, 99, 
1938, Duquesne (PA), 4, 6, 0, 0.40000, 96, 114, -18, 
1908, Rutgers (NJ), 3, 5, 1, 0.38889, 53, 104, -51, 
2013, Linfield (OR), 11, 1, 0, 0.91667, 585, 169, 416, 
1956, Eastern Illinois, 2, 7, 0, 0.22222, 89, 293, -204, 
1925, Texas A&M-Kingsville;, 4, 2, 1, 0.64286, 117, 32, 85, 
1926, Texas A&M-Kingsville;, 4, 3, 0, 0.57143, 152, 52, 100, 
1927, Texas A&M-Kingsville;, 4, 1, 0, 0.80000, 121, 19, 102, 
1928, Texas A&M-Kingsville;, 4, 4, 0, 0.50000, 158, 63, 95, 
1903, West Virginia Wesleyan, 3, 4, 0, 0.42857, 71, 146, -75, 
1920, Western Kentucky, 0, 1, 0, 0.00000, 0, 13, -13, 
1921, Western Kentucky, 2, 4, 1, 0.35714, 47, 86, -39, 
1976, Tulane (LA), 2, 9, 0, 0.18182, 149, 228, -79, 
1977, Tulane (LA), 3, 8, 0, 0.27273, 181, 289, -108, 
1978, Tulane (LA), 4, 7, 0, 0.36364, 183, 211, -28, 
1979, Tulane (LA), 9, 3, 0, 0.75000, 320, 179, 141, 
1980, Arizona, 5, 6, 0, 0.45455, 215, 275, -60, 
1981, Arizona, 6, 5, 0, 0.54545, 253, 205, 48, 
1982, Arizona, 6, 4, 1, 0.59091, 311, 219, 92, 
1983, Arizona, 7, 3, 1, 0.68182, 343, 188, 155, 
1984, Arizona, 7, 4, 0, 0.63636, 272, 192, 80, 
1985, Arizona, 8, 3, 1, 0.70833, 252, 146, 106, 
1986, Arizona, 9, 3, 0, 0.75000, 352, 204, 148, 
1987, Southern California, 8, 4, 0, 0.66667, 321, 229, 92, 
1988, Southern California, 10, 2, 0, 0.83333, 370, 184, 186, 
1989, Southern California, 9, 2, 1, 0.79167, 336, 132, 204, 
1990, Southern California, 8, 4, 1, 0.65385, 348, 274, 74, 
1991, Southern California, 3, 8, 0, 0.27273, 229, 276, -47, 
1992, Southern California, 6, 5, 1, 0.54167, 264, 249, 15, 
1994, Missouri, 3, 8, 1, 0.29167, 208, 325, -117, 
1995, Missouri, 3, 8, 0, 0.27273, 186, 311, -125, 
1996, Missouri, 5, 6, 0, 0.45455, 278, 376, -98, 
1997, Missouri, 7, 5, 0, 0.58333, 392, 367, 25, 
1998, Missouri, 8, 4, 0, 0.66667, 334, 236, 98, 
1999, Missouri, 4, 7, 0, 0.36364, 224, 371, -147, 
2000, Missouri, 3, 8, 0, 0.27273, 255, 348, -93, 
1958, Mississippi Valley St., 3, 5, 0, 0.37500, 72, 216, -144, 
1964, Tuskegee (AL), 5, 2, 2, 0.66667, 113, 102, 11, 
1965, Tuskegee (AL), 7, 3, 0, 0.70000, 186, 89, 97, 
1966, Tuskegee (AL), 7, 3, 0, 0.70000, 377, 178, 199, 
1967, Tuskegee (AL), 8, 0, 1, 0.94444, 225, 88, 137, 
1968, Tuskegee (AL), 8, 2, 0, 0.80000, 244, 107, 137, 
1969, Tuskegee (AL), 7, 3, 0, 0.70000, 269, 156, 113, 
1970, Kentucky St., 3, 6, 0, 0.33333, 121, 252, -131, 
1971, Kentucky St., 8, 3, 0, 0.72727, 303, 189, 114, 
1972, Kentucky St., 4, 6, 0, 0.40000, 209, 223, -14, 
1973, Kentucky St., 3, 8, 0, 0.27273, 178, 180, -2, 
1974, Kentucky St., 6, 4, 0, 0.60000, 177, 121, 56, 
1975, Kentucky St., 7, 4, 0, 0.63636, 214, 172, 42, 
1976, Kentucky St., 3, 7, 1, 0.31818, 162, 186, -24, 
1977, Kentucky St., 8, 2, 1, 0.77273, 228, 155, 73, 
1978, Kentucky St., 7, 2, 1, 0.75000, 207, 147, 60, 
1979, Kentucky St., 6, 5, 0, 0.54545, 139, 97, 42, 
1980, Kentucky St., 5, 6, 0, 0.45455, 153, 167, -14, 
1981, Kentucky St., 2, 6, 0, 0.25000, 107, 179, -72, 
1982, Kentucky St., 2, 9, 0, 0.18182, 88, 356, -268, 
1935, Wheaton (IL), 2, 5, 1, 0.31250, 53, 81, -28, 
1903, Doane (NE), 3, 2, 0, 0.60000, 104, 28, 76, 
1925, Gonzaga (WA), 7, 2, 2, 0.72727, 203, 68, 135, 
1926, Gonzaga (WA), 5, 2, 1, 0.68750, 204, 36, 168, 
1927, Gonzaga (WA), 5, 3, 1, 0.61111, 154, 59, 95, 
1928, Gonzaga (WA), 6, 2, 1, 0.72222, 121, 41, 80, 
1929, Santa Clara (CA), 5, 3, 0, 0.62500, 114, 67, 47, 
1930, Santa Clara (CA), 5, 3, 1, 0.61111, 151, 54, 97, 
1931, Santa Clara (CA), 5, 4, 1, 0.55000, 94, 53, 41, 
1932, Santa Clara (CA), 6, 3, 0, 0.66667, 121, 41, 80, 
1933, Santa Clara (CA), 6, 2, 1, 0.72222, 101, 40, 61, 
1934, Santa Clara (CA), 7, 2, 1, 0.75000, 133, 35, 98, 
1935, Santa Clara (CA), 3, 6, 0, 0.33333, 82, 69, 13, 
1936, Villanova (PA), 7, 2, 1, 0.75000, 129, 39, 90, 
1937, Villanova (PA), 8, 0, 1, 0.94444, 185, 7, 178, 
1938, Villanova (PA), 8, 0, 1, 0.94444, 242, 50, 192, 
1939, Villanova (PA), 6, 2, 0, 0.75000, 109, 55, 54, 
1940, Villanova (PA), 4, 5, 0, 0.44444, 147, 99, 48, 
1941, Villanova (PA), 4, 4, 0, 0.50000, 84, 58, 26, 
1942, Villanova (PA), 4, 4, 0, 0.50000, 116, 66, 50, 
1946, San Francisco (CA), 3, 6, 0, 0.33333, 162, 172, -10, 
1949, Lafayette (PA), 2, 6, 0, 0.25000, 104, 128, -24, 
1950, Lafayette (PA), 1, 8, 0, 0.11111, 48, 230, -182, 
1951, Lafayette (PA), 1, 7, 0, 0.12500, 67, 269, -202, 
2007, Southern Virginia, 6, 5, 0, 0.54545, 375, 372, 3, 
2008, Southern Virginia, 3, 8, 0, 0.27273, 250, 370, -120, 
1984, Dubuque (IA), 3, 7, 0, 0.30000, 161, 252, -91, 
1985, Dubuque (IA), 0, 10, 0, 0.00000, 182, 208, -26, 
1986, Dubuque (IA), 2, 9, 0, 0.18182, 147, 334, -187, 
1910, Dayton (OH), 5, 1, 0, 0.83333, 175, 15, 160, 
1940, Jacksonville St. (AL), 3, 5, 0, 0.37500, 112, 104, 8, 
1908, Bucknell (PA), 3, 5, 2, 0.40000, 85, 105, -20, 
1892, Colgate (NY), 3, 0, 0, 1.00000, 50, 10, 40, 
1934, Benedict (SC), 1, 2, 3, 0.41667, 39, 58, -19, 
1935, Benedict (SC), 1, 5, 2, 0.25000, 40, 79, -39, 
1904, Oregon, 5, 3, 0, 0.62500, 64, 59, 5, 
1925, Oregon, 1, 5, 1, 0.21429, 53, 108, -55, 
2013, Humboldt St. (CA), 0, 11, 0, 0.00000, 170, 354, -184, 
1947, Ouachita Baptist (AR), 4, 5, 1, 0.45000, 154, 117, 37, 
1965, Southern (LA), 5, 4, 1, 0.55000, 315, 194, 121, 
1966, Southern (LA), 7, 2, 1, 0.75000, 260, 143, 117, 
1967, Southern (LA), 5, 5, 0, 0.50000, 216, 170, 46, 
1968, Southern (LA), 4, 6, 0, 0.40000, 192, 164, 28, 
1946, Furman (SC), 2, 8, 0, 0.20000, 99, 236, -137, 
1947, Furman (SC), 2, 7, 0, 0.22222, 68, 205, -137, 
1949, Indiana (PA), 4, 4, 1, 0.50000, 118, 130, -12, 
1950, Indiana (PA), 4, 4, 1, 0.50000, 109, 85, 24, 
1951, Indiana (PA), 5, 3, 1, 0.61111, 94, 75, 19, 
1952, Indiana (PA), 4, 4, 0, 0.50000, 122, 121, 1, 
1953, Indiana (PA), 4, 4, 0, 0.50000, 93, 103, -10, 
1954, Indiana (PA), 5, 3, 0, 0.62500, 153, 68, 85, 
1955, Indiana (PA), 3, 5, 0, 0.37500, 79, 85, -6, 
1956, Indiana (PA), 5, 4, 0, 0.55556, 142, 175, -33, 
1957, Indiana (PA), 3, 6, 0, 0.33333, 62, 188, -126, 
1958, Indiana (PA), 5, 3, 0, 0.62500, 112, 80, 32, 
1959, Indiana (PA), 3, 4, 1, 0.43750, 86, 97, -11, 
1960, Indiana (PA), 2, 4, 2, 0.37500, 92, 127, -35, 
1961, Indiana (PA), 2, 7, 0, 0.22222, 103, 160, -57, 
1905, Citadel (SC), 2, 3, 1, 0.41667, 27, 63, -36, 
1943, Morehouse (GA), 2, 2, 1, 0.50000, 24, 24, 0, 
1944, Morehouse (GA), 3, 4, 0, 0.42857, 67, 138, -71, 
1945, Morehouse (GA), 1, 5, 0, 0.16667, 37, 130, -93, 
1901, Oregon, 3, 4, 1, 0.43750, 33, 44, -11, 
1903, Oregon, 4, 2, 1, 0.64286, 75, 18, 57, 
1917, Indiana (PA), 8, 1, 0, 0.88889, 623, 7, 616, 
1918, Indiana (PA), 2, 1, 1, 0.62500, 39, 25, 14, 
1967, Norfolk St. (VA), 4, 4, 0, 0.50000, 103, 169, -66, 
1973, North Carolina Central, 7, 4, 0, 0.63636, 140, 136, 4, 
1974, North Carolina Central, 7, 2, 2, 0.72727, 159, 97, 62, 
1975, North Carolina Central, 5, 4, 1, 0.55000, 160, 198, -38, 
1976, North Carolina Central, 6, 5, 0, 0.54545, 200, 157, 43, 
1977, North Carolina Central, 1, 10, 0, 0.09091, 109, 284, -175, 
1906, Army (NY), 1, 0, 0, 1.00000, 12, 0, 12, 
1907, Army (NY), 6, 2, 1, 0.72222, 125, 24, 101, 
1959, Portland St. (OR), 1, 8, 0, 0.11111, 37, 206, -169, 
1960, Portland St. (OR), 2, 4, 2, 0.37500, 111, 170, -59, 
1961, Portland St. (OR), 3, 5, 0, 0.37500, 141, 221, -80, 
1892, Virginia Tech, 1, 1, 0, 0.50000, 14, 22, -8, 
1893, Virginia Tech, 0, 2, 0, 0.00000, 6, 40, -34, 
1927, Bucknell (PA), 6, 3, 1, 0.65000, 200, 104, 96, 
1928, Bucknell (PA), 5, 2, 3, 0.65000, 124, 48, 76, 
1929, Bucknell (PA), 8, 2, 0, 0.80000, 236, 37, 199, 
1930, Bucknell (PA), 6, 3, 0, 0.66667, 163, 59, 104, 
1931, Bucknell (PA), 6, 0, 3, 0.83333, 148, 47, 101, 
1932, Bucknell (PA), 4, 4, 1, 0.50000, 82, 100, -18, 
1933, Bucknell (PA), 7, 2, 0, 0.77778, 203, 57, 146, 
1934, North Carolina, 7, 1, 1, 0.83333, 125, 34, 91, 
1935, North Carolina, 8, 1, 0, 0.88889, 270, 44, 226, 
1936, Cornell (NY), 3, 5, 0, 0.37500, 145, 132, 13, 
1937, Cornell (NY), 5, 2, 1, 0.68750, 146, 82, 64, 
1938, Cornell (NY), 5, 1, 1, 0.78571, 110, 45, 65, 
1939, Cornell (NY), 8, 0, 0, 1.00000, 197, 52, 145, 
1940, Cornell (NY), 6, 2, 0, 0.75000, 201, 38, 163, 
1941, Cornell (NY), 5, 3, 0, 0.62500, 88, 65, 23, 
1942, Cornell (NY), 3, 5, 1, 0.38889, 95, 148, -53, 
1943, Cornell (NY), 6, 4, 0, 0.60000, 158, 138, 20, 
1944, Cornell (NY), 5, 4, 0, 0.55556, 131, 130, 1, 
1945, North Carolina, 5, 5, 0, 0.50000, 113, 149, -36, 
1946, North Carolina, 8, 2, 1, 0.77273, 271, 129, 142, 
1947, North Carolina, 8, 2, 0, 0.80000, 210, 93, 117, 
1948, North Carolina, 9, 1, 1, 0.86364, 261, 94, 167, 
1949, North Carolina, 7, 4, 0, 0.63636, 190, 205, -15, 
1950, North Carolina, 3, 5, 2, 0.40000, 101, 122, -21, 
1951, North Carolina, 2, 8, 0, 0.20000, 120, 224, -104, 
1952, North Carolina, 2, 6, 0, 0.25000, 110, 206, -96, 
1939, East Stroudsburg (PA), 3, 5, 0, 0.37500, 82, 109, -27, 
1940, East Stroudsburg (PA), 7, 1, 0, 0.87500, 110, 51, 59, 
1941, East Stroudsburg (PA), 5, 2, 0, 0.71429, 102, 47, 55, 
1947, DePauw (IN), 2, 6, 0, 0.25000, 59, 203, -144, 
1948, DePauw (IN), 6, 2, 0, 0.75000, 72, 61, 11, 
1949, DePauw (IN), 1, 7, 0, 0.12500, 126, 211, -85, 
1950, DePauw (IN), 4, 4, 0, 0.50000, 181, 167, 14, 
1951, DePauw (IN), 7, 1, 0, 0.87500, 145, 147, -2, 
1952, DePauw (IN), 4, 4, 0, 0.50000, 134, 195, -61, 
1953, DePauw (IN), 0, 7, 1, 0.06250, 45, 188, -143, 
1954, DePauw (IN), 0, 7, 1, 0.06250, 99, 229, -130, 
1955, DePauw (IN), 5, 4, 0, 0.55556, 175, 169, 6, 
1922, SUNY-Albany (NY), 0, 3, 2, 0.20000, 6, 76, -70, 
1923, SUNY-Albany (NY), 1, 5, 0, 0.16667, 12, 188, -176, 
1924, SUNY-Albany (NY), 0, 4, 1, 0.10000, 6, 111, -105, 
1948, Livingstone (NC), 2, 6, 0, 0.25000, 80, 191, -111, 
2013, Baldwin-Wallace (OH), 6, 4, 0, 0.60000, 261, 195, 66, 
1943, Samford (AL), 2, 2, 0, 0.50000, 108, 74, 34, 
2013, Haskell Indian Nations (KS), 2, 7, 0, 0.22222, 117, 318, -201, 
1953, Wofford (SC), 6, 4, 1, 0.59091, 163, 121, 42, 
1954, Wofford (SC), 8, 2, 0, 0.80000, 241, 89, 152, 
1955, Wofford (SC), 7, 4, 0, 0.63636, 190, 135, 55, 
1956, Wofford (SC), 7, 3, 0, 0.70000, 234, 160, 74, 
1957, Wofford (SC), 8, 2, 0, 0.80000, 177, 106, 71, 
1958, Wofford (SC), 3, 7, 0, 0.30000, 178, 195, -17, 
1959, Wofford (SC), 5, 5, 0, 0.50000, 124, 178, -54, 
1960, Wofford (SC), 5, 3, 0, 0.62500, 117, 132, -15, 
1961, Wofford (SC), 5, 4, 2, 0.54545, 216, 184, 32, 
1962, Wofford (SC), 2, 8, 0, 0.20000, 148, 224, -76, 
1963, Wofford (SC), 4, 6, 0, 0.40000, 143, 146, -3, 
1964, Wofford (SC), 6, 4, 0, 0.60000, 153, 114, 39, 
1965, Wofford (SC), 5, 4, 0, 0.55556, 181, 142, 39, 
1966, Wofford (SC), 6, 3, 1, 0.65000, 203, 162, 41, 
1912, Southwestern (TX), 4, 3, 0, 0.57143, 82, 98, -16, 
1913, Southwestern (TX), 1, 5, 2, 0.25000, 34, 181, -147, 
1922, Bowling Green (OH), 4, 2, 1, 0.64286, 98, 46, 52, 
1989, Kansas St., 1, 10, 0, 0.09091, 134, 349, -215, 
1990, Kansas St., 5, 6, 0, 0.45455, 255, 293, -38, 
1991, Kansas St., 7, 4, 0, 0.63636, 263, 226, 37, 
1992, Kansas St., 5, 6, 0, 0.45455, 195, 233, -38, 
1993, Kansas St., 9, 2, 1, 0.79167, 340, 227, 113, 
1994, Kansas St., 9, 3, 0, 0.75000, 312, 168, 144, 
1995, Kansas St., 10, 2, 0, 0.83333, 456, 166, 290, 
1996, Kansas St., 9, 3, 0, 0.75000, 340, 191, 149, 
1997, Kansas St., 11, 1, 0, 0.91667, 418, 177, 241, 
1998, Kansas St., 11, 2, 0, 0.84615, 610, 197, 413, 
1999, Kansas St., 11, 1, 0, 0.91667, 457, 164, 293, 
2000, Kansas St., 11, 3, 0, 0.78571, 549, 261, 288, 
2001, Kansas St., 6, 6, 0, 0.50000, 330, 205, 125, 
2002, Kansas St., 11, 2, 0, 0.84615, 582, 154, 428, 
2003, Kansas St., 11, 4, 0, 0.73333, 549, 244, 305, 
2004, Kansas St., 4, 7, 0, 0.36364, 326, 337, -11, 
2005, Kansas St., 5, 6, 0, 0.45455, 289, 305, -16, 
2009, Kansas St., 6, 6, 0, 0.50000, 276, 280, -4, 
2010, Kansas St., 7, 6, 0, 0.53846, 437, 378, 59, 
2011, Kansas St., 10, 3, 0, 0.76923, 413, 363, 50, 
2012, Kansas St., 11, 2, 0, 0.84615, 505, 288, 217, 
2013, Kansas St., 8, 5, 0, 0.61538, 432, 298, 134, 
1976, Utah St., 3, 8, 0, 0.27273, 170, 263, -93, 
1977, Utah St., 4, 7, 0, 0.36364, 177, 249, -72, 
1978, Utah St., 7, 4, 0, 0.63636, 269, 214, 55, 
1979, Utah St., 8, 2, 1, 0.77273, 347, 270, 77, 
1980, Utah St., 6, 5, 0, 0.54545, 290, 255, 35, 
1981, Utah St., 5, 5, 1, 0.50000, 204, 210, -6, 
1982, Utah St., 5, 6, 0, 0.45455, 192, 262, -70, 
1987, California, 3, 6, 2, 0.36364, 239, 267, -28, 
1988, California, 5, 5, 1, 0.50000, 243, 244, -1, 
1989, California, 4, 7, 0, 0.36364, 200, 288, -88, 
1990, California, 7, 4, 1, 0.62500, 325, 341, -16, 
1991, California, 10, 2, 0, 0.83333, 443, 239, 204, 
1992, Arizona St., 6, 5, 0, 0.54545, 235, 185, 50, 
1993, Arizona St., 6, 5, 0, 0.54545, 282, 248, 34, 
1994, Arizona St., 3, 8, 0, 0.27273, 242, 347, -105, 
1995, Arizona St., 6, 5, 0, 0.54545, 308, 330, -22, 
1996, Arizona St., 11, 1, 0, 0.91667, 488, 216, 272, 
1997, Arizona St., 9, 3, 0, 0.75000, 324, 210, 114, 
1998, Arizona St., 5, 6, 0, 0.45455, 333, 338, -5, 
1999, Arizona St., 7, 5, 0, 0.58333, 285, 311, -26, 
2000, Arizona St., 6, 6, 0, 0.50000, 313, 303, 10, 
1959, Marshall (WV), 1, 8, 0, 0.11111, 72, 343, -271, 
1960, Marshall (WV), 2, 7, 1, 0.25000, 58, 160, -102, 
1961, Marshall (WV), 2, 7, 1, 0.25000, 61, 183, -122, 
1962, Marshall (WV), 4, 6, 0, 0.40000, 137, 237, -100, 
1963, Marshall (WV), 5, 4, 1, 0.55000, 139, 139, 0, 
1964, Marshall (WV), 7, 3, 0, 0.70000, 120, 93, 27, 
1965, Marshall (WV), 5, 5, 0, 0.50000, 150, 168, -18, 
1966, Marshall (WV), 2, 8, 0, 0.20000, 113, 210, -97, 
1967, Marshall (WV), 0, 10, 0, 0.00000, 72, 311, -239, 
2005, Seton Hill (PA), 1, 9, 0, 0.10000, 147, 347, -200, 
2006, Seton Hill (PA), 2, 9, 0, 0.18182, 144, 316, -172, 
2007, Seton Hill (PA), 3, 7, 0, 0.30000, 258, 330, -72, 
2005, Marshall (WV), 4, 7, 0, 0.36364, 204, 285, -81, 
2006, Marshall (WV), 5, 7, 0, 0.41667, 311, 351, -40, 
2007, Marshall (WV), 3, 9, 0, 0.25000, 298, 411, -113, 
2008, Marshall (WV), 4, 8, 0, 0.33333, 246, 332, -86, 
2009, Marshall (WV), 6, 6, 0, 0.50000, 262, 299, -37, 
1950, Toledo (OH), 4, 5, 0, 0.44444, 200, 234, -34, 
1983, Clarion (PA), 9, 2, 0, 0.81818, 287, 206, 81, 
1984, Clarion (PA), 7, 3, 0, 0.70000, 203, 211, -8, 
1985, Clarion (PA), 8, 2, 0, 0.80000, 230, 153, 77, 
1986, Clarion (PA), 5, 5, 0, 0.50000, 211, 239, -28, 
1987, Clarion (PA), 7, 3, 0, 0.70000, 311, 164, 147, 
1988, Clarion (PA), 3, 7, 0, 0.30000, 136, 299, -163, 
1989, Clarion (PA), 3, 7, 0, 0.30000, 237, 294, -57, 
1990, Clarion (PA), 2, 8, 0, 0.20000, 198, 287, -89, 
1991, Clarion (PA), 5, 5, 0, 0.50000, 277, 263, 14, 
1992, Clarion (PA), 0, 10, 0, 0.00000, 277, 278, -1, 
1993, Clarion (PA), 5, 5, 0, 0.50000, 224, 273, -49, 
1970, California-Davis, 6, 4, 0, 0.60000, 208, 176, 32, 
1971, California-Davis, 9, 1, 0, 0.90000, 305, 184, 121, 
1972, California-Davis, 6, 2, 2, 0.70000, 278, 228, 50, 
1973, California-Davis, 7, 3, 0, 0.70000, 217, 153, 64, 
1974, California-Davis, 9, 1, 0, 0.90000, 297, 143, 154, 
1975, California-Davis, 7, 3, 0, 0.70000, 245, 142, 103, 
1976, California-Davis, 8, 2, 0, 0.80000, 233, 112, 121, 
1977, California-Davis, 11, 1, 0, 0.91667, 335, 159, 176, 
1978, California-Davis, 8, 3, 0, 0.72727, 304, 156, 148, 
1979, California-Davis, 6, 3, 1, 0.65000, 217, 155, 62, 
1980, California-Davis, 7, 2, 1, 0.75000, 267, 178, 89, 
1981, California-Davis, 6, 4, 0, 0.60000, 163, 140, 23, 
1982, California-Davis, 12, 1, 0, 0.92308, 405, 164, 241, 
1983, California-Davis, 11, 1, 0, 0.91667, 380, 94, 286, 
1984, California-Davis, 9, 2, 0, 0.81818, 295, 133, 162, 
1985, California-Davis, 9, 2, 0, 0.81818, 388, 191, 197, 
1986, California-Davis, 10, 1, 0, 0.90909, 361, 213, 148, 
1987, California-Davis, 7, 3, 0, 0.70000, 238, 163, 75, 
1988, California-Davis, 7, 3, 1, 0.68182, 300, 180, 120, 
2013, Rose-Hulman Tech (IN), 7, 3, 0, 0.70000, 322, 237, 85, 
1946, Franklin & Marshall (PA), 3, 4, 0, 0.42857, 109, 115, -6, 
1947, Franklin & Marshall (PA), 4, 3, 1, 0.56250, 136, 122, 14, 
1921, Drake (IA), 5, 2, 0, 0.71429, 149, 40, 109, 
1922, Drake (IA), 7, 0, 0, 1.00000, 155, 26, 129, 
1923, Drake (IA), 5, 2, 0, 0.71429, 168, 49, 119, 
1924, Drake (IA), 5, 2, 1, 0.68750, 106, 56, 50, 
1925, Drake (IA), 5, 3, 0, 0.62500, 65, 41, 24, 
1926, Drake (IA), 2, 6, 0, 0.25000, 60, 118, -58, 
1927, Drake (IA), 3, 6, 0, 0.33333, 89, 158, -69, 
1928, Drake (IA), 7, 1, 0, 0.87500, 141, 52, 89, 
1929, Drake (IA), 5, 3, 1, 0.61111, 145, 79, 66, 
1930, Drake (IA), 5, 4, 0, 0.55556, 166, 120, 46, 
1931, Drake (IA), 5, 6, 0, 0.45455, 130, 226, -96, 
1932, Iowa, 1, 7, 0, 0.12500, 62, 171, -109, 
1933, Iowa, 5, 3, 0, 0.62500, 131, 56, 75, 
1934, Iowa, 2, 5, 1, 0.31250, 98, 153, -55, 
1935, Iowa, 4, 2, 2, 0.62500, 122, 39, 83, 
1936, Iowa, 3, 4, 1, 0.43750, 85, 103, -18, 
1937, Syracuse (NY), 5, 2, 1, 0.68750, 132, 57, 75, 
1938, Syracuse (NY), 5, 3, 0, 0.62500, 137, 102, 35, 
1939, Syracuse (NY), 3, 3, 2, 0.50000, 63, 92, -29, 
1940, Syracuse (NY), 3, 4, 1, 0.43750, 114, 134, -20, 
1941, Syracuse (NY), 5, 2, 1, 0.68750, 190, 86, 104, 
1942, Syracuse (NY), 6, 3, 0, 0.66667, 152, 61, 91, 
1944, Syracuse (NY), 2, 4, 1, 0.35714, 102, 152, -50, 
1945, Syracuse (NY), 1, 6, 0, 0.14286, 38, 106, -68, 
1998, Nebraska, 9, 4, 0, 0.69231, 403, 206, 197, 
1999, Nebraska, 12, 1, 0, 0.92308, 442, 171, 271, 
2000, Nebraska, 10, 2, 0, 0.83333, 522, 230, 292, 
2001, Nebraska, 11, 2, 0, 0.84615, 463, 226, 237, 
2002, Nebraska, 7, 7, 0, 0.50000, 383, 335, 48, 
2003, Nebraska, 9, 3, 0, 0.75000, 305, 185, 120, 
2005, Ohio, 4, 7, 0, 0.36364, 192, 336, -144, 
2006, Ohio, 9, 5, 0, 0.64286, 276, 253, 23, 
2007, Ohio, 6, 6, 0, 0.50000, 366, 359, 7, 
2008, Ohio, 4, 8, 0, 0.33333, 289, 327, -38, 
2009, Ohio, 9, 5, 0, 0.64286, 347, 298, 49, 
2010, Ohio, 8, 5, 0, 0.61538, 357, 309, 48, 
2011, Ohio, 10, 4, 0, 0.71429, 427, 310, 117, 
2012, Ohio, 9, 4, 0, 0.69231, 412, 322, 90, 
2013, Ohio, 7, 6, 0, 0.53846, 356, 357, -1, 
1919, Dayton (OH), 2, 2, 0, 0.50000, 31, 41, -10, 
1985, North Dakota St., 11, 2, 1, 0.82143, 407, 194, 213, 
1986, North Dakota St., 13, 0, 0, 1.00000, 539, 87, 452, 
1987, Montana St., 1, 10, 0, 0.09091, 230, 460, -230, 
1988, Montana St., 4, 7, 0, 0.36364, 244, 374, -130, 
1989, Montana St., 4, 7, 0, 0.36364, 237, 273, -36, 
1990, Montana St., 4, 7, 0, 0.36364, 268, 304, -36, 
1991, Montana St., 2, 9, 0, 0.18182, 197, 300, -103, 
1903, Mount Union (OH), 2, 5, 1, 0.31250, 31, 192, -161, 
1904, Mount Union (OH), 2, 6, 0, 0.25000, 44, 253, -209, 
1912, Colgate (NY), 5, 2, 0, 0.71429, 90, 47, 43, 
1914, Villanova (PA), 4, 3, 1, 0.56250, 30, 71, -41, 
1915, Villanova (PA), 6, 1, 0, 0.85714, 100, 29, 71, 
1916, Michigan St., 4, 2, 1, 0.64286, 126, 26, 100, 
1924, Villanova (PA), 2, 5, 1, 0.31250, 70, 109, -39, 
1979, Texas Southern, 3, 8, 0, 0.27273, 118, 219, -101, 
1980, Texas Southern, 2, 9, 0, 0.18182, 107, 303, -196, 
1966, Johns Hopkins (MD), 0, 6, 2, 0.12500, 74, 198, -124, 
1967, Johns Hopkins (MD), 6, 1, 0, 0.85714, 255, 93, 162, 
1968, Johns Hopkins (MD), 7, 2, 0, 0.77778, 306, 185, 121, 
1969, Johns Hopkins (MD), 5, 4, 0, 0.55556, 190, 187, 3, 
1970, Johns Hopkins (MD), 5, 4, 0, 0.55556, 153, 192, -39, 
1998, Northern Arizona, 6, 5, 0, 0.54545, 241, 227, 14, 
1999, Northern Arizona, 4, 8, 0, 0.33333, 409, 370, 39, 
2000, Northern Arizona, 3, 8, 0, 0.27273, 245, 275, -30, 
2001, Northern Arizona, 8, 4, 0, 0.66667, 399, 341, 58, 
2002, Northern Arizona, 6, 5, 0, 0.54545, 252, 284, -32, 
2003, Northern Arizona, 9, 4, 0, 0.69231, 409, 305, 104, 
2004, Northern Arizona, 4, 7, 0, 0.36364, 244, 314, -70, 
2005, Northern Arizona, 3, 8, 0, 0.27273, 233, 328, -95, 
2006, Northern Arizona, 6, 5, 0, 0.54545, 378, 296, 82, 
2007, Northern Arizona, 6, 5, 0, 0.54545, 322, 305, 17, 
2008, Northern Arizona, 6, 5, 0, 0.54545, 316, 273, 43, 
2009, Northern Arizona, 5, 6, 0, 0.45455, 327, 327, 0, 
2010, Northern Arizona, 6, 5, 0, 0.54545, 314, 218, 96, 
2011, Northern Arizona, 4, 7, 0, 0.36364, 309, 294, 15, 
2012, Northern Arizona, 8, 3, 0, 0.72727, 348, 260, 88, 
2013, Northern Arizona, 9, 3, 0, 0.75000, 278, 264, 14, 
1896, Texas A&M;, 2, 0, 1, 0.83333, 50, 4, 46, 
1895, Wyoming, 1, 0, 0, 1.00000, 34, 0, 34, 
1896, Wyoming, 2, 0, 0, 1.00000, 28, 20, 8, 
1897, Wyoming, 2, 0, 0, 1.00000, 20, 0, 20, 
1899, Wyoming, 0, 1, 1, 0.25000, 5, 17, -12, 
1963, Louisiana College, 3, 5, 0, 0.37500, 92, 124, -32, 
1964, Louisiana College, 1, 8, 0, 0.11111, 110, 186, -76, 
1965, Louisiana College, 2, 7, 0, 0.22222, 52, 151, -99, 
1966, Louisiana College, 0, 9, 0, 0.00000, 17, 295, -278, 
2009, Illinois St., 6, 5, 0, 0.54545, 255, 280, -25, 
2010, Illinois St., 6, 5, 0, 0.54545, 321, 436, -115, 
2011, Illinois St., 7, 4, 0, 0.63636, 307, 211, 96, 
2012, Illinois St., 9, 4, 0, 0.69231, 393, 339, 54, 
2013, Illinois St., 5, 6, 0, 0.45455, 272, 325, -53, 
1893, Georgia Tech, 2, 1, 1, 0.62500, 38, 18, 20, 
1894, Georgia Tech, 0, 3, 0, 0.00000, 0, 136, -136, 
1947, Atlantic Christian (NC), 0, 8, 0, 0.00000, 19, 167, -148, 
1948, Atlantic Christian (NC), 2, 7, 0, 0.22222, 46, 180, -134, 
1949, Catawba (NC), 5, 6, 0, 0.45455, 138, 147, -9, 
1950, Catawba (NC), 4, 6, 0, 0.40000, 138, 135, 3, 
1951, Catawba (NC), 5, 5, 0, 0.50000, 158, 169, -11, 
1952, Catawba (NC), 6, 4, 1, 0.59091, 115, 164, -49, 
2001, Presbyterian (SC), 7, 4, 0, 0.63636, 367, 259, 108, 
2002, Presbyterian (SC), 8, 3, 0, 0.72727, 251, 154, 97, 
2003, Presbyterian (SC), 4, 6, 0, 0.40000, 267, 190, 77, 
2004, Presbyterian (SC), 6, 5, 0, 0.54545, 239, 230, 9, 
2005, Presbyterian (SC), 10, 2, 0, 0.83333, 402, 170, 232, 
2006, Presbyterian (SC), 7, 4, 0, 0.63636, 166, 145, 21, 
1994, New Haven (CT), 7, 3, 0, 0.70000, 329, 207, 122, 
1995, New Haven (CT), 10, 1, 1, 0.87500, 347, 158, 189, 
1996, New Haven (CT), 7, 3, 0, 0.70000, 343, 172, 171, 
1997, New Haven (CT), 12, 2, 0, 0.85714, 556, 202, 354, 
1998, New Haven (CT), 5, 5, 0, 0.50000, 230, 198, 32, 
1980, Carson-Newman (TN), 5, 5, 0, 0.50000, 218, 146, 72, 
1981, Carson-Newman (TN), 7, 4, 0, 0.63636, 273, 162, 111, 
1982, Carson-Newman (TN), 10, 2, 0, 0.83333, 334, 179, 155, 
1983, Carson-Newman (TN), 10, 3, 0, 0.76923, 332, 234, 98, 
1984, Carson-Newman (TN), 10, 2, 1, 0.80769, 416, 219, 197, 
1985, Carson-Newman (TN), 5, 5, 0, 0.50000, 189, 209, -20, 
1986, Carson-Newman (TN), 12, 1, 0, 0.92308, 316, 133, 183, 
1987, Carson-Newman (TN), 10, 4, 0, 0.71429, 338, 235, 103, 
1988, Carson-Newman (TN), 12, 2, 0, 0.85714, 409, 200, 209, 
1989, Carson-Newman (TN), 12, 1, 0, 0.92308, 423, 161, 262, 
1990, Carson-Newman (TN), 11, 1, 0, 0.91667, 434, 243, 191, 
1991, Carson-Newman (TN), 7, 4, 0, 0.63636, 439, 193, 246, 
1992, Carson-Newman (TN), 8, 3, 0, 0.72727, 213, 155, 58, 
1993, Carson-Newman (TN), 8, 2, 1, 0.77273, 383, 233, 150, 
1994, Carson-Newman (TN), 8, 3, 0, 0.72727, 405, 231, 174, 
1995, Carson-Newman (TN), 9, 3, 0, 0.75000, 363, 223, 140, 
1996, Carson-Newman (TN), 12, 2, 0, 0.85714, 385, 182, 203, 
1997, Carson-Newman (TN), 11, 1, 0, 0.91667, 412, 152, 260, 
1998, Carson-Newman (TN), 12, 2, 0, 0.85714, 499, 291, 208, 
1999, Carson-Newman (TN), 13, 1, 0, 0.92857, 597, 281, 316, 
2000, Carson-Newman (TN), 8, 2, 0, 0.80000, 428, 184, 244, 
2001, Carson-Newman (TN), 6, 3, 0, 0.66667, 322, 188, 134, 
2002, Carson-Newman (TN), 12, 1, 0, 0.92308, 567, 243, 324, 
2003, Carson-Newman (TN), 11, 2, 0, 0.84615, 483, 305, 178, 
2004, Carson-Newman (TN), 9, 3, 0, 0.75000, 444, 309, 135, 
2005, Carson-Newman (TN), 8, 2, 0, 0.80000, 332, 163, 169, 
2006, Carson-Newman (TN), 8, 3, 0, 0.72727, 289, 153, 136, 
2007, Carson-Newman (TN), 10, 1, 0, 0.90909, 537, 236, 301, 
2008, Carson-Newman (TN), 7, 4, 0, 0.63636, 447, 268, 179, 
2009, Carson-Newman (TN), 11, 3, 0, 0.78571, 537, 324, 213, 
2010, Carson-Newman (TN), 7, 4, 0, 0.63636, 344, 300, 44, 
2011, Carson-Newman (TN), 5, 6, 0, 0.45455, 310, 275, 35, 
2012, Carson-Newman (TN), 9, 3, 0, 0.75000, 474, 331, 143, 
2013, Carson-Newman (TN), 10, 3, 0, 0.76923, 489, 346, 143, 
1907, Western Michigan, 4, 2, 1, 0.64286, 84, 8, 76, 
1908, Western Michigan, 3, 4, 0, 0.42857, 38, 104, -66, 
1909, Western Michigan, 7, 0, 0, 1.00000, 194, 9, 185, 
1910, Western Michigan, 5, 3, 0, 0.62500, 82, 32, 50, 
1911, Western Michigan, 2, 3, 0, 0.40000, 110, 59, 51, 
1912, Western Michigan, 3, 2, 1, 0.58333, 86, 50, 36, 
1913, Western Michigan, 4, 0, 0, 1.00000, 59, 15, 44, 
1914, Western Michigan, 6, 0, 0, 1.00000, 180, 7, 173, 
1915, Western Michigan, 5, 1, 0, 0.83333, 291, 43, 248, 
1916, Western Michigan, 5, 1, 0, 0.83333, 389, 19, 370, 
1917, Western Michigan, 4, 3, 0, 0.57143, 203, 105, 98, 
1918, Western Michigan, 3, 2, 0, 0.60000, 223, 30, 193, 
1919, Western Michigan, 4, 1, 0, 0.80000, 156, 91, 65, 
1920, Western Michigan, 3, 4, 0, 0.42857, 119, 133, -14, 
1921, Western Michigan, 6, 2, 0, 0.75000, 262, 40, 222, 
1922, Minnesota, 3, 3, 1, 0.50000, 79, 65, 14, 
1923, Minnesota, 5, 1, 1, 0.78571, 114, 60, 54, 
1924, Minnesota, 3, 3, 2, 0.50000, 68, 63, 5, 
1925, UCLA, 6, 3, 1, 0.65000, 104, 137, -33, 
1926, UCLA, 5, 3, 0, 0.62500, 153, 67, 86, 
1927, UCLA, 6, 2, 1, 0.72222, 144, 54, 90, 
1928, UCLA, 4, 4, 1, 0.50000, 171, 136, 35, 
1929, UCLA, 4, 4, 0, 0.50000, 121, 190, -69, 
1930, UCLA, 3, 5, 0, 0.37500, 77, 125, -48, 
1931, UCLA, 3, 4, 1, 0.43750, 83, 57, 26, 
1932, UCLA, 6, 4, 0, 0.60000, 149, 61, 88, 
1933, UCLA, 6, 4, 1, 0.59091, 123, 62, 61, 
1934, UCLA, 7, 3, 0, 0.70000, 146, 69, 77, 
1935, UCLA, 8, 2, 0, 0.80000, 160, 79, 81, 
1936, UCLA, 6, 3, 1, 0.65000, 143, 91, 52, 
1937, UCLA, 2, 6, 1, 0.27778, 93, 133, -40, 
1938, UCLA, 7, 4, 1, 0.62500, 217, 106, 111, 
2006, Boston College (MA), 1, 0, 0, 1.00000, 25, 24, 1, 
2009, Boston College (MA), 8, 5, 0, 0.61538, 322, 257, 65, 
2010, Boston College (MA), 7, 6, 0, 0.53846, 240, 254, -14, 
2011, Boston College (MA), 4, 8, 0, 0.33333, 218, 282, -64, 
2012, Boston College (MA), 2, 10, 0, 0.16667, 238, 356, -118, 
1956, Arkansas-Pine Bluff, 2, 6, 1, 0.27778, 99, 165, -66, 
1957, Arkansas-Pine Bluff, 3, 6, 0, 0.33333, 79, 205, -126, 
1958, Arkansas-Pine Bluff, 3, 6, 0, 0.33333, 101, 223, -122, 
1959, Arkansas-Pine Bluff, 4, 6, 0, 0.40000, 184, 193, -9, 
1960, Arkansas-Pine Bluff, 6, 5, 0, 0.54545, 249, 154, 95, 
1961, Arkansas-Pine Bluff, 3, 6, 1, 0.35000, 172, 189, -17, 
1917, Dartmouth (NH), 5, 3, 0, 0.62500, 83, 68, 15, 
1918, Dartmouth (NH), 3, 3, 0, 0.50000, 78, 83, -5, 
1919, Dartmouth (NH), 6, 1, 1, 0.81250, 141, 53, 88, 
1920, Dartmouth (NH), 7, 2, 0, 0.77778, 199, 68, 131, 
1921, West Virginia, 5, 4, 1, 0.55000, 161, 82, 79, 
1922, West Virginia, 10, 0, 1, 0.95455, 267, 34, 233, 
1923, West Virginia, 7, 1, 1, 0.83333, 297, 41, 256, 
1924, West Virginia, 8, 1, 0, 0.88889, 282, 47, 235, 
1925, Minnesota, 5, 2, 1, 0.68750, 176, 91, 85, 
1926, Minnesota, 5, 3, 0, 0.62500, 269, 57, 212, 
1927, Minnesota, 6, 0, 2, 0.87500, 209, 51, 158, 
1928, Minnesota, 6, 2, 0, 0.75000, 182, 36, 146, 
1929, Minnesota, 6, 2, 0, 0.75000, 179, 55, 124, 
1930, Oregon, 7, 2, 0, 0.77778, 131, 35, 96, 
1931, Oregon, 6, 2, 2, 0.70000, 90, 87, 3, 
1932, Wisconsin, 6, 1, 1, 0.81250, 151, 48, 103, 
1933, Wisconsin, 2, 5, 1, 0.31250, 54, 79, -25, 
1934, Wisconsin, 4, 4, 0, 0.50000, 48, 84, -36, 
1935, Wisconsin, 1, 7, 0, 0.12500, 53, 171, -118, 
1936, Toledo (OH), 2, 6, 0, 0.25000, 94, 58, 36, 
1937, Toledo (OH), 6, 3, 0, 0.66667, 128, 96, 32, 
1938, Toledo (OH), 6, 3, 1, 0.65000, 156, 83, 73, 
1939, Toledo (OH), 7, 3, 0, 0.70000, 180, 59, 121, 
1940, Toledo (OH), 6, 3, 0, 0.66667, 146, 78, 68, 
1941, Toledo (OH), 7, 4, 0, 0.63636, 195, 122, 73, 
1942, Toledo (OH), 4, 4, 1, 0.50000, 91, 114, -23, 
1943, Maryland, 4, 5, 0, 0.44444, 105, 194, -89, 
1944, Maryland, 1, 7, 1, 0.16667, 46, 170, -124, 
2004, Grambling St. (LA), 6, 5, 0, 0.54545, 294, 295, -1, 
2005, Grambling St. (LA), 11, 1, 0, 0.91667, 529, 236, 293, 
2006, Grambling St. (LA), 3, 8, 0, 0.27273, 295, 281, 14, 
2011, Alcorn St. (MS), 2, 8, 0, 0.20000, 210, 272, -62, 
1936, Arkansas St., 3, 5, 0, 0.37500, 54, 188, -134, 
1937, Arkansas St., 1, 5, 0, 0.16667, 16, 267, -251, 
1938, Arkansas St., 3, 3, 0, 0.50000, 54, 68, -14, 
1998, Willamette (OR), 7, 3, 0, 0.70000, 336, 172, 164, 
1999, Willamette (OR), 7, 4, 0, 0.63636, 322, 185, 137, 
2000, Willamette (OR), 3, 7, 0, 0.30000, 156, 248, -92, 
2001, Willamette (OR), 4, 5, 0, 0.44444, 215, 171, 44, 
2002, Willamette (OR), 6, 4, 0, 0.60000, 375, 300, 75, 
2003, Willamette (OR), 7, 3, 0, 0.70000, 323, 191, 132, 
2004, Willamette (OR), 7, 4, 0, 0.63636, 280, 229, 51, 
2005, Willamette (OR), 5, 4, 0, 0.55556, 239, 300, -61, 
2006, Willamette (OR), 2, 7, 0, 0.22222, 186, 294, -108, 
2007, Willamette (OR), 4, 6, 0, 0.40000, 251, 211, 40, 
2008, Willamette (OR), 11, 1, 0, 0.91667, 498, 233, 265, 
2009, Willamette (OR), 8, 2, 0, 0.80000, 382, 159, 223, 
2010, Willamette (OR), 7, 3, 0, 0.70000, 371, 207, 164, 
2011, Willamette (OR), 4, 6, 0, 0.40000, 266, 207, 59, 
1955, Oklahoma St., 2, 8, 0, 0.20000, 88, 172, -84, 
1956, Oklahoma St., 3, 5, 2, 0.40000, 131, 166, -35, 
1957, Oklahoma St., 6, 3, 1, 0.65000, 182, 129, 53, 
1958, Oklahoma St., 8, 3, 0, 0.72727, 201, 134, 67, 
1959, Oklahoma St., 6, 4, 0, 0.60000, 181, 151, 30, 
1960, Oklahoma St., 3, 7, 0, 0.30000, 102, 126, -24, 
1961, Oklahoma St., 4, 6, 0, 0.40000, 154, 166, -12, 
1962, Oklahoma St., 4, 6, 0, 0.40000, 138, 214, -76, 
1915, Fort Hays St. (KS), 4, 3, 0, 0.57143, 74, 67, 7, 
1916, Fort Hays St. (KS), 5, 2, 0, 0.71429, 95, 61, 34, 
1917, Fort Hays St. (KS), 7, 0, 0, 1.00000, 130, 27, 103, 
1918, Fort Hays St. (KS), 2, 1, 0, 0.66667, 49, 39, 10, 
1908, Purdue (IN), 4, 3, 0, 0.57143, 124, 78, 46, 
1909, Purdue (IN), 2, 5, 0, 0.28571, 72, 147, -75, 
2012, Western Carolina (NC), 1, 10, 0, 0.09091, 257, 449, -192, 
2013, Western Carolina (NC), 2, 10, 0, 0.16667, 235, 467, -232, 
1900, Furman (SC), 0, 2, 1, 0.16667, 5, 33, -28, 
1968, Bridgewater (VA), 5, 3, 0, 0.62500, 161, 124, 37, 
1969, Bridgewater (VA), 3, 6, 0, 0.33333, 106, 192, -86, 
1970, Bridgewater (VA), 4, 5, 0, 0.44444, 143, 121, 22, 
1971, Bridgewater (VA), 6, 3, 0, 0.66667, 152, 78, 74, 
1972, Bridgewater (VA), 4, 4, 1, 0.50000, 97, 148, -51, 
1973, Bridgewater (VA), 5, 4, 0, 0.55556, 109, 118, -9, 
1974, Bridgewater (VA), 4, 5, 0, 0.44444, 141, 190, -49, 
1975, Bridgewater (VA), 2, 7, 0, 0.22222, 76, 167, -91, 
1976, Bridgewater (VA), 1, 8, 0, 0.11111, 104, 168, -64, 
1977, Bridgewater (VA), 3, 5, 1, 0.38889, 82, 191, -109, 
1978, Bridgewater (VA), 3, 6, 0, 0.33333, 117, 139, -22, 
1979, Bridgewater (VA), 4, 5, 0, 0.44444, 121, 148, -27, 
1980, Bridgewater (VA), 6, 3, 0, 0.66667, 166, 194, -28, 
1981, Bridgewater (VA), 2, 6, 1, 0.27778, 100, 232, -132, 
1982, Bridgewater (VA), 3, 6, 0, 0.33333, 120, 172, -52, 
1983, Bridgewater (VA), 0, 9, 0, 0.00000, 69, 277, -208, 
1984, Bridgewater (VA), 1, 8, 0, 0.11111, 92, 280, -188, 
1987, Livingstone (NC), 2, 8, 0, 0.20000, 97, 216, -119, 
1988, Livingstone (NC), 4, 14, 0, 0.22222, 162, 576, -414, 
1989, Clark Atlanta (GA), 2, 8, 0, 0.20000, 123, 379, -256, 
2007, Cal St.-Sacramento, 3, 8, 0, 0.27273, 201, 305, -104, 
2008, Cal St.-Sacramento, 6, 6, 0, 0.50000, 319, 324, -5, 
2009, Cal St.-Sacramento, 5, 6, 0, 0.45455, 274, 371, -97, 
2010, Cal St.-Sacramento, 6, 5, 0, 0.54545, 353, 272, 81, 
2011, Cal St.-Sacramento, 4, 7, 0, 0.36364, 261, 301, -40, 
2012, Cal St.-Sacramento, 6, 5, 0, 0.54545, 297, 310, -13, 
2013, Cal St.-Sacramento, 5, 7, 0, 0.41667, 326, 398, -72, 
1919, Pacific (CA), 1, 4, 0, 0.20000, 27, 285, -258, 
1894, Hamilton (NY), 0, 4, 0, 0.00000, 10, 178, -168, 
1895, Hamilton (NY), 3, 3, 1, 0.50000, 38, 144, -106, 
1915, Tennessee-Chattanooga, 5, 2, 2, 0.66667, 194, 48, 146, 
1916, Tennessee-Chattanooga, 3, 5, 0, 0.37500, 103, 152, -49, 
1956, Northern Arizona, 8, 2, 0, 0.80000, 311, 93, 218, 
1957, Northern Arizona, 8, 1, 0, 0.88889, 269, 65, 204, 
1958, Northern Arizona, 11, 1, 0, 0.91667, 311, 98, 213, 
1959, Northern Arizona, 6, 2, 1, 0.72222, 135, 142, -7, 
1960, Northern Arizona, 6, 3, 2, 0.63636, 260, 176, 84, 
1961, Northern Arizona, 3, 5, 1, 0.38889, 136, 230, -94, 
1962, Northern Arizona, 6, 4, 0, 0.60000, 169, 173, -4, 
1963, Northern Arizona, 5, 3, 1, 0.61111, 194, 128, 66, 
1964, Northern Arizona, 4, 5, 0, 0.44444, 275, 123, 152, 
1948, Franklin & Marshall (PA), 5, 3, 1, 0.61111, 136, 130, 6, 
1949, Franklin & Marshall (PA), 2, 5, 2, 0.33333, 132, 166, -34, 
1950, Franklin & Marshall (PA), 9, 0, 0, 1.00000, 252, 41, 211, 
1951, Franklin & Marshall (PA), 5, 4, 0, 0.55556, 234, 110, 124, 
1952, Franklin & Marshall (PA), 7, 1, 0, 0.87500, 224, 137, 87, 
1953, Franklin & Marshall (PA), 5, 2, 0, 0.71429, 178, 106, 72, 
1954, Franklin & Marshall (PA), 3, 5, 0, 0.37500, 105, 174, -69, 
1955, Franklin & Marshall (PA), 2, 6, 0, 0.25000, 76, 159, -83, 
1956, Franklin & Marshall (PA), 5, 2, 1, 0.68750, 103, 59, 44, 
1957, Franklin & Marshall (PA), 4, 2, 1, 0.64286, 142, 72, 70, 
1958, Franklin & Marshall (PA), 5, 4, 0, 0.55556, 169, 153, 16, 
1959, Franklin & Marshall (PA), 4, 3, 1, 0.56250, 128, 199, -71, 
1960, Franklin & Marshall (PA), 2, 6, 0, 0.25000, 119, 241, -122, 
1961, Franklin & Marshall (PA), 1, 7, 0, 0.12500, 35, 205, -170, 
1962, Franklin & Marshall (PA), 0, 8, 0, 0.00000, 62, 219, -157, 
1987, Eastern Illinois, 5, 6, 0, 0.45455, 159, 200, -41, 
1988, Eastern Illinois, 5, 6, 0, 0.45455, 204, 209, -5, 
1989, Eastern Illinois, 9, 4, 0, 0.69231, 278, 180, 98, 
1990, Eastern Illinois, 5, 6, 0, 0.45455, 180, 219, -39, 
1991, Eastern Illinois, 4, 7, 0, 0.36364, 307, 264, 43, 
1992, Eastern Illinois, 5, 6, 0, 0.45455, 276, 295, -19, 
1993, Eastern Illinois, 3, 7, 1, 0.31818, 250, 310, -60, 
1994, Eastern Illinois, 6, 5, 0, 0.54545, 253, 232, 21, 
1995, Eastern Illinois, 10, 2, 0, 0.83333, 328, 201, 127, 
1996, Eastern Illinois, 8, 4, 0, 0.66667, 378, 240, 138, 
1997, Eastern Illinois, 8, 3, 0, 0.72727, 267, 213, 54, 
1998, Eastern Illinois, 6, 5, 0, 0.54545, 275, 297, -22, 
1999, Eastern Illinois, 2, 10, 0, 0.16667, 267, 365, -98, 
2000, Eastern Illinois, 8, 4, 0, 0.66667, 443, 242, 201, 
2001, Eastern Illinois, 9, 2, 0, 0.81818, 403, 255, 148, 
2002, Eastern Illinois, 8, 4, 0, 0.66667, 424, 414, 10, 
2003, Eastern Illinois, 4, 8, 0, 0.33333, 210, 268, -58, 
2004, Eastern Illinois, 5, 6, 0, 0.45455, 291, 323, -32, 
2005, Eastern Illinois, 9, 3, 0, 0.75000, 319, 230, 89, 
2006, Eastern Illinois, 8, 5, 0, 0.61538, 297, 275, 22, 
2007, Eastern Illinois, 8, 4, 0, 0.66667, 353, 316, 37, 
2008, Eastern Illinois, 5, 7, 0, 0.41667, 272, 281, -9, 
2009, Eastern Illinois, 8, 4, 0, 0.66667, 282, 255, 27, 
2010, Eastern Illinois, 2, 9, 0, 0.18182, 197, 322, -125, 
2011, Eastern Illinois, 2, 9, 0, 0.18182, 255, 345, -90, 
1933, Wagner (NY), 0, 2, 0, 0.00000, 0, 71, -71, 
1934, Wagner (NY), 1, 4, 0, 0.20000, 12, 58, -46, 
1935, Wagner (NY), 0, 5, 2, 0.14286, 13, 120, -107, 
1936, Wagner (NY), 0, 3, 1, 0.12500, 13, 125, -112, 
1923, Adrian (MI), 4, 4, 0, 0.50000, 71, 94, -23, 
1924, Adrian (MI), 6, 1, 2, 0.77778, 151, 65, 86, 
1925, Adrian (MI), 6, 3, 0, 0.66667, 84, 62, 22, 
1926, Adrian (MI), 4, 4, 1, 0.50000, 79, 121, -42, 
1927, Adrian (MI), 2, 5, 1, 0.31250, 32, 180, -148, 
1928, Adrian (MI), 5, 3, 0, 0.62500, 124, 144, -20, 
1929, Adrian (MI), 1, 7, 1, 0.16667, 57, 243, -186, 
1930, Adrian (MI), 5, 4, 0, 0.55556, 117, 198, -81, 
1931, Adrian (MI), 5, 4, 0, 0.55556, 186, 117, 69, 
1932, Adrian (MI), 2, 6, 1, 0.27778, 33, 276, -243, 
1933, Adrian (MI), 5, 3, 1, 0.61111, 138, 77, 61, 
1934, Adrian (MI), 3, 5, 1, 0.38889, 75, 172, -97, 
1935, Adrian (MI), 7, 3, 0, 0.70000, 176, 120, 56, 
1936, Albion (MI), 2, 5, 2, 0.33333, 47, 103, -56, 
1937, Albion (MI), 4, 4, 0, 0.50000, 103, 43, 60, 
1938, Albion (MI), 5, 2, 1, 0.68750, 86, 56, 30, 
1939, Albion (MI), 7, 1, 0, 0.87500, 170, 23, 147, 
1940, Albion (MI), 7, 1, 0, 0.87500, 117, 30, 87, 
1941, Albion (MI), 3, 4, 1, 0.43750, 52, 118, -66, 
1942, Albion (MI), 4, 4, 0, 0.50000, 64, 54, 10, 
1945, Albion (MI), 1, 7, 0, 0.12500, 45, 71, -26, 
1946, Albion (MI), 3, 5, 0, 0.37500, 67, 130, -63, 
1883, Albion (MI), 1, 0, 0, 1.00000, 10, 5, 5, 
1884, Albion (MI), 1, 1, 0, 0.50000, 10, 20, -10, 
1999, West Virginia Tech, 1, 10, 0, 0.09091, 146, 424, -278, 
2000, West Virginia Tech, 5, 6, 0, 0.45455, 281, 286, -5, 
2001, West Virginia Tech, 4, 4, 0, 0.50000, 165, 304, -139, 
2002, West Virginia Tech, 6, 5, 0, 0.54545, 331, 357, -26, 
2003, Charleston (WV), 2, 9, 0, 0.18182, 246, 407, -161, 
2004, Charleston (WV), 3, 7, 0, 0.30000, 272, 314, -42, 
1971, Bloomsburg (PA), 4, 5, 0, 0.44444, 134, 293, -159, 
1972, Bloomsburg (PA), 5, 5, 0, 0.50000, 207, 196, 11, 
1973, Bloomsburg (PA), 4, 5, 0, 0.44444, 122, 214, -92, 
1974, Bloomsburg (PA), 1, 7, 1, 0.16667, 59, 198, -139, 
1975, Bloomsburg (PA), 1, 8, 0, 0.11111, 56, 293, -237, 
1937, Lenoir-Rhyne (NC), 4, 5, 2, 0.45455, 65, 104, -39, 
1987, Duke (NC), 5, 6, 0, 0.45455, 301, 243, 58, 
1988, Duke (NC), 7, 3, 1, 0.68182, 324, 324, 0, 
1989, Duke (NC), 8, 4, 0, 0.66667, 377, 335, 42, 
1990, Florida, 9, 2, 0, 0.81818, 387, 171, 216, 
1991, Florida, 10, 2, 0, 0.83333, 389, 191, 198, 
1992, Florida, 9, 4, 0, 0.69231, 315, 284, 31, 
1993, Florida, 11, 2, 0, 0.84615, 513, 244, 269, 
1994, Florida, 10, 2, 1, 0.80769, 538, 228, 310, 
1995, Florida, 12, 1, 0, 0.92308, 558, 263, 295, 
1996, Florida, 12, 1, 0, 0.92308, 611, 221, 390, 
1997, Florida, 10, 2, 0, 0.83333, 430, 205, 225, 
1998, Florida, 10, 2, 0, 0.83333, 380, 165, 215, 
1999, Florida, 9, 4, 0, 0.69231, 403, 272, 131, 
2000, Florida, 10, 3, 0, 0.76923, 468, 273, 195, 
2001, Florida, 10, 2, 0, 0.83333, 538, 178, 360, 
2005, South Carolina, 7, 5, 0, 0.58333, 284, 279, 5, 
2006, South Carolina, 8, 5, 0, 0.61538, 346, 243, 103, 
2007, South Carolina, 6, 6, 0, 0.50000, 313, 282, 31, 
2008, South Carolina, 7, 6, 0, 0.53846, 270, 274, -4, 
2009, South Carolina, 7, 6, 0, 0.53846, 268, 265, 3, 
2010, South Carolina, 9, 5, 0, 0.64286, 433, 324, 109, 
2011, South Carolina, 11, 2, 0, 0.84615, 391, 239, 152, 
2012, South Carolina, 11, 2, 0, 0.84615, 410, 237, 173, 
2013, South Carolina, 11, 2, 0, 0.84615, 443, 264, 179, 
1909, New Mexico St., 1, 3, 1, 0.30000, 19, 91, -72, 
2012, DePauw (IN), 2, 6, 0, 0.25000, 153, 212, -59, 
1918, Kalamazoo (MI), 1, 2, 0, 0.33333, 29, 48, -19, 
1949, Willamette (OR), 3, 6, 0, 0.33333, 91, 244, -153, 
1950, Willamette (OR), 4, 4, 2, 0.50000, 132, 124, 8, 
1951, Willamette (OR), 3, 5, 0, 0.37500, 129, 136, -7, 
1950, Carson-Newman (TN), 3, 5, 1, 0.38889, 132, 139, -7, 
1951, Carson-Newman (TN), 4, 6, 0, 0.40000, 132, 195, -63, 
1918, North Carolina St., 1, 3, 0, 0.25000, 54, 174, -120, 
1935, Susquehanna (PA), 3, 3, 1, 0.50000, 78, 52, 26, 
1936, Susquehanna (PA), 3, 5, 0, 0.37500, 74, 96, -22, 
1937, Susquehanna (PA), 0, 7, 1, 0.06250, 25, 98, -73, 
1938, Susquehanna (PA), 1, 7, 0, 0.12500, 51, 135, -84, 
1939, Susquehanna (PA), 4, 4, 0, 0.50000, 84, 109, -25, 
1940, Susquehanna (PA), 7, 0, 1, 0.93750, 120, 38, 82, 
1941, Susquehanna (PA), 2, 6, 0, 0.25000, 42, 93, -51, 
1942, Susquehanna (PA), 1, 4, 1, 0.25000, 37, 100, -63, 
1946, Susquehanna (PA), 3, 3, 0, 0.50000, 68, 86, -18, 
1947, Susquehanna (PA), 4, 1, 2, 0.71429, 125, 86, 39, 
1948, Susquehanna (PA), 2, 6, 0, 0.25000, 64, 101, -37, 
1949, Susquehanna (PA), 1, 7, 0, 0.12500, 74, 222, -148, 
1950, Susquehanna (PA), 4, 2, 1, 0.64286, 70, 72, -2, 
1951, Susquehanna (PA), 6, 0, 0, 1.00000, 185, 91, 94, 
1952, Susquehanna (PA), 4, 3, 0, 0.57143, 166, 126, 40, 
1953, Susquehanna (PA), 0, 6, 0, 0.00000, 47, 145, -98, 
1954, Susquehanna (PA), 0, 6, 0, 0.00000, 6, 179, -173, 
1892, Chicago (IL), 8, 4, 1, 0.65385, 162, 144, 18, 
1893, Chicago (IL), 6, 4, 2, 0.58333, 142, 143, -1, 
1894, Chicago (IL), 14, 8, 1, 0.63043, 412, 138, 274, 
1895, Chicago (IL), 10, 3, 0, 0.76923, 260, 66, 194, 
1896, Chicago (IL), 15, 2, 1, 0.86111, 368, 82, 286, 
1897, Chicago (IL), 11, 1, 0, 0.91667, 331, 68, 263, 
1898, Chicago (IL), 14, 2, 1, 0.85294, 289, 48, 241, 
1899, Chicago (IL), 16, 0, 2, 0.94444, 505, 28, 477, 
1900, Chicago (IL), 9, 5, 1, 0.63333, 204, 135, 69, 
1901, Chicago (IL), 8, 6, 2, 0.56250, 175, 131, 44, 
1902, Chicago (IL), 14, 1, 0, 0.93333, 297, 32, 265, 
1903, Chicago (IL), 12, 2, 1, 0.83333, 413, 61, 352, 
1904, Chicago (IL), 10, 1, 1, 0.87500, 410, 44, 366, 
1905, Chicago (IL), 11, 0, 0, 1.00000, 271, 5, 266, 
1906, Chicago (IL), 4, 1, 0, 0.80000, 175, 17, 158, 
1907, Chicago (IL), 4, 1, 0, 0.80000, 147, 42, 105, 
1908, Chicago (IL), 5, 0, 1, 0.91667, 132, 30, 102, 
1909, Chicago (IL), 4, 1, 2, 0.71429, 134, 40, 94, 
1910, Chicago (IL), 2, 5, 0, 0.28571, 24, 66, -42, 
1911, Chicago (IL), 6, 1, 0, 0.85714, 78, 42, 36, 
1912, Chicago (IL), 6, 1, 0, 0.85714, 86, 44, 42, 
1913, Chicago (IL), 7, 0, 0, 1.00000, 124, 27, 97, 
1914, Chicago (IL), 4, 2, 1, 0.64286, 104, 34, 70, 
1915, Chicago (IL), 5, 2, 0, 0.71429, 83, 50, 33, 
1916, Chicago (IL), 3, 4, 0, 0.42857, 65, 110, -45, 
1917, Chicago (IL), 3, 2, 1, 0.58333, 82, 51, 31, 
1918, Chicago (IL), 4, 6, 1, 0.40909, 128, 91, 37, 
1919, Chicago (IL), 5, 2, 0, 0.71429, 205, 26, 179, 
1920, Chicago (IL), 3, 4, 0, 0.42857, 77, 27, 50, 
1921, Chicago (IL), 6, 1, 0, 0.85714, 111, 13, 98, 
1922, Chicago (IL), 5, 1, 1, 0.78571, 88, 37, 51, 
1923, Chicago (IL), 7, 1, 0, 0.87500, 134, 22, 112, 
1924, Chicago (IL), 4, 1, 3, 0.68750, 88, 40, 48, 
1925, Chicago (IL), 3, 4, 1, 0.43750, 44, 76, -32, 
1926, Chicago (IL), 2, 6, 0, 0.25000, 47, 116, -69, 
1927, Chicago (IL), 4, 4, 0, 0.50000, 65, 68, -3, 
1928, Chicago (IL), 2, 7, 0, 0.22222, 70, 177, -107, 
1929, Chicago (IL), 7, 3, 0, 0.70000, 130, 92, 38, 
1930, Chicago (IL), 2, 5, 2, 0.33333, 33, 129, -96, 
1931, Chicago (IL), 3, 7, 1, 0.31818, 71, 130, -59, 
1932, Chicago (IL), 3, 4, 1, 0.43750, 95, 94, 1, 
1933, Pacific (CA), 5, 5, 0, 0.50000, 71, 59, 12, 
1934, Pacific (CA), 4, 5, 0, 0.44444, 67, 76, -9, 
1935, Pacific (CA), 5, 4, 1, 0.55000, 106, 124, -18, 
1936, Pacific (CA), 5, 4, 1, 0.55000, 107, 63, 44, 
1937, Pacific (CA), 3, 5, 2, 0.40000, 58, 122, -64, 
1938, Pacific (CA), 7, 3, 0, 0.70000, 203, 103, 100, 
1939, Pacific (CA), 6, 6, 1, 0.50000, 145, 116, 29, 
1940, Pacific (CA), 4, 5, 0, 0.44444, 82, 94, -12, 
1941, Pacific (CA), 4, 7, 0, 0.36364, 72, 100, -28, 
1942, Pacific (CA), 2, 6, 1, 0.27778, 58, 141, -83, 
1943, Pacific (CA), 7, 2, 0, 0.77778, 146, 66, 80, 
1944, Pacific (CA), 3, 8, 0, 0.27273, 74, 149, -75, 
1945, Pacific (CA), 0, 10, 1, 0.04545, 33, 317, -284, 
1946, Pacific (CA), 4, 7, 0, 0.36364, 172, 177, -5, 
1941, Worcester Tech (MA), 0, 6, 0, 0.00000, 0, 209, -209, 
1942, Worcester Tech (MA), 0, 6, 0, 0.00000, 46, 214, -168, 
1943, Worcester Tech (MA), 4, 2, 0, 0.66667, 80, 38, 42, 
1944, Worcester Tech (MA), 2, 2, 2, 0.50000, 30, 65, -35, 
1945, Worcester Tech (MA), 0, 5, 0, 0.00000, 0, 200, -200, 
1946, Worcester Tech (MA), 0, 2, 0, 0.00000, 0, 68, -68, 
1920, Duquesne (PA), 3, 3, 1, 0.50000, 82, 73, 9, 
1921, Duquesne (PA), 0, 4, 1, 0.10000, 7, 100, -93, 
1920, Susquehanna (PA), 3, 3, 2, 0.50000, 129, 87, 42, 
1921, Susquehanna (PA), 2, 6, 1, 0.27778, 40, 191, -151, 
1934, Delaware, 4, 3, 1, 0.56250, 51, 71, -20, 
1941, Brown (RI), 5, 4, 0, 0.55556, 102, 81, 21, 
1942, Brown (RI), 4, 4, 0, 0.50000, 96, 114, -18, 
1943, Brown (RI), 5, 3, 0, 0.62500, 194, 180, 14, 
1946, George Washington (DC), 4, 3, 0, 0.57143, 107, 87, 20, 
1947, George Washington (DC), 1, 7, 1, 0.16667, 92, 177, -85, 
1948, Toledo (OH), 5, 6, 0, 0.45455, 206, 225, -19, 
1949, Toledo (OH), 6, 4, 0, 0.60000, 318, 210, 108, 
1954, Idaho, 4, 5, 0, 0.44444, 96, 153, -57, 
1955, Idaho, 2, 7, 0, 0.22222, 128, 174, -46, 
1956, Idaho, 4, 5, 0, 0.44444, 198, 215, -17, 
1957, Idaho, 4, 4, 1, 0.50000, 140, 108, 32, 
1958, Idaho, 4, 5, 0, 0.44444, 114, 139, -25, 
1959, Idaho, 1, 9, 0, 0.10000, 79, 293, -214, 
1960, Idaho, 1, 9, 0, 0.10000, 104, 256, -152, 
1961, Idaho, 2, 7, 0, 0.22222, 65, 351, -286, 
1905, Samford (AL), 1, 2, 1, 0.37500, 48, 91, -43, 
2013, Coe (IA), 7, 3, 0, 0.70000, 266, 160, 106, 
2002, La Salle (PA), 2, 9, 0, 0.18182, 200, 388, -188, 
2003, La Salle (PA), 3, 8, 0, 0.27273, 233, 353, -120, 
1965, Texas A&M;, 3, 7, 0, 0.30000, 80, 170, -90, 
1966, Texas A&M;, 4, 5, 1, 0.45000, 145, 183, -38, 
1967, Texas A&M;, 7, 4, 0, 0.63636, 211, 154, 57, 
1968, Texas A&M;, 3, 7, 0, 0.30000, 196, 184, 12, 
1969, Texas A&M;, 3, 7, 0, 0.30000, 116, 192, -76, 
1970, Texas A&M;, 2, 9, 0, 0.18182, 170, 304, -134, 
1971, Texas A&M;, 5, 6, 0, 0.45455, 144, 212, -68, 
1990, Alabama, 7, 5, 0, 0.58333, 260, 161, 99, 
1991, Alabama, 11, 1, 0, 0.91667, 324, 143, 181, 
1992, Alabama, 13, 0, 0, 1.00000, 366, 122, 244, 
1993, Alabama, 1, 12, 0, 0.07692, 340, 168, 172, 
1994, Alabama, 12, 1, 0, 0.92308, 305, 190, 115, 
1995, Alabama, 8, 3, 0, 0.72727, 260, 188, 72, 
1996, Alabama, 10, 3, 0, 0.76923, 316, 195, 121, 
1893, Mercer (GA), 0, 1, 0, 0.00000, 6, 10, -4, 
1941, Benedict (SC), 2, 5, 1, 0.31250, 63, 103, -40, 
1942, Benedict (SC), 4, 5, 0, 0.44444, 68, 140, -72, 
1946, Benedict (SC), 5, 5, 0, 0.50000, 129, 120, 9, 
1947, Benedict (SC), 2, 4, 2, 0.37500, 94, 77, 17, 
1948, Benedict (SC), 1, 4, 2, 0.28571, 56, 69, -13, 
1897, Mount Union (OH), 2, 4, 1, 0.35714, 40, 80, -40, 
1947, Cameron (OK), 10, 1, 0, 0.90909, 367, 113, 254, 
1923, Delaware Valley (PA), 1, 7, 0, 0.12500, 12, 135, -123, 
1969, Cal St.-Long Beach, 8, 3, 0, 0.72727, 319, 199, 120, 
1970, Cal St.-Long Beach, 9, 2, 1, 0.79167, 317, 135, 182, 
1971, Cal St.-Long Beach, 8, 4, 0, 0.66667, 335, 231, 104, 
1972, Cal St.-Long Beach, 5, 6, 0, 0.45455, 224, 272, -48, 
1973, Cal St.-Long Beach, 1, 9, 1, 0.13636, 124, 199, -75, 
1924, Arkansas St., 4, 5, 0, 0.44444, 101, 89, 12, 
1933, Florida, 5, 3, 1, 0.61111, 114, 53, 61, 
1934, Florida, 6, 3, 1, 0.65000, 113, 110, 3, 
1935, Florida, 3, 7, 0, 0.30000, 113, 154, -41, 
1945, Beloit (WI), 2, 4, 0, 0.33333, 109, 109, 0, 
1973, Oklahoma St., 5, 4, 2, 0.54545, 303, 186, 117, 
1974, Oklahoma St., 7, 5, 0, 0.58333, 262, 183, 79, 
1975, Oklahoma St., 7, 4, 0, 0.63636, 285, 178, 107, 
1976, Oklahoma St., 9, 3, 0, 0.75000, 329, 214, 115, 
1977, Oklahoma St., 4, 7, 0, 0.36364, 235, 267, -32, 
1978, Oklahoma St., 3, 8, 0, 0.27273, 167, 266, -99, 
1899, Colgate (NY), 3, 5, 0, 0.37500, 47, 133, -86, 
1909, Hendrix (AR), 4, 1, 0, 0.80000, 179, 45, 134, 
1910, Hendrix (AR), 4, 2, 0, 0.66667, 175, 25, 150, 
1911, Hendrix (AR), 3, 1, 2, 0.66667, 116, 61, 55, 
1912, Hendrix (AR), 2, 3, 0, 0.40000, 178, 88, 90, 
1958, Iowa St., 4, 6, 0, 0.40000, 127, 88, 39, 
1959, Iowa St., 7, 3, 0, 0.70000, 248, 80, 168, 
1960, Iowa St., 7, 3, 0, 0.70000, 185, 136, 49, 
1961, Iowa St., 5, 5, 0, 0.50000, 151, 133, 18, 
1962, Iowa St., 5, 5, 0, 0.50000, 235, 235, 0, 
1963, Iowa St., 4, 5, 0, 0.44444, 129, 143, -14, 
1964, Iowa St., 1, 8, 1, 0.15000, 72, 155, -83, 
1965, Iowa St., 5, 4, 1, 0.55000, 178, 147, 31, 
1966, Iowa St., 2, 6, 2, 0.30000, 160, 211, -51, 
1967, Iowa St., 2, 8, 0, 0.20000, 86, 275, -189, 
1936, Northern Iowa, 5, 2, 2, 0.66667, 91, 45, 46, 
1937, Northern Iowa, 2, 4, 3, 0.38889, 97, 94, 3, 
1938, Northern Iowa, 3, 5, 0, 0.37500, 60, 99, -39, 
1939, Northern Iowa, 5, 3, 1, 0.61111, 94, 92, 2, 
1940, Northern Iowa, 8, 1, 0, 0.88889, 165, 68, 97, 
1941, Northern Iowa, 5, 3, 0, 0.62500, 164, 82, 82, 
1942, Northern Iowa, 6, 1, 0, 0.85714, 208, 51, 157, 
1945, Northern Iowa, 3, 3, 0, 0.50000, 141, 163, -22, 
1946, Northern Iowa, 4, 1, 2, 0.71429, 175, 32, 143, 
1947, Northern Iowa, 5, 3, 1, 0.61111, 163, 101, 62, 
1948, Northern Iowa, 7, 3, 0, 0.70000, 177, 113, 64, 
1949, Northern Iowa, 5, 2, 0, 0.71429, 186, 64, 122, 
1950, Northern Iowa, 4, 4, 0, 0.50000, 159, 174, -15, 
1951, Northern Iowa, 3, 4, 0, 0.42857, 176, 172, 4, 
1952, Northern Iowa, 6, 2, 0, 0.75000, 240, 146, 94, 
1953, Northern Iowa, 6, 3, 0, 0.66667, 248, 207, 41, 
1954, Northern Iowa, 3, 5, 0, 0.37500, 201, 164, 37, 
1955, Northern Iowa, 8, 1, 0, 0.88889, 220, 114, 106, 
1956, Northern Iowa, 2, 5, 1, 0.31250, 168, 149, 19, 
1957, Northern Iowa, 5, 3, 0, 0.62500, 200, 130, 70, 
1901, Cornell (NY), 11, 1, 0, 0.91667, 333, 14, 319, 
1902, Cornell (NY), 8, 3, 0, 0.72727, 324, 38, 286, 
1969, Augustana (SD), 3, 6, 0, 0.33333, 125, 219, -94, 
1970, Augustana (SD), 4, 6, 0, 0.40000, 152, 220, -68, 
1971, Augustana (SD), 1, 8, 1, 0.15000, 111, 223, -112, 
1972, Augustana (SD), 2, 8, 0, 0.20000, 169, 226, -57, 
1973, Augustana (SD), 6, 3, 1, 0.65000, 288, 147, 141, 
1974, Augustana (SD), 4, 6, 0, 0.40000, 205, 200, 5, 
1975, Augustana (SD), 7, 3, 0, 0.70000, 268, 213, 55, 
1976, Augustana (SD), 4, 6, 0, 0.40000, 200, 178, 22, 
1927, Chadron St. (NE), 7, 2, 0, 0.77778, 339, 63, 276, 
1928, Chadron St. (NE), 5, 2, 0, 0.71429, 108, 39, 69, 
1929, Chadron St. (NE), 8, 1, 0, 0.88889, 141, 41, 100, 
1930, Creighton (NE), 1, 7, 0, 0.12500, 40, 147, -107, 
1931, Creighton (NE), 4, 5, 0, 0.44444, 83, 107, -24, 
1932, Creighton (NE), 5, 2, 1, 0.68750, 115, 65, 50, 
1933, Creighton (NE), 3, 4, 1, 0.43750, 60, 80, -20, 
1935, Kent St. (OH), 3, 5, 0, 0.37500, 127, 108, 19, 
1936, Kent St. (OH), 4, 4, 0, 0.50000, 103, 59, 44, 
1937, Kent St. (OH), 3, 4, 1, 0.43750, 78, 73, 5, 
1938, Kent St. (OH), 6, 2, 0, 0.75000, 174, 69, 105, 
1939, Kent St. (OH), 3, 4, 1, 0.43750, 66, 140, -74, 
1940, Kent St. (OH), 8, 1, 0, 0.88889, 186, 43, 143, 
1941, Kent St. (OH), 2, 5, 1, 0.31250, 109, 100, 9, 
1942, Kent St. (OH), 5, 3, 0, 0.62500, 114, 113, 1, 
1946, Lenoir-Rhyne (NC), 5, 6, 0, 0.45455, 99, 168, -69, 
1947, Lenoir-Rhyne (NC), 5, 4, 1, 0.55000, 141, 83, 58, 
1948, Lenoir-Rhyne (NC), 6, 3, 1, 0.65000, 133, 61, 72, 
1949, Lenoir-Rhyne (NC), 7, 3, 0, 0.70000, 143, 87, 56, 
1950, Lenoir-Rhyne (NC), 8, 2, 0, 0.80000, 271, 81, 190, 
1951, Lenoir-Rhyne (NC), 10, 1, 0, 0.90909, 305, 89, 216, 
1952, Lenoir-Rhyne (NC), 8, 1, 0, 0.88889, 370, 78, 292, 
1953, Lenoir-Rhyne (NC), 4, 5, 0, 0.44444, 107, 167, -60, 
1954, Lenoir-Rhyne (NC), 2, 7, 1, 0.25000, 137, 132, 5, 
1955, Lenoir-Rhyne (NC), 9, 0, 1, 0.95000, 242, 74, 168, 
1956, Lenoir-Rhyne (NC), 10, 0, 0, 1.00000, 380, 70, 310, 
1957, Lenoir-Rhyne (NC), 8, 2, 1, 0.77273, 387, 59, 328, 
1958, Lenoir-Rhyne (NC), 9, 1, 0, 0.90000, 331, 77, 254, 
1959, Lenoir-Rhyne (NC), 10, 1, 0, 0.90909, 390, 136, 254, 
1960, Lenoir-Rhyne (NC), 12, 0, 0, 1.00000, 336, 92, 244, 
1961, Lenoir-Rhyne (NC), 8, 1, 1, 0.85000, 251, 122, 129, 
1962, East Carolina (NC), 5, 4, 0, 0.55556, 217, 136, 81, 
1963, East Carolina (NC), 9, 1, 0, 0.90000, 230, 54, 176, 
1964, East Carolina (NC), 9, 1, 0, 0.90000, 279, 108, 171, 
1965, East Carolina (NC), 9, 1, 0, 0.90000, 299, 83, 216, 
1966, East Carolina (NC), 4, 5, 1, 0.45000, 144, 175, -31, 
1967, East Carolina (NC), 8, 2, 0, 0.80000, 253, 178, 75, 
1968, East Carolina (NC), 4, 6, 0, 0.40000, 175, 244, -69, 
1969, East Carolina (NC), 2, 7, 0, 0.22222, 108, 204, -96, 
2002, Minnesota-Crookston, 1, 10, 0, 0.09091, 184, 440, -256, 
2003, Minnesota-Crookston, 2, 9, 0, 0.18182, 199, 450, -251, 
2004, Minnesota-Crookston, 2, 8, 0, 0.20000, 173, 332, -159, 
2005, Minnesota-Crookston, 1, 10, 0, 0.09091, 128, 562, -434, 
2006, Minnesota-Crookston, 0, 11, 0, 0.00000, 39, 471, -432, 
2007, Minnesota-Crookston, 2, 8, 0, 0.20000, 124, 361, -237, 
2008, Minnesota-Crookston, 2, 9, 0, 0.18182, 166, 470, -304, 
2009, Minnesota-Crookston, 1, 10, 0, 0.09091, 154, 476, -322, 
2010, Minnesota-Crookston, 1, 10, 0, 0.09091, 106, 496, -390, 
1977, Cincinnati (OH), 5, 4, 2, 0.54545, 250, 121, 129, 
1978, Cincinnati (OH), 5, 6, 0, 0.45455, 279, 224, 55, 
1979, Cincinnati (OH), 2, 9, 0, 0.18182, 156, 281, -125, 
1980, Cincinnati (OH), 2, 9, 0, 0.18182, 122, 271, -149, 
1909, Mississippi, 4, 3, 2, 0.55556, 99, 49, 50, 
1910, Mississippi, 7, 1, 0, 0.87500, 144, 9, 135, 
1911, Mississippi, 6, 3, 0, 0.66667, 184, 55, 129, 
1910, Tennessee-Chattanooga, 5, 2, 1, 0.68750, 142, 44, 98, 
1911, Tennessee-Chattanooga, 3, 2, 0, 0.60000, 50, 30, 20, 
1912, Tennessee-Chattanooga, 4, 4, 0, 0.50000, 145, 110, 35, 
1913, Tennessee-Chattanooga, 4, 3, 0, 0.57143, 186, 151, 35, 
1992, Eastern New Mexico, 5, 5, 0, 0.50000, 241, 220, 21, 
1993, Eastern New Mexico, 1, 8, 1, 0.15000, 170, 300, -130, 
2011, Missouri, 1, 0, 0, 1.00000, 31, 27, 4, 
1901, Nevada, 3, 3, 0, 0.50000, 64, 31, 33, 
1902, Nevada, 1, 2, 0, 0.33333, 21, 40, -19, 
1903, Nevada, 2, 4, 2, 0.37500, 56, 40, 16, 
1904, Oregon St., 4, 2, 0, 0.66667, 119, 22, 97, 
1905, Oregon St., 6, 3, 0, 0.66667, 164, 28, 136, 
2008, Campbell (NC), 1, 10, 0, 0.09091, 98, 447, -349, 
2009, Campbell (NC), 3, 8, 0, 0.27273, 214, 315, -101, 
2010, Campbell (NC), 3, 8, 0, 0.27273, 261, 294, -33, 
2011, Campbell (NC), 6, 5, 0, 0.54545, 379, 324, 55, 
2012, Campbell (NC), 1, 10, 0, 0.09091, 156, 422, -266, 
1920, Alma (MI), 0, 7, 0, 0.00000, 19, 234, -215, 
1989, Pennsylvania, 4, 6, 0, 0.40000, 171, 229, -58, 
1990, Pennsylvania, 3, 7, 0, 0.30000, 155, 197, -42, 
1991, Pennsylvania, 2, 8, 0, 0.20000, 142, 236, -94, 
1999, Baylor (TX), 1, 10, 0, 0.09091, 137, 414, -277, 
2000, Baylor (TX), 2, 9, 0, 0.18182, 139, 397, -258, 
2001, Baylor (TX), 3, 8, 0, 0.27273, 205, 357, -152, 
2002, Baylor (TX), 3, 9, 0, 0.25000, 202, 496, -294, 
1992, West Texas A&M;, 1, 9, 0, 0.10000, 114, 358, -244, 
1993, West Texas A&M;, 3, 6, 0, 0.33333, 249, 286, -37, 
1980, Arkansas Tech, 6, 4, 0, 0.60000, 247, 263, -16, 
1981, Arkansas Tech, 4, 5, 1, 0.45000, 241, 238, 3, 
1982, Arkansas Tech, 3, 7, 0, 0.30000, 180, 219, -39, 
1983, Arkansas Tech, 4, 5, 1, 0.45000, 138, 164, -26, 
1984, Arkansas Tech, 4, 5, 0, 0.44444, 110, 138, -28, 
1985, Arkansas Tech, 1, 9, 0, 0.10000, 128, 228, -100, 
1929, California (PA), 4, 4, 0, 0.50000, 100, 51, 49, 
1930, California (PA), 5, 2, 1, 0.68750, 108, 52, 56, 
1931, California (PA), 4, 2, 2, 0.62500, 42, 37, 5, 
1932, California (PA), 3, 2, 1, 0.58333, 22, 27, -5, 
1933, California (PA), 4, 3, 0, 0.57143, 31, 72, -41, 
1934, California (PA), 4, 2, 1, 0.64286, 48, 59, -11, 
1935, California (PA), 4, 3, 0, 0.57143, 89, 85, 4, 
1936, California (PA), 3, 4, 1, 0.43750, 37, 126, -89, 
1937, California (PA), 4, 3, 1, 0.56250, 28, 49, -21, 
1938, California (PA), 2, 3, 2, 0.42857, 30, 53, -23, 
1950, Adams St. (CO), 2, 5, 2, 0.33333, 116, 224, -108, 
1951, Adams St. (CO), 3, 6, 0, 0.33333, 130, 290, -160, 
1915, Beloit (WI), 0, 6, 1, 0.07143, 3, 121, -118, 
1916, Monmouth (IL), 5, 2, 1, 0.68750, 136, 90, 46, 
1917, Monmouth (IL), 4, 3, 1, 0.56250, 129, 85, 44, 
1920, Georgia, 8, 0, 1, 0.94444, 250, 17, 233, 
1921, Georgia, 7, 2, 1, 0.75000, 161, 31, 130, 
1922, Georgia, 5, 4, 1, 0.55000, 178, 77, 101, 
1920, Monmouth (IL), 1, 7, 0, 0.12500, 64, 164, -100, 
1921, Monmouth (IL), 1, 7, 0, 0.12500, 28, 214, -186, 
1922, Oglethorpe (GA), 1, 9, 0, 0.10000, 57, 196, -139, 
1922, Duke (NC), 7, 2, 1, 0.75000, 156, 57, 99, 
1954, Texas A&M-Kingsville;, 6, 5, 0, 0.54545, 147, 161, -14, 
1955, Texas A&M-Kingsville;, 4, 6, 0, 0.40000, 167, 189, -22, 
1956, Texas A&M-Kingsville;, 7, 3, 0, 0.70000, 228, 129, 99, 
1957, Texas A&M-Kingsville;, 5, 5, 1, 0.50000, 199, 155, 44, 
1958, Texas A&M-Kingsville;, 7, 4, 0, 0.63636, 174, 101, 73, 
1959, Texas A&M-Kingsville;, 12, 1, 0, 0.92308, 231, 114, 117, 
1960, Texas A&M-Kingsville;, 8, 1, 1, 0.85000, 337, 95, 242, 
1961, Texas A&M-Kingsville;, 7, 2, 0, 0.77778, 171, 102, 69, 
1962, Texas A&M-Kingsville;, 9, 0, 1, 0.95000, 233, 64, 169, 
1963, Texas A&M-Kingsville;, 5, 4, 0, 0.55556, 173, 127, 46, 
1964, Texas A&M-Kingsville;, 7, 2, 1, 0.75000, 207, 97, 110, 
1965, Texas A&M-Kingsville;, 6, 3, 0, 0.66667, 147, 113, 34, 
1966, Texas A&M-Kingsville;, 5, 5, 0, 0.50000, 140, 96, 44, 
1967, Texas A&M-Kingsville;, 9, 0, 0, 1.00000, 229, 63, 166, 
1968, Texas A&M-Kingsville;, 10, 2, 0, 0.83333, 371, 129, 242, 
1969, Texas A&M-Kingsville;, 11, 1, 0, 0.91667, 314, 145, 169, 
1970, Texas A&M-Kingsville;, 11, 1, 0, 0.91667, 327, 145, 182, 
1971, Texas A&M-Kingsville;, 7, 3, 0, 0.70000, 197, 134, 63, 
1972, Texas A&M-Kingsville;, 6, 5, 0, 0.54545, 230, 147, 83, 
1973, Texas A&M-Kingsville;, 2, 8, 0, 0.20000, 197, 253, -56, 
1974, Texas A&M-Kingsville;, 13, 0, 0, 1.00000, 435, 192, 243, 
1975, Texas A&M-Kingsville;, 12, 0, 0, 1.00000, 437, 102, 335, 
1976, Texas A&M-Kingsville;, 13, 0, 0, 1.00000, 593, 107, 486, 
1924, Bowling Green (OH), 3, 4, 0, 0.42857, 60, 73, -13, 
1925, Bowling Green (OH), 3, 1, 3, 0.64286, 34, 28, 6, 
1926, Bowling Green (OH), 4, 3, 1, 0.56250, 88, 70, 18, 
1927, Bowling Green (OH), 5, 1, 1, 0.78571, 52, 14, 38, 
1928, Bowling Green (OH), 5, 0, 2, 0.85714, 84, 18, 66, 
1929, Bowling Green (OH), 4, 2, 1, 0.64286, 76, 54, 22, 
1930, Bowling Green (OH), 6, 0, 2, 0.87500, 107, 38, 69, 
1931, Bowling Green (OH), 3, 1, 4, 0.62500, 31, 21, 10, 
1932, Bowling Green (OH), 3, 3, 1, 0.50000, 33, 77, -44, 
1933, Bowling Green (OH), 2, 3, 2, 0.42857, 44, 91, -47, 
1934, Bowling Green (OH), 2, 3, 2, 0.42857, 36, 54, -18, 
1951, Cedarville (OH), 2, 6, 0, 0.25000, 64, 190, -126, 
1979, Fordham (NY), 0, 9, 0, 0.00000, 166, 216, -50, 
1980, Fordham (NY), 0, 9, 0, 0.00000, 161, 239, -78, 
1972, Central Arkansas, 2, 7, 1, 0.25000, 101, 256, -155, 
1973, Central Arkansas, 6, 5, 0, 0.54545, 188, 208, -20, 
1974, Central Arkansas, 7, 2, 2, 0.72727, 233, 120, 113, 
1975, Central Arkansas, 4, 6, 1, 0.40909, 91, 130, -39, 
1976, Central Arkansas, 9, 3, 0, 0.75000, 254, 90, 164, 
1977, Central Arkansas, 7, 3, 0, 0.70000, 176, 122, 54, 
1978, Central Arkansas, 9, 2, 0, 0.81818, 238, 142, 96, 
1979, Central Arkansas, 7, 2, 2, 0.72727, 258, 165, 93, 
1980, Central Arkansas, 9, 1, 0, 0.90000, 311, 148, 163, 
1981, Central Arkansas, 8, 3, 0, 0.72727, 279, 219, 60, 
1982, Lamar (TX), 4, 7, 0, 0.36364, 150, 248, -98, 
1983, Lamar (TX), 2, 9, 0, 0.18182, 132, 233, -101, 
1984, Lamar (TX), 2, 9, 0, 0.18182, 125, 261, -136, 
1985, Lamar (TX), 3, 8, 0, 0.27273, 196, 277, -81, 
1986, Arkansas Tech, 6, 4, 0, 0.60000, 233, 179, 54, 
1987, Arkansas Tech, 2, 6, 1, 0.27778, 113, 256, -143, 
1988, Arkansas Tech, 6, 4, 0, 0.60000, 148, 141, 7, 
1989, Arkansas Tech, 6, 3, 0, 0.66667, 166, 197, -31, 
1990, Arkansas Tech, 4, 6, 0, 0.40000, 158, 212, -54, 
1991, Arkansas Tech, 1, 9, 0, 0.10000, 223, 236, -13, 
1992, Arkansas Tech, 4, 5, 1, 0.45000, 177, 201, -24, 
1924, Middle Tennessee St., 1, 7, 0, 0.12500, 26, 160, -134, 
1925, Middle Tennessee St., 3, 4, 2, 0.44444, 104, 121, -17, 
1920, Jacksonville St. (AL), 7, 1, 1, 0.83333, 221, 26, 195, 
1921, Jacksonville St. (AL), 5, 2, 2, 0.66667, 275, 107, 168, 
1929, Jacksonville St. (AL), 5, 3, 0, 0.62500, 90, 84, 6, 
1930, Jacksonville St. (AL), 4, 3, 1, 0.56250, 104, 97, 7, 
1965, Central St. (OH), 3, 5, 0, 0.37500, 120, 176, -56, 
1966, Central St. (OH), 3, 5, 1, 0.38889, 126, 144, -18, 
1913, Central Arkansas, 2, 3, 0, 0.40000, 64, 107, -43, 
2013, McPherson (KS), 5, 6, 0, 0.45455, 276, 279, -3, 
2013, Saint Olaf (MN), 1, 9, 0, 0.10000, 202, 353, -151, 
1973, Southwest St. (MN), 4, 6, 0, 0.40000, 167, 222, -55, 
1974, Southwest St. (MN), 4, 5, 0, 0.44444, 177, 270, -93, 
1975, Southwest St. (MN), 1, 7, 0, 0.12500, 74, 327, -253, 
1976, Southwest St. (MN), 0, 9, 0, 0.00000, 76, 407, -331, 
1931, Bemidji St. (MN), 4, 3, 0, 0.57143, 90, 84, 6, 
1932, Bemidji St. (MN), 3, 4, 1, 0.43750, 71, 52, 19, 
1933, Bemidji St. (MN), 3, 3, 1, 0.50000, 92, 50, 42, 
1934, Bemidji St. (MN), 3, 5, 0, 0.37500, 36, 102, -66, 
1982, Hamilton (NY), 1, 7, 0, 0.12500, 90, 147, -57, 
1983, Hamilton (NY), 2, 6, 0, 0.25000, 116, 221, -105, 
1984, Hamilton (NY), 6, 1, 1, 0.81250, 167, 114, 53, 
1985, Boston (MA), 3, 8, 0, 0.27273, 172, 265, -93, 
1986, Boston (MA), 4, 7, 0, 0.36364, 205, 304, -99, 
1987, Boston (MA), 3, 8, 0, 0.27273, 175, 226, -51, 
2006, Hamilton (NY), 2, 6, 0, 0.25000, 24, 82, -58, 
2007, Hamilton (NY), 2, 6, 0, 0.25000, 91, 172, -81, 
2008, Hamilton (NY), 2, 6, 0, 0.25000, 136, 158, -22, 
2009, Hamilton (NY), 2, 6, 0, 0.25000, 91, 203, -112, 
2010, Hamilton (NY), 1, 7, 0, 0.12500, 127, 238, -111, 
2011, Hamilton (NY), 3, 5, 0, 0.37500, 101, 159, -58, 
1959, Brigham Young (UT), 3, 7, 0, 0.30000, 101, 169, -68, 
1960, Brigham Young (UT), 3, 8, 0, 0.27273, 102, 207, -105, 
1949, Prairie View A&M; (TX), 8, 3, 0, 0.72727, 216, 135, 81, 
1950, Prairie View A&M; (TX), 8, 3, 0, 0.72727, 225, 83, 142, 
1951, Prairie View A&M; (TX), 9, 1, 0, 0.90000, 346, 76, 270, 
1965, North Carolina Central, 3, 5, 1, 0.38889, 82, 196, -114, 
1966, North Carolina Central, 6, 3, 0, 0.66667, 129, 94, 35, 
1967, North Carolina Central, 1, 7, 1, 0.16667, 113, 244, -131, 
1928, Yale (CT), 4, 4, 0, 0.50000, 106, 73, 33, 
1929, Yale (CT), 5, 2, 1, 0.68750, 172, 69, 103, 
1930, Yale (CT), 5, 2, 2, 0.66667, 196, 58, 138, 
1931, Yale (CT), 5, 1, 2, 0.75000, 198, 79, 119, 
1932, Yale (CT), 2, 2, 3, 0.50000, 41, 41, 0, 
1934, New York (NY), 3, 4, 1, 0.43750, 105, 108, -3, 
1935, New York (NY), 7, 1, 0, 0.87500, 206, 47, 159, 
1936, New York (NY), 5, 3, 1, 0.61111, 176, 108, 68, 
1937, New York (NY), 5, 4, 0, 0.55556, 154, 85, 69, 
1938, New York (NY), 4, 4, 0, 0.50000, 108, 84, 24, 
1939, New York (NY), 5, 4, 0, 0.55556, 105, 85, 20, 
1940, New York (NY), 2, 7, 0, 0.22222, 71, 185, -114, 
1941, New York (NY), 2, 7, 0, 0.22222, 47, 243, -196, 
1956, Temple (PA), 3, 5, 0, 0.37500, 94, 126, -32, 
1957, Temple (PA), 1, 6, 0, 0.14286, 62, 210, -148, 
1958, Temple (PA), 0, 8, 0, 0.00000, 56, 251, -195, 
1959, Temple (PA), 0, 9, 0, 0.00000, 73, 270, -197, 
1954, Western Illinois, 6, 1, 3, 0.75000, 170, 120, 50, 
1955, Western Illinois, 5, 4, 1, 0.55000, 192, 114, 78, 
1956, Western Illinois, 6, 3, 0, 0.66667, 211, 151, 60, 
1908, Virginia Union, 0, 4, 0, 0.00000, 0, 44, -44, 
1909, Virginia Union, 1, 1, 1, 0.50000, 28, 22, 6, 
1910, Virginia Union, 1, 2, 0, 0.33333, 10, 21, -11, 
1923, Northern Arizona, 6, 1, 0, 0.85714, 168, 43, 125, 
1994, Virginia Military Institute, 1, 10, 0, 0.09091, 153, 437, -284, 
1995, Virginia Military Institute, 4, 7, 0, 0.36364, 269, 350, -81, 
1996, Virginia Military Institute, 3, 8, 0, 0.27273, 189, 296, -107, 
2007, West Virginia, 1, 0, 0, 1.00000, 48, 28, 20, 
2008, West Virginia, 9, 4, 0, 0.69231, 319, 221, 98, 
2009, West Virginia, 9, 4, 0, 0.69231, 340, 282, 58, 
2010, West Virginia, 9, 4, 0, 0.69231, 327, 176, 151, 
1923, Alderson (WV), 5, 4, 0, 0.55556, 117, 100, 17, 
1907, Mount Union (OH), 9, 2, 0, 0.81818, 265, 23, 242, 
1909, Allegheny (PA), 2, 5, 0, 0.28571, 36, 115, -79, 
1910, Allegheny (PA), 4, 1, 1, 0.75000, 81, 29, 52, 
1913, Oregon St., 3, 2, 3, 0.56250, 59, 75, -16, 
1914, Oregon St., 7, 0, 2, 0.88889, 172, 15, 157, 
1915, Oregon St., 5, 3, 0, 0.62500, 166, 73, 93, 
1916, Nebraska, 6, 2, 0, 0.75000, 145, 51, 94, 
1917, Nebraska, 5, 2, 0, 0.71429, 228, 33, 195, 
1921, Clemson (SC), 1, 6, 2, 0.22222, 48, 187, -139, 
1922, Clemson (SC), 5, 4, 0, 0.55556, 170, 109, 61, 
1923, Texas, 8, 0, 1, 0.94444, 241, 21, 220, 
1924, Texas, 5, 3, 1, 0.61111, 109, 64, 45, 
1925, Texas, 6, 2, 1, 0.72222, 157, 51, 106, 
1926, Texas, 5, 4, 0, 0.55556, 146, 69, 77, 
1927, Texas-El Paso, 2, 2, 2, 0.50000, 69, 69, 0, 
1928, Texas-El Paso, 3, 4, 1, 0.43750, 100, 103, -3, 
1939, Appalachian St. (NC), 7, 1, 2, 0.80000, 269, 33, 236, 
1899, Monmouth (IL), 0, 2, 0, 0.00000, 0, 53, -53, 
1942, Southern Methodist (TX), 3, 6, 2, 0.36364, 126, 133, -7, 
1943, Southern Methodist (TX), 2, 7, 0, 0.22222, 69, 115, -46, 
1944, Southern Methodist (TX), 5, 5, 0, 0.50000, 131, 201, -70, 
1903, Illinois St., 3, 1, 0, 0.75000, 63, 22, 41, 
1904, Illinois St., 2, 5, 0, 0.28571, 33, 102, -69, 
1905, Illinois St., 8, 2, 0, 0.80000, 165, 28, 137, 
1906, Illinois St., 2, 3, 1, 0.41667, 55, 31, 24, 
1918, South Dakota, 1, 2, 0, 0.33333, 33, 20, 13, 
1919, South Dakota, 2, 6, 0, 0.25000, 38, 95, -57, 
1922, Montana, 3, 4, 0, 0.42857, 65, 133, -68, 
1923, Montana, 4, 4, 0, 0.50000, 108, 117, -9, 
1956, South Dakota, 4, 4, 0, 0.50000, 115, 142, -27, 
1957, South Dakota, 4, 4, 1, 0.50000, 140, 146, -6, 
1958, South Dakota, 5, 4, 0, 0.55556, 137, 137, 0, 
1959, South Dakota, 4, 5, 1, 0.45000, 190, 213, -23, 
1960, South Dakota, 1, 8, 0, 0.11111, 62, 220, -158, 
1961, South Dakota, 1, 8, 0, 0.11111, 126, 245, -119, 
1932, Murray St. (KY), 4, 2, 3, 0.61111, 132, 21, 111, 
1933, Murray St. (KY), 9, 0, 0, 1.00000, 255, 25, 230, 
1934, Murray St. (KY), 6, 3, 0, 0.66667, 180, 67, 113, 
1935, Murray St. (KY), 4, 5, 0, 0.44444, 131, 99, 32, 
1936, Murray St. (KY), 5, 4, 0, 0.55556, 164, 92, 72, 
1937, Murray St. (KY), 8, 1, 1, 0.85000, 219, 62, 157, 
1938, Murray St. (KY), 6, 2, 1, 0.72222, 199, 68, 131, 
1939, Murray St. (KY), 4, 4, 1, 0.50000, 110, 102, 8, 
1940, Murray St. (KY), 4, 3, 2, 0.55556, 142, 74, 68, 
1942, Murray St. (KY), 1, 6, 2, 0.22222, 63, 156, -93, 
1944, Murray St. (KY), 5, 2, 0, 0.71429, 166, 64, 102, 
1945, Murray St. (KY), 5, 2, 1, 0.68750, 176, 129, 47, 
1912, Texas Christian, 8, 1, 0, 0.88889, 230, 53, 177, 
1899, Oregon St., 3, 2, 0, 0.60000, 75, 60, 15, 
1894, Wisconsin, 5, 2, 0, 0.71429, 158, 20, 138, 
1895, Wisconsin, 5, 2, 1, 0.68750, 144, 71, 73, 
1937, Oklahoma, 5, 2, 2, 0.66667, 98, 39, 59, 
1938, Oklahoma, 10, 1, 0, 0.90909, 185, 29, 156, 
1939, Oklahoma, 6, 2, 1, 0.72222, 186, 62, 124, 
1940, Oklahoma, 6, 3, 0, 0.66667, 121, 105, 16, 
1941, Marquette (WI), 4, 5, 0, 0.44444, 170, 151, 19, 
1942, Marquette (WI), 7, 2, 0, 0.77778, 193, 90, 103, 
1943, Marquette (WI), 3, 4, 1, 0.43750, 143, 153, -10, 
1944, Marquette (WI), 1, 7, 0, 0.12500, 73, 191, -118, 
1945, Marquette (WI), 5, 4, 1, 0.55000, 238, 156, 82, 
1998, South Dakota St., 6, 5, 0, 0.54545, 294, 244, 50, 
1999, South Dakota St., 8, 3, 0, 0.72727, 351, 309, 42, 
2000, South Dakota St., 6, 5, 0, 0.54545, 291, 255, 36, 
2001, South Dakota St., 5, 6, 0, 0.45455, 284, 301, -17, 
2002, South Dakota St., 6, 4, 0, 0.60000, 267, 224, 43, 
2003, South Dakota St., 7, 4, 0, 0.63636, 297, 192, 105, 
2004, South Dakota St., 6, 5, 0, 0.54545, 245, 263, -18, 
2005, South Dakota St., 6, 5, 0, 0.54545, 363, 251, 112, 
2006, South Dakota St., 7, 4, 0, 0.63636, 235, 235, 0, 
2007, South Dakota St., 7, 4, 0, 0.63636, 376, 244, 132, 
2008, South Dakota St., 7, 5, 0, 0.58333, 427, 348, 79, 
2009, South Dakota St., 8, 4, 0, 0.66667, 333, 209, 124, 
2010, South Dakota St., 5, 6, 0, 0.45455, 234, 232, 2, 
2011, South Dakota St., 5, 6, 0, 0.45455, 265, 364, -99, 
2012, South Dakota St., 9, 4, 0, 0.69231, 304, 213, 91, 
2013, South Dakota St., 9, 5, 0, 0.64286, 405, 330, 75, 
1956, Rutgers (NJ), 3, 7, 0, 0.30000, 117, 240, -123, 
1957, Rutgers (NJ), 5, 4, 0, 0.55556, 181, 133, 48, 
1958, Rutgers (NJ), 8, 1, 0, 0.88889, 301, 77, 224, 
1959, Rutgers (NJ), 6, 3, 0, 0.66667, 132, 121, 11, 
1960, Pennsylvania, 3, 6, 0, 0.33333, 104, 149, -45, 
1961, Pennsylvania, 2, 7, 0, 0.22222, 42, 194, -152, 
1962, Pennsylvania, 3, 6, 0, 0.33333, 90, 174, -84, 
1963, Pennsylvania, 3, 6, 0, 0.33333, 97, 189, -92, 
1964, Pennsylvania, 1, 8, 0, 0.11111, 48, 222, -174, 
1911, Nebraska, 5, 1, 2, 0.75000, 281, 33, 248, 
1912, Nebraska, 7, 1, 0, 0.87500, 220, 37, 183, 
1913, Nebraska, 8, 0, 0, 1.00000, 138, 28, 110, 
1914, Nebraska, 7, 0, 1, 0.93750, 174, 28, 146, 
1915, Nebraska, 8, 0, 0, 1.00000, 282, 39, 243, 
1916, Indiana, 2, 4, 1, 0.35714, 51, 90, -39, 
1917, Indiana, 5, 2, 0, 0.71429, 225, 59, 166, 
1918, Indiana, 2, 2, 0, 0.50000, 64, 31, 33, 
1919, Indiana, 3, 4, 0, 0.42857, 70, 64, 6, 
1920, Indiana, 5, 2, 0, 0.71429, 129, 48, 81, 
1921, Indiana, 3, 4, 0, 0.42857, 86, 94, -8, 
1976, San Jose St. (CA), 7, 4, 0, 0.63636, 354, 213, 141, 
1977, San Jose St. (CA), 4, 7, 0, 0.36364, 231, 299, -68, 
1978, San Jose St. (CA), 7, 5, 0, 0.58333, 259, 248, 11, 
1901, Yale (CT), 11, 1, 1, 0.88462, 251, 37, 214, 
1952, Adams St. (CO), 3, 5, 1, 0.38889, 184, 210, -26, 
1953, Adams St. (CO), 3, 6, 0, 0.33333, 154, 175, -21, 
1954, Adams St. (CO), 3, 6, 0, 0.33333, 135, 229, -94, 
1955, Adams St. (CO), 6, 4, 0, 0.60000, 135, 178, -43, 
1956, Adams St. (CO), 0, 8, 0, 0.00000, 76, 261, -185, 
1933, Oregon St., 6, 2, 2, 0.70000, 88, 48, 40, 
1934, Oregon St., 3, 6, 2, 0.36364, 104, 131, -27, 
1935, Oregon St., 6, 4, 1, 0.59091, 175, 100, 75, 
1936, Oregon St., 4, 6, 0, 0.40000, 116, 151, -35, 
1937, Oregon St., 3, 3, 3, 0.50000, 71, 60, 11, 
1938, Oregon St., 5, 3, 1, 0.61111, 72, 51, 21, 
1939, Oregon St., 9, 1, 1, 0.86364, 186, 77, 109, 
1940, Oregon St., 5, 3, 1, 0.61111, 128, 80, 48, 
1941, Oregon St., 8, 2, 0, 0.80000, 143, 49, 94, 
1942, Oregon St., 4, 5, 1, 0.45000, 157, 142, 15, 
1945, Oregon St., 4, 4, 1, 0.50000, 100, 131, -31, 
1946, Oregon St., 7, 1, 1, 0.83333, 157, 81, 76, 
1947, Oregon St., 5, 5, 0, 0.50000, 171, 136, 35, 
1948, Oregon St., 5, 4, 3, 0.54167, 249, 236, 13, 
1948, Texas A&M;, 0, 9, 1, 0.05000, 123, 247, -124, 
1949, Texas A&M;, 1, 8, 1, 0.15000, 92, 267, -175, 
1950, Texas A&M;, 7, 4, 0, 0.63636, 344, 206, 138, 
2000, Colorado School of Mines, 2, 8, 0, 0.20000, 220, 413, -193, 
2001, Colorado School of Mines, 7, 4, 0, 0.63636, 462, 385, 77, 
2002, Colorado School of Mines, 7, 4, 0, 0.63636, 365, 284, 81, 
2003, Colorado School of Mines, 6, 5, 0, 0.54545, 367, 296, 71, 
2004, Colorado School of Mines, 12, 1, 0, 0.92308, 515, 301, 214, 
2005, Colorado School of Mines, 6, 5, 0, 0.54545, 374, 334, 40, 
2006, Colorado School of Mines, 4, 7, 0, 0.36364, 243, 277, -34, 
2007, Colorado School of Mines, 7, 5, 0, 0.58333, 227, 230, -3, 
2008, Colorado School of Mines, 8, 4, 0, 0.66667, 298, 221, 77, 
2009, Colorado School of Mines, 8, 3, 0, 0.72727, 364, 229, 135, 
2010, Colorado School of Mines, 9, 3, 0, 0.75000, 438, 289, 149, 
2011, Colorado School of Mines, 8, 3, 0, 0.72727, 348, 240, 108, 
2012, Colorado School of Mines, 6, 5, 0, 0.54545, 432, 258, 174, 
2013, Colorado School of Mines, 8, 3, 0, 0.72727, 398, 187, 211, 
1977, Toledo (OH), 2, 9, 0, 0.18182, 112, 287, -175, 
1978, Toledo (OH), 2, 9, 0, 0.18182, 144, 256, -112, 
1979, Toledo (OH), 8, 2, 1, 0.77273, 213, 190, 23, 
1980, Toledo (OH), 4, 7, 0, 0.36364, 187, 190, -3, 
1981, Toledo (OH), 9, 3, 0, 0.75000, 270, 170, 100, 
1982, Utah, 5, 6, 0, 0.45455, 247, 188, 59, 
1983, Utah, 5, 6, 0, 0.45455, 296, 289, 7, 
1984, Utah, 6, 5, 1, 0.54167, 347, 253, 94, 
1989, Memphis (TN), 2, 9, 0, 0.18182, 174, 338, -164, 
1990, Memphis (TN), 4, 6, 1, 0.40909, 212, 233, -21, 
1991, Memphis (TN), 5, 6, 0, 0.45455, 228, 229, -1, 
1992, Memphis (TN), 6, 5, 0, 0.54545, 312, 181, 131, 
1993, Memphis (TN), 6, 5, 0, 0.54545, 268, 215, 53, 
1994, Memphis (TN), 6, 5, 0, 0.54545, 163, 159, 4, 
1978, Eastern Michigan, 3, 7, 0, 0.30000, 122, 238, -116, 
1979, Eastern Michigan, 2, 8, 1, 0.22727, 113, 236, -123, 
1980, Eastern Michigan, 1, 9, 0, 0.10000, 81, 322, -241, 
1981, Eastern Michigan, 0, 11, 0, 0.00000, 88, 338, -250, 
1982, Eastern Michigan, 0, 3, 0, 0.00000, 19, 98, -79, 
2006, Middle Tennessee St., 7, 6, 0, 0.53846, 296, 302, -6, 
2007, Middle Tennessee St., 5, 7, 0, 0.41667, 308, 339, -31, 
2008, Middle Tennessee St., 5, 7, 0, 0.41667, 274, 299, -25, 
2009, Middle Tennessee St., 10, 3, 0, 0.76923, 416, 308, 108, 
2010, Middle Tennessee St., 6, 7, 0, 0.46154, 344, 365, -21, 
2011, Middle Tennessee St., 2, 10, 0, 0.16667, 267, 441, -174, 
2012, Middle Tennessee St., 8, 4, 0, 0.66667, 319, 336, -17, 
2013, Middle Tennessee St., 8, 5, 0, 0.61538, 377, 341, 36, 
2002, Northwestern St. (LA), 9, 4, 0, 0.69231, 359, 283, 76, 
2003, Northwestern St. (LA), 6, 6, 0, 0.50000, 386, 265, 121, 
2004, Northwestern St. (LA), 8, 4, 0, 0.66667, 401, 282, 119, 
2005, Northwestern St. (LA), 5, 5, 0, 0.50000, 215, 240, -25, 
2006, Northwestern St. (LA), 4, 7, 0, 0.36364, 187, 249, -62, 
2007, Northwestern St. (LA), 4, 7, 0, 0.36364, 240, 372, -132, 
2008, Northwestern St. (LA), 7, 5, 0, 0.58333, 320, 339, -19, 
1986, Louisiana-Lafayette, 6, 5, 0, 0.54545, 242, 204, 38, 
1987, Louisiana-Lafayette, 6, 5, 0, 0.54545, 191, 252, -61, 
1988, Louisiana-Lafayette, 6, 5, 0, 0.54545, 296, 224, 72, 
1989, Louisiana-Lafayette, 7, 4, 0, 0.63636, 241, 232, 9, 
1990, Louisiana-Lafayette, 5, 6, 0, 0.45455, 197, 242, -45, 
1991, Louisiana-Lafayette, 2, 8, 1, 0.22727, 148, 269, -121, 
1992, Louisiana-Lafayette, 2, 9, 0, 0.18182, 143, 306, -163, 
1993, Louisiana-Lafayette, 8, 3, 0, 0.72727, 249, 227, 22, 
1994, Louisiana-Lafayette, 6, 5, 0, 0.54545, 221, 264, -43, 
1995, Louisiana-Lafayette, 6, 5, 0, 0.54545, 351, 275, 76, 
1996, Louisiana-Lafayette, 5, 6, 0, 0.45455, 304, 404, -100, 
1997, Louisiana-Lafayette, 1, 10, 0, 0.09091, 176, 553, -377, 
1998, Louisiana-Lafayette, 2, 9, 0, 0.18182, 199, 453, -254, 
1969, Wake Forest (NC), 3, 7, 0, 0.30000, 125, 279, -154, 
1970, Wake Forest (NC), 6, 5, 0, 0.54545, 191, 241, -50, 
1971, Wake Forest (NC), 6, 5, 0, 0.54545, 218, 178, 40, 
1972, Minnesota, 4, 7, 0, 0.36364, 185, 304, -119, 
1973, Minnesota, 7, 4, 0, 0.63636, 260, 295, -35, 
1974, Minnesota, 4, 7, 0, 0.36364, 161, 332, -171, 
1975, Minnesota, 6, 5, 0, 0.54545, 236, 192, 44, 
1976, Minnesota, 6, 5, 0, 0.54545, 201, 211, -10, 
1977, Minnesota, 7, 5, 0, 0.58333, 171, 180, -9, 
1978, Minnesota, 5, 6, 0, 0.45455, 210, 267, -57, 
1965, Alma (MI), 3, 5, 0, 0.37500, 79, 147, -68, 
1966, Alma (MI), 4, 5, 0, 0.44444, 102, 93, 9, 
1967, Alma (MI), 8, 0, 0, 1.00000, 217, 41, 176, 
1968, Alma (MI), 8, 0, 0, 1.00000, 248, 65, 183, 
1969, Alma (MI), 6, 3, 0, 0.66667, 218, 113, 105, 
1970, Alma (MI), 5, 3, 0, 0.62500, 195, 104, 91, 
1973, Michigan St., 5, 6, 0, 0.45455, 114, 164, -50, 
1974, Michigan St., 7, 3, 1, 0.68182, 270, 196, 74, 
1975, Michigan St., 7, 4, 0, 0.63636, 222, 167, 55, 
1977, Bowling Green (OH), 5, 7, 0, 0.41667, 275, 296, -21, 
1978, Bowling Green (OH), 4, 7, 0, 0.36364, 277, 267, 10, 
1979, Bowling Green (OH), 4, 7, 0, 0.36364, 194, 265, -71, 
1980, Bowling Green (OH), 4, 7, 0, 0.36364, 189, 186, 3, 
1981, Bowling Green (OH), 5, 5, 1, 0.50000, 155, 132, 23, 
1982, Bowling Green (OH), 7, 5, 0, 0.58333, 265, 199, 66, 
1983, Bowling Green (OH), 8, 3, 0, 0.72727, 277, 242, 35, 
1984, Bowling Green (OH), 8, 3, 0, 0.72727, 327, 198, 129, 
1985, Bowling Green (OH), 11, 1, 0, 0.91667, 355, 223, 132, 
1986, San Diego St. (CA), 8, 4, 0, 0.66667, 292, 279, 13, 
1987, San Diego St. (CA), 5, 7, 0, 0.41667, 357, 428, -71, 
1988, San Diego St. (CA), 3, 8, 0, 0.27273, 204, 384, -180, 
1910, Tennessee, 3, 5, 1, 0.38889, 50, 134, -84, 
1908, Clemson (SC), 1, 6, 0, 0.14286, 26, 104, -78, 
1994, West Texas A&M;, 9, 2, 0, 0.81818, 506, 361, 145, 
1995, West Texas A&M;, 5, 6, 0, 0.45455, 272, 334, -62, 
1996, West Texas A&M;, 1, 9, 0, 0.10000, 94, 229, -135, 
1999, Oklahoma, 7, 5, 0, 0.58333, 430, 229, 201, 
2000, Oklahoma, 13, 0, 0, 1.00000, 481, 194, 287, 
2001, Oklahoma, 11, 2, 0, 0.84615, 397, 169, 228, 
2002, Oklahoma, 12, 2, 0, 0.85714, 541, 216, 325, 
2003, Oklahoma, 12, 2, 0, 0.85714, 601, 214, 387, 
2004, Oklahoma, 12, 1, 0, 0.92308, 452, 219, 233, 
2005, Oklahoma, 8, 4, 0, 0.66667, 323, 277, 46, 
2006, Oklahoma, 11, 3, 0, 0.78571, 424, 242, 182, 
2007, Oklahoma, 11, 3, 0, 0.78571, 592, 284, 308, 
2008, Oklahoma, 12, 2, 0, 0.85714, 716, 343, 373, 
2009, Oklahoma, 8, 5, 0, 0.61538, 404, 189, 215, 
2010, Oklahoma, 12, 2, 0, 0.85714, 521, 305, 216, 
2011, Oklahoma, 10, 3, 0, 0.76923, 514, 287, 227, 
2012, Oklahoma, 10, 3, 0, 0.76923, 496, 331, 165, 
2013, Oklahoma, 11, 2, 0, 0.84615, 427, 287, 140, 
1924, West Liberty St. (WV), 5, 3, 1, 0.61111, 131, 65, 66, 
1925, West Liberty St. (WV), 1, 7, 0, 0.12500, 25, 121, -96, 
2013, Kentucky, 2, 10, 0, 0.16667, 246, 374, -128, 
2004, Arizona, 3, 8, 0, 0.27273, 164, 275, -111, 
2005, Arizona, 3, 8, 0, 0.27273, 252, 290, -38, 
2006, Arizona, 6, 6, 0, 0.50000, 199, 235, -36, 
2007, Arizona, 5, 7, 0, 0.41667, 336, 322, 14, 
2008, Arizona, 8, 5, 0, 0.61538, 476, 277, 199, 
2009, Arizona, 8, 5, 0, 0.61538, 356, 311, 45, 
2010, Arizona, 7, 6, 0, 0.53846, 367, 295, 72, 
2011, Arizona, 1, 5, 0, 0.16667, 164, 225, -61, 
1963, Franklin & Marshall (PA), 1, 6, 0, 0.14286, 87, 173, -86, 
1964, Franklin & Marshall (PA), 8, 0, 0, 1.00000, 148, 88, 60, 
1965, Franklin & Marshall (PA), 4, 4, 0, 0.50000, 167, 185, -18, 
1966, Franklin & Marshall (PA), 3, 3, 2, 0.50000, 73, 67, 6, 
1967, Franklin & Marshall (PA), 4, 4, 0, 0.50000, 183, 125, 58, 
1952, Montana St., 2, 5, 0, 0.28571, 87, 200, -113, 
1953, Montana St., 4, 4, 0, 0.50000, 131, 117, 14, 
1956, Montana St., 9, 0, 1, 0.95000, 312, 74, 238, 
1957, Montana St., 8, 2, 0, 0.80000, 202, 139, 63, 
1946, Davidson (NC), 4, 5, 0, 0.44444, 206, 130, 76, 
1947, Davidson (NC), 6, 3, 1, 0.65000, 155, 108, 47, 
1983, Catawba (NC), 0, 9, 1, 0.05000, 109, 245, -136, 
1984, Catawba (NC), 3, 8, 0, 0.27273, 156, 222, -66, 
1985, Catawba (NC), 5, 6, 0, 0.45455, 265, 278, -13, 
1986, Catawba (NC), 5, 6, 0, 0.45455, 258, 245, 13, 
2010, Miami (FL), 0, 1, 0, 0.00000, 17, 33, -16, 
1962, Central Connecticut St., 2, 8, 0, 0.20000, 122, 145, -23, 
1963, Central Connecticut St., 1, 7, 0, 0.12500, 53, 153, -100, 
1980, Louisiana St., 7, 4, 0, 0.63636, 213, 193, 20, 
1981, Louisiana St., 3, 7, 1, 0.31818, 169, 272, -103, 
1982, Louisiana St., 8, 3, 1, 0.70833, 385, 191, 194, 
1983, Louisiana St., 4, 7, 0, 0.36364, 251, 253, -2, 
1938, Southeastern Louisiana, 4, 4, 2, 0.50000, 177, 73, 104, 
1939, Southeastern Louisiana, 7, 3, 0, 0.70000, 169, 59, 110, 
1940, Southeastern Louisiana, 3, 6, 1, 0.35000, 117, 147, -30, 
1990, Georgia Southern, 12, 3, 0, 0.80000, 436, 272, 164, 
1991, Georgia Southern, 7, 4, 0, 0.63636, 257, 160, 97, 
1992, Georgia Southern, 7, 4, 0, 0.63636, 177, 151, 26, 
1993, Georgia Southern, 10, 3, 0, 0.76923, 357, 200, 157, 
1994, Georgia Southern, 6, 5, 0, 0.54545, 330, 270, 60, 
1995, Georgia Southern, 9, 4, 0, 0.69231, 294, 237, 57, 
2000, Rhode Island, 3, 8, 0, 0.27273, 175, 257, -82, 
2001, Rhode Island, 8, 3, 0, 0.72727, 272, 252, 20, 
2002, Rhode Island, 3, 9, 0, 0.25000, 187, 389, -202, 
2003, Rhode Island, 4, 8, 0, 0.33333, 309, 381, -72, 
2004, Rhode Island, 4, 7, 0, 0.36364, 265, 355, -90, 
2005, Rhode Island, 4, 7, 0, 0.36364, 312, 306, 6, 
2006, Rhode Island, 4, 7, 0, 0.36364, 214, 332, -118, 
2007, Rhode Island, 3, 8, 0, 0.27273, 228, 360, -132, 
1993, Abilene Christian (TX), 7, 3, 0, 0.70000, 297, 195, 102, 
1994, Abilene Christian (TX), 3, 7, 0, 0.30000, 207, 300, -93, 
1995, Abilene Christian (TX), 4, 7, 0, 0.36364, 177, 272, -95, 
1940, Saint Mary's (CA), 5, 3, 0, 0.62500, 100, 68, 32, 
1941, Saint Mary's (CA), 5, 4, 0, 0.55556, 133, 123, 10, 
1919, Texas St., 4, 4, 0, 0.50000, 71, 77, -6, 
1920, Texas St., 5, 2, 1, 0.68750, 234, 84, 150, 
1921, Texas St., 7, 0, 0, 1.00000, 185, 26, 159, 
1922, Texas St., 3, 3, 0, 0.50000, 92, 73, 19, 
1923, Texas St., 4, 4, 0, 0.50000, 157, 73, 84, 
1924, Texas St., 4, 4, 0, 0.50000, 69, 82, -13, 
1925, Texas St., 2, 6, 1, 0.27778, 57, 106, -49, 
1926, Texas St., 7, 2, 0, 0.77778, 171, 56, 115, 
1927, Texas St., 4, 4, 1, 0.50000, 127, 71, 56, 
1928, Texas St., 2, 7, 0, 0.22222, 48, 113, -65, 
1929, Texas St., 6, 1, 2, 0.77778, 120, 75, 45, 
1930, Texas St., 5, 2, 3, 0.65000, 51, 55, -4, 
1931, Texas St., 4, 4, 0, 0.50000, 67, 46, 21, 
1932, Texas St., 5, 3, 0, 0.62500, 82, 40, 42, 
1933, Texas St., 7, 1, 1, 0.83333, 84, 30, 54, 
1934, Texas St., 2, 7, 1, 0.25000, 65, 91, -26, 
1989, Western Carolina (NC), 3, 7, 1, 0.31818, 190, 261, -71, 
1951, Merchant Marine (NY), 4, 3, 0, 0.57143, 143, 92, 51, 
1952, Merchant Marine (NY), 3, 3, 2, 0.50000, 132, 123, 9, 
1953, Merchant Marine (NY), 3, 5, 0, 0.37500, 106, 103, 3, 
1954, Merchant Marine (NY), 5, 3, 0, 0.62500, 146, 136, 10, 
1955, Merchant Marine (NY), 1, 6, 0, 0.14286, 25, 127, -102, 
1956, Merchant Marine (NY), 0, 8, 1, 0.05556, 26, 283, -257, 
1957, Merchant Marine (NY), 0, 8, 0, 0.00000, 25, 192, -167, 
1964, Kent St. (OH), 3, 5, 1, 0.38889, 87, 121, -34, 
1965, Kent St. (OH), 5, 4, 1, 0.55000, 144, 114, 30, 
1966, Kent St. (OH), 4, 6, 0, 0.40000, 211, 161, 50, 
1967, Kent St. (OH), 4, 6, 0, 0.40000, 195, 144, 51, 
2000, Southwest St. (MN), 4, 7, 0, 0.36364, 314, 374, -60, 
2001, Southwest St. (MN), 3, 8, 0, 0.27273, 231, 409, -178, 
2002, Southwest St. (MN), 4, 7, 0, 0.36364, 252, 355, -103, 
2003, Southwest St. (MN), 3, 8, 0, 0.27273, 269, 385, -116, 
1979, Hamilton (NY), 0, 8, 0, 0.00000, 92, 263, -171, 
1980, Hamilton (NY), 2, 6, 0, 0.25000, 98, 216, -118, 
1981, Hamilton (NY), 0, 8, 0, 0.00000, 72, 283, -211, 
1972, Portland St. (OR), 3, 8, 0, 0.27273, 125, 303, -178, 
1973, Portland St. (OR), 1, 10, 0, 0.09091, 85, 327, -242, 
1974, Portland St. (OR), 5, 6, 0, 0.45455, 272, 227, 45, 
1955, Missouri St., 2, 6, 1, 0.27778, 89, 155, -66, 
1962, Catawba (NC), 3, 6, 1, 0.35000, 182, 179, 3, 
1963, Catawba (NC), 6, 3, 0, 0.66667, 176, 96, 80, 
1964, Catawba (NC), 5, 6, 0, 0.45455, 188, 195, -7, 
1965, Catawba (NC), 7, 3, 0, 0.70000, 242, 141, 101, 
1966, Catawba (NC), 5, 5, 0, 0.50000, 171, 225, -54, 
1967, Catawba (NC), 5, 4, 1, 0.55000, 180, 161, 19, 
1968, Catawba (NC), 2, 8, 0, 0.20000, 215, 294, -79, 
1969, Catawba (NC), 3, 7, 0, 0.30000, 226, 244, -18, 
1970, Catawba (NC), 5, 5, 0, 0.50000, 246, 243, 3, 
1971, Catawba (NC), 5, 6, 0, 0.45455, 247, 187, 60, 
1972, Catawba (NC), 5, 5, 0, 0.50000, 259, 221, 38, 
2013, Whittier (CA), 1, 8, 0, 0.11111, 258, 428, -170, 
1902, Monmouth (IL), 3, 6, 0, 0.33333, 86, 107, -21, 
1923, Kalamazoo (MI), 0, 10, 0, 0.00000, 30, 477, -447, 
1924, Kalamazoo (MI), 2, 6, 0, 0.25000, 90, 127, -37, 
2013, Gettysburg (PA), 4, 6, 0, 0.40000, 308, 328, -20, 
2001, Miles (AL), 4, 7, 0, 0.36364, 250, 289, -39, 
2002, Miles (AL), 6, 5, 0, 0.54545, 239, 241, -2, 
2003, Miles (AL), 7, 3, 0, 0.70000, 297, 195, 102, 
2004, Miles (AL), 0, 10, 0, 0.00000, 233, 156, 77, 
2005, Miles (AL), 0, 11, 0, 0.00000, 211, 216, -5, 
2006, Miles (AL), 0, 10, 0, 0.00000, 176, 161, 15, 
2007, Miles (AL), 0, 11, 0, 0.00000, 130, 263, -133, 
1917, Samford (AL), 1, 1, 0, 0.50000, 38, 12, 26, 
1901, Georgia Tech, 4, 0, 1, 0.90000, 97, 5, 92, 
1926, Saint Francis (PA), 4, 3, 0, 0.57143, 142, 71, 71, 
1930, Saint Francis (PA), 4, 4, 0, 0.50000, 36, 79, -43, 
1931, Saint Francis (PA), 2, 5, 1, 0.31250, 43, 113, -70, 
2009, Central Michigan, 1, 0, 0, 1.00000, 44, 41, 3, 
2012, Cincinnati (OH), 1, 0, 0, 1.00000, 48, 34, 14, 
2002, Briar Cliff (IA), 6, 3, 0, 0.66667, 184, 130, 54, 
2003, Briar Cliff (IA), 0, 10, 0, 0.00000, 42, 370, -328, 
2004, Briar Cliff (IA), 3, 7, 0, 0.30000, 143, 247, -104, 
2005, Briar Cliff (IA), 4, 7, 0, 0.36364, 158, 305, -147, 
2006, Briar Cliff (IA), 5, 6, 0, 0.45455, 136, 300, -164, 
2007, Briar Cliff (IA), 0, 11, 0, 0.00000, 168, 342, -174, 
2002, Florida International, 5, 6, 0, 0.45455, 241, 228, 13, 
2003, Florida International, 2, 10, 0, 0.16667, 270, 341, -71, 
2004, Florida International, 3, 7, 0, 0.30000, 261, 325, -64, 
2005, Florida International, 5, 6, 0, 0.45455, 257, 323, -66, 
2006, Florida International, 0, 12, 0, 0.00000, 115, 313, -198, 
1969, Fort Hays St. (KS), 0, 9, 0, 0.00000, 91, 309, -218, 
1970, Fort Hays St. (KS), 5, 5, 0, 0.50000, 297, 267, 30, 
1971, Fort Hays St. (KS), 2, 7, 1, 0.25000, 197, 266, -69, 
2004, Florida, 0, 1, 0, 0.00000, 10, 27, -17, 
2010, Louisville (KY), 7, 6, 0, 0.53846, 343, 252, 91, 
2011, Louisville (KY), 7, 6, 0, 0.53846, 285, 261, 24, 
2012, Louisville (KY), 11, 2, 0, 0.84615, 405, 309, 96, 
2013, Louisville (KY), 12, 1, 0, 0.92308, 457, 158, 299, 
1954, Cal St.-Sacramento, 0, 7, 0, 0.00000, 40, 217, -177, 
1955, Cal St.-Sacramento, 1, 6, 0, 0.14286, 48, 176, -128, 
1956, Cal St.-Sacramento, 3, 5, 1, 0.38889, 128, 178, -50, 
1990, Nevada-Las Vegas, 4, 7, 0, 0.36364, 239, 324, -85, 
1991, Nevada-Las Vegas, 4, 7, 0, 0.36364, 220, 360, -140, 
1992, Nevada-Las Vegas, 6, 5, 0, 0.54545, 243, 311, -68, 
1993, Nevada-Las Vegas, 3, 8, 0, 0.27273, 259, 347, -88, 
1910, Mercer (GA), 6, 3, 0, 0.66667, 119, 73, 46, 
1911, Mercer (GA), 4, 6, 1, 0.40909, 102, 111, -9, 
1912, Mercer (GA), 5, 3, 1, 0.61111, 188, 113, 75, 
1994, West Alabama, 1, 9, 0, 0.10000, 81, 483, -402, 
1995, West Alabama, 2, 9, 0, 0.18182, 170, 347, -177, 
1996, West Alabama, 3, 7, 0, 0.30000, 243, 345, -102, 
1983, West Virginia Wesleyan, 2, 8, 0, 0.20000, 79, 263, -184, 
1984, West Virginia Wesleyan, 1, 9, 0, 0.10000, 101, 294, -193, 
1985, West Virginia Wesleyan, 1, 8, 0, 0.11111, 114, 196, -82, 
1986, West Virginia Wesleyan, 4, 6, 0, 0.40000, 178, 259, -81, 
1987, West Virginia Wesleyan, 6, 4, 0, 0.60000, 247, 151, 96, 
1988, West Virginia Wesleyan, 6, 4, 0, 0.60000, 232, 176, 56, 
1989, West Virginia Wesleyan, 7, 3, 0, 0.70000, 184, 149, 35, 
1990, West Virginia Wesleyan, 5, 5, 0, 0.50000, 227, 216, 11, 
1991, West Virginia Wesleyan, 4, 5, 0, 0.44444, 188, 188, 0, 
1992, West Virginia Wesleyan, 3, 7, 0, 0.30000, 172, 241, -69, 
1993, West Virginia Wesleyan, 7, 3, 0, 0.70000, 213, 142, 71, 
1994, West Virginia Wesleyan, 7, 3, 0, 0.70000, 343, 236, 107, 
1995, West Virginia Wesleyan, 8, 2, 0, 0.80000, 279, 181, 98, 
1996, West Virginia Wesleyan, 3, 7, 0, 0.30000, 299, 285, 14, 
1997, West Virginia Wesleyan, 5, 5, 0, 0.50000, 342, 286, 56, 
1998, West Virginia Wesleyan, 4, 6, 0, 0.40000, 268, 267, 1, 
1999, West Virginia Wesleyan, 2, 8, 0, 0.20000, 80, 304, -224, 
2000, West Virginia Wesleyan, 2, 8, 0, 0.20000, 154, 339, -185, 
2001, West Virginia Wesleyan, 3, 6, 0, 0.33333, 214, 280, -66, 
2002, West Virginia Wesleyan, 7, 4, 0, 0.63636, 315, 233, 82, 
2003, West Virginia Wesleyan, 9, 2, 0, 0.81818, 372, 208, 164, 
2004, West Virginia Wesleyan, 6, 5, 0, 0.54545, 336, 290, 46, 
2005, West Virginia Wesleyan, 3, 8, 0, 0.27273, 269, 466, -197, 
2006, West Virginia Wesleyan, 2, 8, 0, 0.20000, 113, 220, -107, 
2007, West Virginia Wesleyan, 3, 8, 0, 0.27273, 208, 350, -142, 
2008, West Virginia Wesleyan, 1, 10, 0, 0.09091, 179, 357, -178, 
1945, Illinois St., 4, 3, 0, 0.57143, 89, 114, -25, 
1946, Illinois St., 6, 3, 0, 0.66667, 106, 53, 53, 
1947, Illinois St., 4, 3, 2, 0.55556, 103, 70, 33, 
1948, Illinois St., 7, 2, 0, 0.77778, 220, 75, 145, 
1949, Illinois St., 6, 2, 1, 0.72222, 179, 54, 125, 
1950, Illinois St., 7, 1, 2, 0.80000, 154, 93, 61, 
1951, Illinois St., 3, 5, 1, 0.38889, 129, 165, -36, 
1952, Illinois St., 1, 6, 2, 0.22222, 141, 229, -88, 
1953, Illinois St., 5, 4, 0, 0.55556, 141, 121, 20, 
1954, Illinois St., 5, 3, 1, 0.61111, 113, 127, -14, 
1955, Illinois St., 3, 4, 2, 0.44444, 110, 191, -81, 
1956, Illinois St., 4, 4, 1, 0.50000, 103, 95, 8, 
1957, Illinois St., 5, 3, 0, 0.62500, 171, 124, 47, 
1958, Illinois St., 3, 6, 0, 0.33333, 116, 159, -43, 
1959, Illinois St., 3, 5, 1, 0.38889, 107, 176, -69, 
1960, Illinois St., 2, 6, 1, 0.27778, 66, 179, -113, 
1961, Illinois St., 5, 4, 0, 0.55556, 129, 142, -13, 
1962, Illinois St., 5, 4, 0, 0.55556, 87, 162, -75, 
1963, Illinois St., 3, 6, 0, 0.33333, 124, 177, -53, 
1964, Illinois St., 5, 4, 0, 0.55556, 173, 161, 12, 
1951, Hanover (IN), 6, 3, 0, 0.66667, 136, 107, 29, 
1952, Hanover (IN), 6, 1, 2, 0.77778, 164, 104, 60, 
1953, Hanover (IN), 4, 4, 1, 0.50000, 128, 172, -44, 
1954, Hanover (IN), 4, 5, 0, 0.44444, 177, 207, -30, 
1919, Wisconsin-Oshkosh, 5, 1, 0, 0.83333, 150, 18, 132, 
1923, Indiana St., 3, 3, 0, 0.50000, 65, 83, -18, 
1924, Indiana St., 6, 2, 0, 0.75000, 263, 59, 204, 
1925, Indiana St., 2, 4, 1, 0.35714, 114, 100, 14, 
1926, Indiana St., 2, 4, 1, 0.35714, 65, 114, -49, 
1932, Indiana St., 3, 5, 0, 0.37500, 107, 115, -8, 
1942, Indiana St., 4, 3, 0, 0.57143, 106, 62, 44, 
1910, Colorado School of Mines, 2, 4, 0, 0.33333, 25, 64, -39, 
1911, Colorado School of Mines, 2, 5, 0, 0.28571, 55, 51, 4, 
2010, Nicholls St. (LA), 4, 7, 0, 0.36364, 231, 369, -138, 
2011, Nicholls St. (LA), 1, 10, 0, 0.09091, 198, 380, -182, 
2012, Nicholls St. (LA), 1, 10, 0, 0.09091, 195, 426, -231, 
2013, Nicholls St. (LA), 4, 8, 0, 0.33333, 322, 520, -198, 
1932, Southeast Missouri St., 2, 6, 1, 0.27778, 64, 83, -19, 
1933, Southeast Missouri St., 5, 3, 1, 0.61111, 132, 80, 52, 
1934, Southeast Missouri St., 8, 1, 0, 0.88889, 168, 41, 127, 
1935, Southeast Missouri St., 7, 2, 0, 0.77778, 122, 46, 76, 
1936, Southeast Missouri St., 4, 5, 0, 0.44444, 54, 78, -24, 
1937, Southeast Missouri St., 9, 0, 0, 1.00000, 168, 12, 156, 
1938, Southeast Missouri St., 3, 5, 0, 0.37500, 57, 76, -19, 
1939, Southeast Missouri St., 5, 3, 1, 0.61111, 88, 36, 52, 
1940, Southeast Missouri St., 4, 4, 2, 0.50000, 90, 73, 17, 
1941, Southeast Missouri St., 4, 4, 1, 0.50000, 162, 111, 51, 
1942, Southeast Missouri St., 5, 2, 1, 0.68750, 126, 84, 42, 
1943, Southeast Missouri St., 5, 2, 0, 0.71429, 118, 45, 73, 
1944, Southeast Missouri St., 4, 3, 0, 0.57143, 124, 52, 72, 
1946, Southeast Missouri St., 8, 0, 1, 0.94444, 200, 38, 162, 
1947, Iowa St., 3, 6, 0, 0.33333, 111, 141, -30, 
1948, Iowa St., 4, 6, 0, 0.40000, 116, 197, -81, 
1949, Iowa St., 5, 3, 1, 0.61111, 169, 134, 35, 
1950, Iowa St., 3, 6, 1, 0.35000, 174, 200, -26, 
1951, Iowa St., 4, 4, 1, 0.50000, 211, 216, -5, 
1952, Iowa St., 3, 6, 0, 0.33333, 158, 199, -41, 
1953, Iowa St., 2, 7, 0, 0.22222, 120, 211, -91, 
1987, Case Western Reserve (OH), 3, 6, 0, 0.33333, 154, 231, -77, 
1988, Case Western Reserve (OH), 7, 3, 0, 0.70000, 209, 188, 21, 
1989, Case Western Reserve (OH), 4, 6, 0, 0.40000, 186, 281, -95, 
1990, Case Western Reserve (OH), 4, 6, 0, 0.40000, 187, 241, -54, 
1991, Case Western Reserve (OH), 7, 3, 0, 0.70000, 212, 174, 38, 
1992, Case Western Reserve (OH), 2, 6, 2, 0.30000, 115, 220, -105, 
1993, Case Western Reserve (OH), 2, 8, 0, 0.20000, 150, 298, -148, 
1960, Massachusetts, 7, 2, 0, 0.77778, 173, 121, 52, 
1961, Cincinnati (OH), 3, 7, 0, 0.30000, 97, 142, -45, 
1962, Cincinnati (OH), 2, 8, 0, 0.20000, 142, 202, -60, 
1963, Cincinnati (OH), 6, 4, 0, 0.60000, 238, 138, 100, 
1964, Cincinnati (OH), 8, 2, 0, 0.80000, 211, 99, 112, 
1965, Cincinnati (OH), 5, 5, 0, 0.50000, 163, 172, -9, 
1966, Cincinnati (OH), 3, 7, 0, 0.30000, 141, 201, -60, 
2013, Sioux Falls (SD), 6, 5, 0, 0.54545, 363, 295, 68, 
1925, Villanova (PA), 6, 2, 1, 0.72222, 107, 40, 67, 
1926, Villanova (PA), 6, 2, 1, 0.72222, 219, 76, 143, 
1927, Villanova (PA), 6, 1, 0, 0.85714, 181, 56, 125, 
1928, Villanova (PA), 7, 0, 1, 0.93750, 133, 34, 99, 
1929, Villanova (PA), 7, 2, 1, 0.75000, 187, 73, 114, 
1930, Villanova (PA), 5, 5, 0, 0.50000, 86, 81, 5, 
1931, Villanova (PA), 4, 3, 2, 0.55556, 131, 62, 69, 
1932, Villanova (PA), 7, 2, 0, 0.77778, 192, 53, 139, 
1933, Villanova (PA), 7, 2, 1, 0.75000, 234, 54, 180, 
1934, Villanova (PA), 3, 4, 2, 0.44444, 100, 54, 46, 
1935, Villanova (PA), 7, 2, 0, 0.77778, 199, 67, 132, 
1936, Wisconsin, 2, 6, 0, 0.25000, 95, 144, -49, 
1937, Wisconsin, 4, 3, 1, 0.56250, 103, 61, 42, 
1938, Wisconsin, 5, 3, 0, 0.62500, 111, 93, 18, 
1939, Wisconsin, 1, 6, 1, 0.18750, 54, 113, -59, 
1940, Wisconsin, 4, 4, 0, 0.50000, 125, 134, -9, 
1941, Wisconsin, 3, 5, 0, 0.37500, 144, 208, -64, 
1942, Wisconsin, 8, 1, 1, 0.85000, 149, 68, 81, 
1943, Wisconsin, 1, 9, 0, 0.10000, 41, 282, -241, 
1944, Wisconsin, 3, 6, 0, 0.33333, 112, 180, -68, 
1945, Wisconsin, 3, 4, 2, 0.44444, 128, 128, 0, 
1946, Wisconsin, 4, 5, 0, 0.44444, 140, 144, -4, 
1947, Wisconsin, 5, 3, 1, 0.61111, 171, 156, 15, 
1948, Wisconsin, 2, 7, 0, 0.22222, 126, 193, -67, 
1984, Massachusetts, 3, 8, 0, 0.27273, 148, 219, -71, 
1985, Massachusetts, 7, 4, 0, 0.63636, 198, 127, 71, 
1986, Texas-El Paso, 4, 8, 0, 0.33333, 309, 391, -82, 
1987, Texas-El Paso, 7, 4, 0, 0.63636, 309, 234, 75, 
1988, Texas-El Paso, 10, 3, 0, 0.76923, 445, 275, 170, 
1989, Missouri, 2, 9, 0, 0.18182, 171, 363, -192, 
1990, Missouri, 4, 7, 0, 0.36364, 278, 360, -82, 
1991, Missouri, 3, 7, 1, 0.31818, 223, 403, -180, 
1992, Missouri, 3, 8, 0, 0.27273, 214, 269, -55, 
1993, Missouri, 3, 7, 1, 0.31818, 192, 344, -152, 
1915, Rensselaer Tech (NY), 1, 8, 0, 0.11111, 9, 307, -298, 
2013, Cumberland (TN), 7, 4, 0, 0.63636, 333, 356, -23, 
1935, Henderson St. (AR), 2, 5, 1, 0.31250, 25, 78, -53, 
1936, Henderson St. (AR), 3, 5, 0, 0.37500, 86, 147, -61, 
1937, Henderson St. (AR), 2, 5, 0, 0.28571, 54, 131, -77, 
1938, Henderson St. (AR), 1, 6, 1, 0.18750, 33, 95, -62, 
1998, Southwestern Assemblies (TX), 2, 8, 0, 0.20000, 177, 468, -291, 
2013, Lewis & Clark (OR), 1, 8, 0, 0.11111, 258, 477, -219, 
1918, Holy Cross (MA), 2, 0, 0, 1.00000, 48, 14, 34, 
2005, Eureka (IL), 1, 9, 0, 0.10000, 87, 416, -329, 
2006, Eureka (IL), 0, 10, 0, 0.00000, 107, 381, -274, 
2007, Eureka (IL), 2, 8, 0, 0.20000, 133, 372, -239, 
2008, Eureka (IL), 3, 6, 0, 0.33333, 205, 329, -124, 
1899, Ohio, 2, 2, 0, 0.50000, 78, 77, 1, 
1903, Ohio, 2, 5, 0, 0.28571, 45, 159, -114, 
2001, Merrimack (MA), 6, 4, 0, 0.60000, 170, 214, -44, 
2002, Merrimack (MA), 6, 4, 0, 0.60000, 157, 152, 5, 
1957, Wagner (NY), 2, 6, 0, 0.25000, 91, 137, -46, 
1958, Wagner (NY), 3, 5, 0, 0.37500, 115, 135, -20, 
1959, Wagner (NY), 6, 2, 0, 0.75000, 196, 92, 104, 
1960, Wagner (NY), 9, 0, 0, 1.00000, 255, 96, 159, 
1961, Wagner (NY), 6, 3, 0, 0.66667, 215, 112, 103, 
2013, Northwood (MI), 2, 9, 0, 0.18182, 243, 357, -114, 
1992, Texas Christian, 2, 8, 1, 0.22727, 195, 319, -124, 
1993, Texas Christian, 4, 7, 0, 0.36364, 201, 313, -112, 
1994, Texas Christian, 7, 5, 0, 0.58333, 302, 301, 1, 
1995, Texas Christian, 6, 5, 0, 0.54545, 217, 246, -29, 
1996, Texas Christian, 4, 7, 0, 0.36364, 211, 302, -91, 
1997, Texas Christian, 1, 10, 0, 0.09091, 172, 325, -153, 
2007, Samford (AL), 4, 7, 0, 0.36364, 279, 384, -105, 
2008, Samford (AL), 6, 5, 0, 0.54545, 274, 207, 67, 
2009, Samford (AL), 5, 6, 0, 0.45455, 217, 192, 25, 
2010, Samford (AL), 4, 7, 0, 0.36364, 196, 278, -82, 
2011, Samford (AL), 6, 5, 0, 0.54545, 311, 273, 38, 
2012, Samford (AL), 7, 4, 0, 0.63636, 272, 227, 45, 
2013, Samford (AL), 8, 5, 0, 0.61538, 391, 364, 27, 
1919, Mississippi, 4, 4, 0, 0.50000, 105, 128, -23, 
1920, Mississippi, 4, 3, 0, 0.57143, 217, 85, 132, 
1921, Mississippi, 3, 6, 0, 0.33333, 179, 133, 46, 
1916, George Washington (DC), 3, 3, 1, 0.50000, 47, 70, -23, 
2008, Houston (TX), 8, 5, 0, 0.61538, 528, 402, 126, 
2009, Houston (TX), 10, 4, 0, 0.71429, 591, 421, 170, 
2010, Houston (TX), 5, 7, 0, 0.41667, 452, 386, 66, 
2011, Houston (TX), 12, 1, 0, 0.92308, 660, 300, 360, 
2012, Texas A&M;, 11, 2, 0, 0.84615, 578, 283, 295, 
2013, Texas A&M;, 9, 4, 0, 0.69231, 575, 419, 156, 
1900, Tulane (LA), 5, 0, 0, 1.00000, 105, 0, 105, 
1901, Tulane (LA), 4, 2, 0, 0.66667, 117, 19, 98, 
1906, Carthage (WI), 3, 2, 0, 0.60000, 31, 26, 5, 
1966, Dickinson St. (ND), 1, 7, 0, 0.12500, 134, 194, -60, 
1967, Dickinson St. (ND), 2, 6, 0, 0.25000, 110, 186, -76, 
1992, Pittsburgh (PA), 0, 1, 0, 0.00000, 23, 36, -13, 
2000, Western Connecticut St., 10, 1, 0, 0.90909, 502, 160, 342, 
2001, Western Connecticut St., 8, 2, 0, 0.80000, 208, 143, 65, 
2010, Princeton (NJ), 1, 9, 0, 0.10000, 165, 334, -169, 
2011, Princeton (NJ), 1, 9, 0, 0.10000, 174, 325, -151, 
2012, Princeton (NJ), 5, 5, 0, 0.50000, 266, 199, 67, 
2013, Princeton (NJ), 8, 2, 0, 0.80000, 437, 246, 191, 
2011, Fairleigh Dickinson-Madison (NJ), 1, 9, 0, 0.10000, 113, 433, -320, 
2012, Fairleigh Dickinson-Madison (NJ), 2, 8, 0, 0.20000, 169, 351, -182, 
2013, Fairleigh Dickinson-Madison (NJ), 1, 9, 0, 0.10000, 201, 496, -295, 
1994, Chowan (NC), 0, 9, 1, 0.05000, 41, 344, -303, 
1995, Chowan (NC), 1, 7, 1, 0.16667, 80, 228, -148, 
1996, Chowan (NC), 3, 7, 0, 0.30000, 119, 211, -92, 
1997, Chowan (NC), 2, 8, 0, 0.20000, 115, 286, -171, 
1973, Concordia-Saint Paul (MN), 2, 7, 0, 0.22222, 126, 228, -102, 
1974, Concordia-Saint Paul (MN), 2, 7, 0, 0.22222, 57, 156, -99, 
1975, Concordia-Saint Paul (MN), 2, 6, 0, 0.25000, 67, 216, -149, 
1976, Concordia-Saint Paul (MN), 5, 4, 0, 0.55556, 192, 133, 59, 
1977, Concordia-Saint Paul (MN), 9, 1, 0, 0.90000, 288, 129, 159, 
1983, Concordia-Saint Paul (MN), 5, 4, 0, 0.55556, 128, 105, 23, 
2000, Davidson (NC), 10, 0, 0, 1.00000, 271, 135, 136, 
2010, Bucknell (PA), 1, 10, 0, 0.09091, 151, 310, -159, 
2011, Bucknell (PA), 6, 5, 0, 0.54545, 225, 213, 12, 
2012, Bucknell (PA), 3, 8, 0, 0.27273, 165, 263, -98, 
2013, Bucknell (PA), 6, 5, 0, 0.54545, 240, 241, -1, 
1899, Sewanee (TN), 12, 0, 0, 1.00000, 322, 10, 312, 
1900, Sewanee (TN), 6, 1, 1, 0.81250, 134, 33, 101, 
1901, Sewanee (TN), 4, 2, 2, 0.62500, 159, 67, 92, 
1919, Lafayette (PA), 6, 2, 0, 0.75000, 174, 40, 134, 
1920, Lafayette (PA), 5, 3, 0, 0.62500, 182, 47, 135, 
1921, Lafayette (PA), 9, 0, 0, 1.00000, 274, 26, 248, 
1922, Lafayette (PA), 7, 2, 0, 0.77778, 206, 40, 166, 
1923, Lafayette (PA), 6, 1, 2, 0.77778, 152, 28, 124, 
1924, Pittsburgh (PA), 5, 3, 1, 0.61111, 98, 43, 55, 
1925, Pittsburgh (PA), 8, 1, 0, 0.88889, 151, 34, 117, 
1926, Pittsburgh (PA), 5, 2, 2, 0.66667, 170, 73, 97, 
1927, Pittsburgh (PA), 8, 1, 1, 0.85000, 279, 27, 252, 
1928, Pittsburgh (PA), 6, 2, 1, 0.72222, 177, 15, 162, 
1929, Pittsburgh (PA), 9, 1, 0, 0.90000, 291, 90, 201, 
1930, Pittsburgh (PA), 6, 2, 1, 0.72222, 186, 69, 117, 
1931, Pittsburgh (PA), 8, 1, 0, 0.88889, 280, 37, 243, 
1932, Pittsburgh (PA), 8, 1, 2, 0.81818, 182, 60, 122, 
1933, Pittsburgh (PA), 8, 1, 0, 0.88889, 147, 13, 134, 
1934, Pittsburgh (PA), 8, 1, 0, 0.88889, 205, 44, 161, 
1935, Pittsburgh (PA), 7, 1, 2, 0.80000, 135, 28, 107, 
1936, Pittsburgh (PA), 8, 1, 1, 0.85000, 224, 34, 190, 
1937, Pittsburgh (PA), 9, 0, 1, 0.95000, 203, 34, 169, 
1938, Pittsburgh (PA), 8, 2, 0, 0.80000, 213, 59, 154, 
1908, Central Michigan, 4, 2, 0, 0.66667, 38, 16, 22, 
1956, Washington St., 3, 6, 1, 0.35000, 163, 247, -84, 
1957, Washington St., 6, 4, 0, 0.60000, 193, 161, 32, 
1958, Washington St., 7, 3, 0, 0.70000, 199, 117, 82, 
1959, Washington St., 6, 4, 0, 0.60000, 177, 121, 56, 
1960, Washington St., 4, 5, 1, 0.45000, 210, 161, 49, 
1961, Washington St., 3, 7, 0, 0.30000, 163, 213, -50, 
1962, Washington St., 5, 4, 1, 0.55000, 213, 167, 46, 
1963, Washington St., 3, 6, 1, 0.35000, 95, 160, -65, 
1900, New Mexico St., 3, 3, 1, 0.50000, 49, 27, 22, 
1902, Georgetown (DC), 7, 3, 0, 0.70000, 142, 88, 54, 
1991, Army (NY), 4, 7, 0, 0.36364, 196, 226, -30, 
1992, Army (NY), 5, 6, 0, 0.45455, 225, 251, -26, 
1993, Army (NY), 6, 5, 0, 0.54545, 289, 243, 46, 
1994, Army (NY), 4, 7, 0, 0.36364, 215, 252, -37, 
1995, Army (NY), 5, 5, 1, 0.50000, 325, 211, 114, 
1996, Army (NY), 10, 2, 0, 0.83333, 379, 224, 155, 
1997, Army (NY), 4, 7, 0, 0.36364, 221, 311, -90, 
1998, Army (NY), 3, 8, 0, 0.27273, 257, 325, -68, 
1999, Army (NY), 3, 8, 0, 0.27273, 225, 317, -92, 
1920, Virginia Tech, 4, 6, 0, 0.40000, 172, 111, 61, 
1917, Louisiana St., 3, 5, 0, 0.37500, 112, 94, 18, 
1938, Truman St. (MO), 3, 5, 0, 0.37500, 64, 122, -58, 
1946, Hamilton (NY), 2, 2, 0, 0.50000, 42, 93, -51, 
1947, Hamilton (NY), 1, 6, 0, 0.14286, 34, 144, -110, 
1948, Hamilton (NY), 2, 5, 0, 0.28571, 45, 110, -65, 
2010, Central Missouri St., 11, 3, 0, 0.78571, 562, 390, 172, 
2011, Central Missouri St., 8, 4, 0, 0.66667, 403, 295, 108, 
2012, Central Missouri St., 6, 4, 0, 0.60000, 288, 221, 67, 
2013, Central Missouri St., 6, 4, 0, 0.60000, 376, 214, 162, 
1939, Temple (PA), 2, 7, 0, 0.22222, 51, 96, -45, 
1902, Yale (CT), 11, 0, 1, 0.95833, 286, 22, 264, 
2001, Buffalo St. (NY), 1, 8, 0, 0.11111, 159, 307, -148, 
2002, Buffalo St. (NY), 1, 9, 0, 0.10000, 94, 281, -187, 
2003, Buffalo St. (NY), 2, 8, 0, 0.20000, 153, 279, -126, 
1931, Southeastern Louisiana, 2, 2, 2, 0.50000, 32, 98, -66, 
1932, Southeastern Louisiana, 3, 5, 0, 0.37500, 114, 53, 61, 
1933, Southeastern Louisiana, 7, 3, 0, 0.70000, 252, 109, 143, 
1934, Southeastern Louisiana, 7, 3, 0, 0.70000, 191, 70, 121, 
1935, Southeastern Louisiana, 7, 2, 0, 0.77778, 110, 51, 59, 
1936, Southeastern Louisiana, 7, 0, 1, 0.93750, 182, 19, 163, 
1937, Southeastern Louisiana, 8, 2, 1, 0.77273, 241, 59, 182, 
1950, Louisiana-Lafayette, 5, 4, 0, 0.55556, 159, 100, 59, 
1958, North Park (IL), 7, 1, 0, 0.87500, 190, 46, 144, 
1959, North Park (IL), 6, 1, 1, 0.81250, 128, 63, 65, 
1960, North Park (IL), 4, 5, 0, 0.44444, 202, 140, 62, 
1990, Stonehill (MA), 3, 4, 1, 0.43750, 144, 190, -46, 
1991, Stonehill (MA), 5, 4, 0, 0.55556, 148, 140, 8, 
1992, Stonehill (MA), 6, 2, 1, 0.72222, 232, 117, 115, 
1967, Montana, 7, 3, 0, 0.70000, 181, 103, 78, 
1968, Montana, 2, 7, 0, 0.22222, 196, 227, -31, 
1969, Montana, 10, 1, 0, 0.90909, 338, 149, 189, 
1970, Montana, 10, 1, 0, 0.90909, 336, 165, 171, 
1971, Montana, 6, 5, 0, 0.54545, 258, 242, 16, 
1972, Montana, 3, 8, 0, 0.27273, 151, 259, -108, 
1973, Montana, 4, 6, 0, 0.40000, 152, 221, -69, 
1974, Montana, 3, 6, 1, 0.35000, 244, 253, -9, 
1975, Montana, 6, 4, 0, 0.60000, 243, 183, 60, 
1961, Wheaton (IL), 8, 0, 0, 1.00000, 217, 37, 180, 
1962, Wheaton (IL), 5, 4, 0, 0.55556, 222, 156, 66, 
1963, Wheaton (IL), 8, 1, 0, 0.88889, 179, 102, 77, 
1964, Wheaton (IL), 2, 7, 0, 0.22222, 63, 235, -172, 
1965, Wheaton (IL), 1, 8, 0, 0.11111, 73, 300, -227, 
1966, Wheaton (IL), 5, 4, 0, 0.55556, 185, 116, 69, 
1967, Wheaton (IL), 7, 2, 0, 0.77778, 182, 66, 116, 
1968, Wheaton (IL), 5, 4, 0, 0.55556, 114, 102, 12, 
1920, Connecticut, 1, 6, 1, 0.18750, 69, 126, -57, 
1891, Sewanee (TN), 1, 2, 0, 0.33333, 28, 48, -20, 
1892, Sewanee (TN), 5, 1, 1, 0.78571, 142, 70, 72, 
1893, Sewanee (TN), 2, 3, 1, 0.41667, 84, 46, 38, 
1903, Morningside (IA), 5, 3, 0, 0.62500, 167, 72, 95, 
1904, Washington St., 2, 2, 0, 0.50000, 46, 26, 20, 
1905, Washington St., 4, 4, 0, 0.50000, 175, 61, 114, 
1993, Colgate (NY), 3, 7, 1, 0.31818, 149, 284, -135, 
1994, Colgate (NY), 3, 8, 0, 0.27273, 174, 253, -79, 
1995, Colgate (NY), 0, 11, 0, 0.00000, 134, 367, -233, 
2000, Mount Ida (MA), 0, 9, 0, 0.00000, 16, 372, -356, 
2001, Mount Ida (MA), 1, 8, 0, 0.11111, 64, 307, -243, 
2002, Mount Ida (MA), 2, 7, 0, 0.22222, 138, 270, -132, 
2003, Mount Ida (MA), 4, 6, 0, 0.40000, 154, 287, -133, 
2004, Mount Ida (MA), 6, 2, 0, 0.75000, 220, 221, -1, 
2005, Mount Ida (MA), 1, 9, 0, 0.10000, 182, 434, -252, 
2006, Mount Ida (MA), 5, 4, 0, 0.55556, 167, 259, -92, 
2007, Mount Ida (MA), 3, 7, 0, 0.30000, 251, 322, -71, 
1895, Doane (NE), 3, 2, 0, 0.60000, 26, 64, -38, 
1926, West Liberty St. (WV), 6, 3, 0, 0.66667, 107, 67, 40, 
1927, West Liberty St. (WV), 6, 1, 1, 0.81250, 156, 32, 124, 
1928, West Liberty St. (WV), 6, 3, 0, 0.66667, 293, 44, 249, 
1929, West Liberty St. (WV), 8, 1, 0, 0.88889, 261, 46, 215, 
1930, West Liberty St. (WV), 5, 3, 1, 0.61111, 156, 54, 102, 
1931, West Liberty St. (WV), 7, 1, 1, 0.83333, 255, 39, 216, 
1932, West Liberty St. (WV), 7, 2, 0, 0.77778, 261, 38, 223, 
1963, Montana St., 6, 3, 0, 0.66667, 195, 89, 106, 
1964, Montana St., 7, 4, 0, 0.63636, 223, 111, 112, 
1965, Montana St., 3, 7, 0, 0.30000, 119, 185, -66, 
1966, Montana St., 8, 3, 0, 0.72727, 401, 162, 239, 
1967, Montana St., 7, 3, 0, 0.70000, 228, 151, 77, 
1968, Washington St., 3, 6, 1, 0.35000, 189, 188, 1, 
1969, Washington St., 1, 9, 0, 0.10000, 143, 339, -196, 
1970, Washington St., 1, 10, 0, 0.09091, 231, 460, -229, 
1971, Washington St., 4, 7, 0, 0.36364, 246, 286, -40, 
1972, Washington St., 7, 4, 0, 0.63636, 274, 241, 33, 
1973, Washington St., 5, 6, 0, 0.45455, 250, 290, -40, 
1974, Washington St., 2, 9, 0, 0.18182, 162, 272, -110, 
1975, Washington St., 3, 8, 0, 0.27273, 262, 295, -33, 
1976, Fresno St. (CA), 6, 5, 0, 0.54545, 237, 165, 72, 
1977, Fresno St. (CA), 9, 2, 0, 0.81818, 354, 163, 191, 
1980, Fresno St. (CA), 5, 6, 0, 0.45455, 192, 245, -53, 
1981, Fresno St. (CA), 5, 6, 0, 0.45455, 264, 299, -35, 
1982, Fresno St. (CA), 11, 1, 0, 0.91667, 381, 228, 153, 
1983, Fresno St. (CA), 6, 5, 0, 0.54545, 242, 214, 28, 
1984, Fresno St. (CA), 6, 6, 0, 0.50000, 293, 253, 40, 
1985, Fresno St. (CA), 11, 0, 1, 0.95833, 481, 209, 272, 
1986, Fresno St. (CA), 9, 2, 0, 0.81818, 302, 150, 152, 
1987, Fresno St. (CA), 6, 5, 0, 0.54545, 260, 179, 81, 
1988, Fresno St. (CA), 10, 2, 0, 0.83333, 393, 169, 224, 
1989, Fresno St. (CA), 11, 1, 0, 0.91667, 441, 220, 221, 
1990, Fresno St. (CA), 8, 2, 1, 0.77273, 346, 230, 116, 
1991, Fresno St. (CA), 10, 2, 0, 0.83333, 507, 235, 272, 
1992, Fresno St. (CA), 9, 4, 0, 0.69231, 510, 364, 146, 
1993, Fresno St. (CA), 8, 4, 0, 0.66667, 467, 350, 117, 
1994, Fresno St. (CA), 5, 7, 1, 0.42308, 376, 426, -50, 
1995, Fresno St. (CA), 5, 7, 0, 0.41667, 371, 387, -16, 
1996, Fresno St. (CA), 4, 7, 0, 0.36364, 267, 344, -77, 
2013, Claremont-Mudd-Scripps (CA), 3, 6, 0, 0.33333, 186, 297, -111, 
1894, Tulane (LA), 0, 4, 0, 0.00000, 14, 50, -36, 
1909, Willamette (OR), 2, 2, 0, 0.50000, 71, 40, 31, 
1910, Willamette (OR), 5, 1, 0, 0.83333, 127, 9, 118, 
1911, Willamette (OR), 5, 1, 0, 0.83333, 110, 17, 93, 
1912, Willamette (OR), 5, 1, 1, 0.78571, 244, 28, 216, 
1913, Willamette (OR), 5, 0, 0, 1.00000, 170, 15, 155, 
1899, Hamilton (NY), 8, 2, 1, 0.77273, 282, 67, 215, 
1900, Syracuse (NY), 7, 2, 1, 0.75000, 208, 60, 148, 
1901, Syracuse (NY), 7, 2, 0, 0.77778, 185, 33, 152, 
1902, Syracuse (NY), 6, 2, 1, 0.72222, 172, 93, 79, 
1903, Hamilton (NY), 6, 3, 0, 0.66667, 136, 91, 45, 
1904, Ohio St., 6, 5, 0, 0.54545, 219, 123, 96, 
1905, Ohio St., 8, 2, 2, 0.75000, 197, 63, 134, 
1908, Colgate (NY), 4, 3, 0, 0.57143, 78, 25, 53, 
1909, Kentucky, 9, 1, 0, 0.90000, 261, 29, 232, 
1910, Kentucky, 7, 2, 0, 0.77778, 140, 29, 111, 
1911, Miami (OH), 2, 4, 2, 0.37500, 57, 45, 12, 
1912, Kentucky, 7, 2, 0, 0.77778, 250, 41, 209, 
1913, West Virginia, 3, 4, 2, 0.44444, 109, 137, -28, 
1914, Tulane (LA), 3, 3, 1, 0.50000, 145, 147, -2, 
1904, North Dakota, 6, 1, 0, 0.85714, 182, 41, 141, 
1905, North Dakota, 6, 1, 1, 0.81250, 196, 72, 124, 
1906, North Dakota, 1, 3, 0, 0.25000, 37, 47, -10, 
1907, North Dakota, 2, 2, 0, 0.50000, 49, 47, 2, 
1899, Northern Iowa, 1, 3, 2, 0.33333, 63, 45, 18, 
2011, Elon (NC), 5, 6, 0, 0.45455, 291, 359, -68, 
2012, Elon (NC), 3, 8, 0, 0.27273, 267, 350, -83, 
2013, Elon (NC), 2, 10, 0, 0.16667, 258, 393, -135, 
1996, Wheaton (IL), 8, 1, 0, 0.88889, 318, 122, 196, 
1997, Wheaton (IL), 4, 5, 0, 0.44444, 250, 194, 56, 
1998, Wheaton (IL), 6, 3, 0, 0.66667, 356, 170, 186, 
1999, Wheaton (IL), 7, 2, 0, 0.77778, 272, 144, 128, 
2000, Wheaton (IL), 8, 2, 0, 0.80000, 267, 227, 40, 
2001, Wheaton (IL), 6, 4, 0, 0.60000, 340, 236, 104, 
2002, Wheaton (IL), 10, 2, 0, 0.83333, 496, 196, 300, 
2003, Wheaton (IL), 12, 1, 0, 0.92308, 469, 314, 155, 
2004, Wheaton (IL), 10, 2, 0, 0.83333, 465, 253, 212, 
2005, Wheaton (IL), 7, 3, 0, 0.70000, 323, 172, 151, 
2006, Wheaton (IL), 10, 2, 0, 0.83333, 430, 184, 246, 
2007, Wheaton (IL), 8, 2, 0, 0.80000, 347, 158, 189, 
2008, Wheaton (IL), 11, 3, 0, 0.78571, 505, 290, 215, 
2009, Wheaton (IL), 7, 3, 0, 0.70000, 313, 168, 145, 
2010, Wheaton (IL), 10, 2, 0, 0.83333, 381, 192, 189, 
2011, Wheaton (IL), 8, 2, 0, 0.80000, 345, 184, 161, 
2012, Wheaton (IL), 8, 2, 0, 0.80000, 400, 166, 234, 
2013, Wheaton (IL), 8, 2, 0, 0.80000, 383, 143, 240, 
1891, Eastern Michigan, 0, 2, 0, 0.00000, 4, 64, -60, 
2008, Clemson (SC), 4, 3, 0, 0.57143, 167, 133, 34, 
2009, Clemson (SC), 9, 5, 0, 0.64286, 436, 286, 150, 
2010, Clemson (SC), 6, 7, 0, 0.46154, 312, 244, 68, 
2011, Clemson (SC), 10, 4, 0, 0.71429, 470, 410, 60, 
2012, Clemson (SC), 11, 2, 0, 0.84615, 533, 323, 210, 
2013, Clemson (SC), 11, 2, 0, 0.84615, 522, 288, 234, 
1977, Augustana (SD), 7, 4, 0, 0.63636, 322, 201, 121, 
1978, Augustana (SD), 4, 5, 0, 0.44444, 188, 221, -33, 
1979, Augustana (SD), 4, 5, 0, 0.44444, 216, 213, 3, 
1980, Augustana (SD), 2, 7, 1, 0.25000, 152, 277, -125, 
1982, Adams St. (CO), 3, 4, 2, 0.44444, 199, 214, -15, 
1983, Adams St. (CO), 4, 6, 0, 0.40000, 171, 245, -74, 
1992, Jamestown (ND), 5, 4, 0, 0.55556, 180, 227, -47, 
1993, Jamestown (ND), 4, 5, 0, 0.44444, 178, 246, -68, 
1994, Jamestown (ND), 6, 3, 0, 0.66667, 196, 211, -15, 
1973, Oklahoma, 10, 0, 1, 0.95455, 400, 133, 267, 
1974, Oklahoma, 11, 0, 0, 1.00000, 473, 92, 381, 
1975, Oklahoma, 11, 1, 0, 0.91667, 344, 154, 190, 
1976, Oklahoma, 9, 2, 1, 0.79167, 326, 192, 134, 
1977, Oklahoma, 10, 2, 0, 0.83333, 401, 217, 184, 
1978, Oklahoma, 11, 1, 0, 0.91667, 471, 175, 296, 
1979, Oklahoma, 11, 1, 0, 0.91667, 406, 145, 261, 
1980, Oklahoma, 10, 2, 0, 0.83333, 396, 209, 187, 
1981, Oklahoma, 7, 4, 1, 0.62500, 341, 193, 148, 
1982, Oklahoma, 8, 4, 0, 0.66667, 317, 203, 114, 
1983, Oklahoma, 8, 4, 0, 0.66667, 312, 222, 90, 
1984, Oklahoma, 9, 2, 1, 0.79167, 306, 164, 142, 
1985, Oklahoma, 11, 1, 0, 0.91667, 371, 103, 268, 
1986, Oklahoma, 11, 1, 0, 0.91667, 508, 81, 427, 
1987, Oklahoma, 11, 1, 0, 0.91667, 493, 102, 391, 
1988, Oklahoma, 9, 3, 0, 0.75000, 332, 160, 172, 
1970, Butler (IN), 3, 6, 1, 0.35000, 159, 256, -97, 
1971, Butler (IN), 3, 7, 0, 0.30000, 88, 219, -131, 
1972, Butler (IN), 5, 5, 0, 0.50000, 228, 216, 12, 
1973, Butler (IN), 5, 5, 0, 0.50000, 181, 282, -101, 
1974, Butler (IN), 8, 2, 0, 0.80000, 292, 263, 29, 
1975, Butler (IN), 9, 1, 0, 0.90000, 305, 118, 187, 
1976, Butler (IN), 6, 4, 0, 0.60000, 272, 216, 56, 
1977, Butler (IN), 5, 5, 0, 0.50000, 172, 198, -26, 
1978, Butler (IN), 5, 5, 0, 0.50000, 128, 187, -59, 
1979, Butler (IN), 5, 5, 0, 0.50000, 153, 177, -24, 
1980, Butler (IN), 4, 6, 0, 0.40000, 120, 189, -69, 
1981, Butler (IN), 3, 7, 0, 0.30000, 178, 227, -49, 
1982, Butler (IN), 7, 3, 0, 0.70000, 190, 91, 99, 
1983, Butler (IN), 9, 1, 1, 0.86364, 264, 146, 118, 
1984, Butler (IN), 6, 4, 0, 0.60000, 182, 175, 7, 
1969, Northern Arizona, 7, 3, 0, 0.70000, 284, 182, 102, 
1970, Northern Arizona, 2, 8, 0, 0.20000, 123, 285, -162, 
1988, Carthage (WI), 3, 6, 0, 0.33333, 76, 186, -110, 
1989, Carthage (WI), 1, 8, 0, 0.11111, 88, 249, -161, 
1990, Carthage (WI), 5, 4, 0, 0.55556, 228, 248, -20, 
1991, Carthage (WI), 3, 6, 0, 0.33333, 183, 243, -60, 
1992, Methodist (NC), 0, 10, 0, 0.00000, 90, 311, -221, 
1993, Methodist (NC), 4, 6, 0, 0.40000, 162, 244, -82, 
1994, Methodist (NC), 5, 5, 0, 0.50000, 246, 200, 46, 
1995, Methodist (NC), 5, 6, 0, 0.45455, 205, 201, 4, 
1996, Methodist (NC), 6, 4, 0, 0.60000, 219, 197, 22, 
1997, Methodist (NC), 9, 1, 0, 0.90000, 244, 145, 99, 
1998, Methodist (NC), 7, 3, 0, 0.70000, 257, 163, 94, 
1999, Methodist (NC), 3, 7, 0, 0.30000, 186, 278, -92, 
2000, Methodist (NC), 7, 3, 0, 0.70000, 209, 167, 42, 
2001, Methodist (NC), 5, 5, 0, 0.50000, 241, 235, 6, 
2002, Methodist (NC), 3, 7, 0, 0.30000, 196, 211, -15, 
2003, Methodist (NC), 4, 5, 0, 0.44444, 226, 230, -4, 
2004, Methodist (NC), 7, 3, 0, 0.70000, 256, 203, 53, 
2005, Methodist (NC), 8, 2, 0, 0.80000, 365, 257, 108, 
2006, Methodist (NC), 4, 6, 0, 0.40000, 164, 174, -10, 
2007, Methodist (NC), 4, 6, 0, 0.40000, 221, 245, -24, 
2008, Methodist (NC), 2, 8, 0, 0.20000, 158, 303, -145, 
2009, Methodist (NC), 3, 7, 0, 0.30000, 202, 325, -123, 
2010, Methodist (NC), 2, 8, 0, 0.20000, 164, 344, -180, 
1985, Edinboro (PA), 5, 4, 1, 0.55000, 217, 209, 8, 
1986, Edinboro (PA), 7, 3, 0, 0.70000, 321, 283, 38, 
1987, Edinboro (PA), 3, 8, 0, 0.27273, 226, 283, -57, 
1987, Citadel (SC), 4, 7, 0, 0.36364, 228, 280, -52, 
1988, Citadel (SC), 8, 4, 0, 0.66667, 318, 286, 32, 
1989, Citadel (SC), 5, 5, 1, 0.50000, 245, 258, -13, 
1990, Citadel (SC), 7, 5, 0, 0.58333, 266, 223, 43, 
1991, Citadel (SC), 7, 4, 0, 0.63636, 238, 183, 55, 
1992, Citadel (SC), 11, 2, 0, 0.84615, 353, 185, 168, 
1993, Citadel (SC), 5, 6, 0, 0.45455, 246, 255, -9, 
1994, Citadel (SC), 6, 5, 0, 0.54545, 388, 343, 45, 
1995, Citadel (SC), 2, 9, 0, 0.18182, 165, 262, -97, 
1884, Wabash (IN), 1, 0, 0, 1.00000, 4, 0, 4, 
1957, Fort Valley St. (GA), 6, 3, 0, 0.66667, 93, 151, -58, 
1958, Fort Valley St. (GA), 5, 2, 1, 0.68750, 95, 81, 14, 
1959, Fort Valley St. (GA), 5, 3, 1, 0.61111, 108, 72, 36, 
1969, Southern (LA), 6, 2, 1, 0.72222, 209, 142, 67, 
1970, Southern (LA), 5, 5, 1, 0.50000, 181, 200, -19, 
1971, Southern (LA), 3, 7, 0, 0.30000, 142, 232, -90, 
1903, Monmouth (IL), 5, 4, 2, 0.54545, 97, 185, -88, 
1904, Monmouth (IL), 3, 3, 3, 0.50000, 128, 108, 20, 
1911, Ferris St. (MI), 2, 3, 0, 0.40000, 27, 32, -5, 
2010, Western Kentucky, 2, 10, 0, 0.16667, 274, 398, -124, 
2011, Western Kentucky, 7, 5, 0, 0.58333, 275, 298, -23, 
2012, Western Kentucky, 7, 5, 0, 0.58333, 345, 307, 38, 
2013, South Florida, 2, 10, 0, 0.16667, 165, 343, -178, 
1974, Richmond (VA), 5, 5, 0, 0.50000, 184, 267, -83, 
1975, Richmond (VA), 5, 6, 0, 0.45455, 186, 226, -40, 
1976, Richmond (VA), 5, 6, 0, 0.45455, 173, 156, 17, 
1977, Richmond (VA), 3, 8, 0, 0.27273, 129, 293, -164, 
1978, Richmond (VA), 3, 8, 0, 0.27273, 176, 195, -19, 
1979, Richmond (VA), 0, 11, 0, 0.00000, 79, 271, -192, 
1920, Dayton (OH), 2, 4, 0, 0.33333, 19, 63, -44, 
1921, Dayton (OH), 1, 0, 0, 1.00000, 13, 6, 7, 
1923, Cedarville (OH), 1, 6, 0, 0.14286, 14, 90, -76, 
1985, Villanova (PA), 5, 0, 0, 1.00000, 159, 37, 122, 
1986, Villanova (PA), 8, 1, 0, 0.88889, 313, 150, 163, 
1987, Villanova (PA), 6, 4, 0, 0.60000, 307, 259, 48, 
1988, Villanova (PA), 5, 5, 1, 0.50000, 209, 225, -16, 
1989, Villanova (PA), 8, 4, 0, 0.66667, 303, 291, 12, 
1990, Villanova (PA), 6, 5, 0, 0.54545, 204, 161, 43, 
1991, Villanova (PA), 10, 2, 0, 0.83333, 413, 149, 264, 
1992, Villanova (PA), 9, 3, 0, 0.75000, 314, 176, 138, 
1993, Villanova (PA), 3, 8, 0, 0.27273, 135, 291, -156, 
1994, Villanova (PA), 5, 6, 0, 0.45455, 246, 248, -2, 
1995, Villanova (PA), 3, 8, 0, 0.27273, 194, 195, -1, 
1996, Villanova (PA), 8, 4, 0, 0.66667, 378, 261, 117, 
1997, Villanova (PA), 12, 1, 0, 0.92308, 525, 288, 237, 
1998, Villanova (PA), 6, 5, 0, 0.54545, 358, 340, 18, 
1999, Villanova (PA), 7, 4, 0, 0.63636, 334, 324, 10, 
2000, Villanova (PA), 5, 6, 0, 0.45455, 385, 361, 24, 
2001, Villanova (PA), 8, 3, 0, 0.72727, 401, 306, 95, 
2002, Villanova (PA), 11, 4, 0, 0.73333, 448, 278, 170, 
2003, Villanova (PA), 7, 4, 0, 0.63636, 314, 178, 136, 
2004, Villanova (PA), 6, 5, 0, 0.54545, 330, 248, 82, 
2005, Villanova (PA), 4, 7, 0, 0.36364, 257, 350, -93, 
2006, Villanova (PA), 6, 5, 0, 0.54545, 247, 273, -26, 
2007, Villanova (PA), 7, 4, 0, 0.63636, 288, 261, 27, 
2008, Villanova (PA), 10, 3, 0, 0.76923, 382, 278, 104, 
2009, Villanova (PA), 14, 1, 0, 0.93333, 471, 211, 260, 
2010, Villanova (PA), 9, 5, 0, 0.64286, 431, 269, 162, 
2011, Villanova (PA), 2, 9, 0, 0.18182, 189, 336, -147, 
2012, Villanova (PA), 8, 4, 0, 0.66667, 353, 251, 102, 
2013, Villanova (PA), 6, 5, 0, 0.54545, 337, 245, 92, 
2013, Northwestern College (MN), 6, 4, 0, 0.60000, 260, 232, 28, 
2007, Stonehill (MA), 5, 5, 0, 0.50000, 184, 206, -22, 
2008, Stonehill (MA), 4, 6, 0, 0.40000, 227, 180, 47, 
2009, Stonehill (MA), 5, 5, 0, 0.50000, 237, 282, -45, 
2010, Stonehill (MA), 5, 5, 0, 0.50000, 264, 251, 13, 
2011, Stonehill (MA), 4, 7, 0, 0.36364, 279, 281, -2, 
2012, Stonehill (MA), 5, 5, 0, 0.50000, 242, 218, 24, 
2013, Stonehill (MA), 8, 3, 0, 0.72727, 321, 267, 54, 
1925, Marshall (WV), 4, 1, 4, 0.66667, 138, 29, 109, 
1926, Marshall (WV), 5, 4, 1, 0.55000, 150, 99, 51, 
1927, Marshall (WV), 5, 3, 1, 0.61111, 194, 75, 119, 
1928, Marshall (WV), 8, 1, 1, 0.85000, 175, 33, 142, 
1934, West Virginia, 6, 4, 0, 0.60000, 117, 113, 4, 
1935, West Virginia, 3, 4, 2, 0.44444, 129, 96, 33, 
1936, West Virginia, 6, 4, 0, 0.60000, 151, 122, 29, 
1969, Merchant Marine (NY), 7, 2, 0, 0.77778, 177, 88, 89, 
1970, Merchant Marine (NY), 6, 3, 0, 0.66667, 194, 118, 76, 
1902, Central Michigan, 4, 0, 0, 1.00000, 82, 0, 82, 
1903, Central Michigan, 6, 0, 0, 1.00000, 69, 11, 58, 
1904, Central Michigan, 0, 2, 0, 0.00000, 6, 66, -60, 
1905, Central Michigan, 7, 1, 0, 0.87500, 132, 14, 118, 
1918, Central Michigan, 1, 0, 0, 1.00000, 41, 6, 35, 
1974, Louisiana-Lafayette, 2, 9, 0, 0.18182, 149, 287, -138, 
1975, Louisiana-Lafayette, 6, 5, 0, 0.54545, 259, 233, 26, 
1976, Louisiana-Lafayette, 7, 4, 0, 0.63636, 261, 148, 113, 
1977, Louisiana-Lafayette, 6, 4, 2, 0.58333, 239, 181, 58, 
1978, Louisiana-Lafayette, 3, 8, 0, 0.27273, 127, 229, -102, 
1979, Louisiana-Lafayette, 4, 7, 0, 0.36364, 147, 168, -21, 
1910, DePauw (IN), 4, 4, 0, 0.50000, 45, 69, -24, 
1901, Southern California, 0, 1, 0, 0.00000, 0, 6, -6, 
1903, Adrian (MI), 5, 4, 0, 0.55556, 68, 101, -33, 
1904, Adrian (MI), 2, 2, 0, 0.50000, 68, 57, 11, 
1906, Mercer (GA), 1, 4, 0, 0.20000, 32, 163, -131, 
1921, Connecticut, 3, 2, 3, 0.56250, 115, 75, 40, 
1922, Connecticut, 2, 6, 1, 0.27778, 77, 108, -31, 
1923, William & Mary (VA), 7, 3, 0, 0.70000, 224, 115, 109, 
1924, William & Mary (VA), 6, 2, 1, 0.72222, 170, 61, 109, 
1925, William & Mary (VA), 7, 4, 0, 0.63636, 235, 86, 149, 
1926, William & Mary (VA), 7, 3, 0, 0.70000, 169, 87, 82, 
1927, William & Mary (VA), 4, 5, 1, 0.45000, 111, 118, -7, 
1931, Rutgers (NJ), 4, 3, 1, 0.56250, 111, 100, 11, 
1932, Rutgers (NJ), 6, 3, 1, 0.65000, 159, 58, 101, 
1933, Rutgers (NJ), 6, 3, 1, 0.65000, 146, 94, 52, 
1934, Rutgers (NJ), 5, 3, 1, 0.61111, 184, 68, 116, 
1935, Rutgers (NJ), 4, 5, 0, 0.44444, 115, 170, -55, 
1936, Rutgers (NJ), 1, 6, 1, 0.18750, 20, 133, -113, 
1937, Rutgers (NJ), 5, 4, 0, 0.55556, 128, 39, 89, 
1942, San Francisco (CA), 6, 4, 0, 0.60000, 221, 106, 115, 
1943, San Francisco (CA), 1, 7, 0, 0.12500, 13, 199, -186, 
1928, Lehigh (PA), 3, 6, 0, 0.33333, 57, 192, -135, 
1929, Lehigh (PA), 4, 3, 2, 0.55556, 158, 110, 48, 
1930, Lehigh (PA), 4, 5, 0, 0.44444, 88, 129, -41, 
1931, Lehigh (PA), 3, 7, 0, 0.30000, 103, 174, -71, 
1932, Lehigh (PA), 2, 6, 1, 0.27778, 75, 220, -145, 
1933, Lehigh (PA), 2, 6, 0, 0.25000, 45, 197, -152, 
1936, Bloomsburg (PA), 1, 7, 0, 0.12500, 29, 111, -82, 
1937, Bloomsburg (PA), 3, 4, 0, 0.42857, 51, 78, -27, 
1938, Bloomsburg (PA), 1, 6, 1, 0.18750, 30, 143, -113, 
1939, Bloomsburg (PA), 0, 8, 0, 0.00000, 38, 154, -116, 
1964, Wake Forest (NC), 5, 5, 0, 0.50000, 172, 178, -6, 
1965, Wake Forest (NC), 3, 7, 0, 0.30000, 88, 204, -116, 
1966, Wake Forest (NC), 3, 7, 0, 0.30000, 90, 162, -72, 
1967, Wake Forest (NC), 4, 6, 0, 0.40000, 175, 256, -81, 
1968, Wake Forest (NC), 2, 7, 1, 0.25000, 212, 228, -16, 
1964, Miami (FL), 4, 5, 1, 0.45000, 147, 133, 14, 
1965, Miami (FL), 5, 4, 1, 0.55000, 199, 138, 61, 
1966, Miami (FL), 8, 2, 1, 0.77273, 210, 103, 107, 
1967, Miami (FL), 7, 4, 0, 0.63636, 257, 140, 117, 
1968, Miami (FL), 5, 5, 0, 0.50000, 161, 131, 30, 
1969, Miami (FL), 4, 6, 0, 0.40000, 201, 216, -15, 
1970, Miami (FL), 1, 1, 0, 0.50000, 57, 45, 12, 
1972, Lane (TN), 1, 6, 1, 0.18750, 50, 252, -202, 
1973, Lane (TN), 3, 6, 0, 0.33333, 130, 186, -56, 
2000, McNeese St. (LA), 8, 4, 0, 0.66667, 315, 224, 91, 
2001, McNeese St. (LA), 8, 4, 0, 0.66667, 347, 206, 141, 
2002, McNeese St. (LA), 13, 2, 0, 0.86667, 478, 273, 205, 
2003, McNeese St. (LA), 10, 2, 0, 0.83333, 405, 284, 121, 
2004, McNeese St. (LA), 4, 7, 0, 0.36364, 262, 423, -161, 
2005, McNeese St. (LA), 5, 4, 0, 0.55556, 221, 287, -66, 
2006, McNeese St. (LA), 1, 3, 0, 0.25000, 110, 102, 8, 
2006, Missouri Southern St., 5, 6, 0, 0.45455, 254, 284, -30, 
2007, Missouri Southern St., 6, 5, 0, 0.54545, 318, 239, 79, 
2008, Missouri Southern St., 4, 7, 0, 0.36364, 241, 292, -51, 
2009, Missouri Southern St., 3, 7, 0, 0.30000, 241, 326, -85, 
2010, Missouri Southern St., 4, 7, 0, 0.36364, 245, 269, -24, 
2011, Missouri Southern St., 3, 7, 0, 0.30000, 296, 329, -33, 
1942, North Carolina, 5, 2, 2, 0.66667, 149, 102, 47, 
1946, Oklahoma, 8, 3, 0, 0.72727, 309, 120, 189, 
1947, Maryland, 7, 2, 2, 0.72727, 207, 121, 86, 
1948, Maryland, 6, 4, 0, 0.60000, 207, 132, 75, 
1949, Maryland, 9, 1, 0, 0.90000, 266, 82, 184, 
1950, Maryland, 7, 2, 1, 0.75000, 274, 120, 154, 
1951, Maryland, 10, 0, 0, 1.00000, 381, 75, 306, 
1952, Maryland, 7, 2, 0, 0.77778, 218, 85, 133, 
1953, Maryland, 10, 1, 0, 0.90909, 298, 38, 260, 
1954, Maryland, 7, 2, 1, 0.75000, 280, 67, 213, 
1955, Maryland, 10, 1, 0, 0.90909, 217, 77, 140, 
1956, North Carolina, 0, 9, 1, 0.05000, 99, 183, -84, 
1957, North Carolina, 6, 4, 0, 0.60000, 142, 129, 13, 
1958, North Carolina, 6, 4, 0, 0.60000, 195, 109, 86, 
1931, Massachusetts, 7, 1, 1, 0.83333, 250, 58, 192, 
1932, Massachusetts, 7, 2, 0, 0.77778, 194, 64, 130, 
1933, Massachusetts, 5, 3, 0, 0.62500, 108, 65, 43, 
1934, Massachusetts, 5, 3, 1, 0.61111, 119, 40, 79, 
1935, Massachusetts, 5, 4, 0, 0.55556, 117, 105, 12, 
2000, Lafayette (PA), 2, 9, 0, 0.18182, 244, 350, -106, 
2001, Lafayette (PA), 2, 8, 0, 0.20000, 210, 308, -98, 
2002, Lafayette (PA), 7, 5, 0, 0.58333, 303, 270, 33, 
2003, Lafayette (PA), 5, 6, 0, 0.45455, 315, 249, 66, 
2004, Lafayette (PA), 8, 4, 0, 0.66667, 324, 229, 95, 
2005, Lafayette (PA), 8, 4, 0, 0.66667, 273, 204, 69, 
2006, Lafayette (PA), 6, 6, 0, 0.50000, 316, 270, 46, 
2007, Lafayette (PA), 7, 4, 0, 0.63636, 281, 186, 95, 
2008, Lafayette (PA), 7, 4, 0, 0.63636, 277, 193, 84, 
2009, Lafayette (PA), 8, 3, 0, 0.72727, 315, 231, 84, 
2010, Lafayette (PA), 2, 9, 0, 0.18182, 234, 298, -64, 
2011, Lafayette (PA), 4, 7, 0, 0.36364, 239, 308, -69, 
2012, Lafayette (PA), 5, 6, 0, 0.45455, 263, 297, -34, 
2013, Lafayette (PA), 5, 7, 0, 0.41667, 318, 336, -18, 
1925, Southern (LA), 4, 2, 1, 0.64286, 152, 81, 71, 
1926, Southern (LA), 0, 2, 1, 0.16667, 6, 52, -46, 
1927, Southern (LA), 0, 1, 0, 0.00000, 0, 34, -34, 
1928, Southern (LA), 4, 2, 1, 0.64286, 107, 85, 22, 
1929, Southern (LA), 7, 1, 0, 0.87500, 327, 30, 297, 
1930, Southern (LA), 5, 1, 1, 0.78571, 226, 45, 181, 
1931, Southern (LA), 7, 0, 0, 1.00000, 321, 13, 308, 
1947, Kentucky St., 4, 6, 0, 0.40000, 174, 112, 62, 
1948, Kentucky St., 7, 2, 1, 0.75000, 198, 89, 109, 
1949, Kentucky St., 6, 4, 0, 0.60000, 228, 197, 31, 
1950, Kentucky St., 4, 5, 1, 0.45000, 125, 166, -41, 
1890, Richmond (VA), 0, 3, 0, 0.00000, 10, 38, -28, 
1897, Texas A&M;, 1, 2, 0, 0.33333, 10, 40, -30, 
1951, Stanford (CA), 9, 2, 0, 0.81818, 229, 181, 48, 
1952, Stanford (CA), 5, 5, 0, 0.50000, 187, 226, -39, 
1953, Stanford (CA), 6, 3, 1, 0.65000, 246, 148, 98, 
1954, Stanford (CA), 4, 6, 0, 0.40000, 123, 229, -106, 
1955, Stanford (CA), 6, 3, 1, 0.65000, 198, 135, 63, 
1956, Stanford (CA), 4, 6, 0, 0.40000, 218, 213, 5, 
1957, Stanford (CA), 6, 4, 0, 0.60000, 227, 158, 69, 
1903, Carson-Newman (TN), 0, 2, 0, 0.00000, 0, 110, -110, 
1904, Carson-Newman (TN), 1, 0, 0, 1.00000, 35, 0, 35, 
1905, Carson-Newman (TN), 0, 1, 0, 0.00000, 0, 45, -45, 
1896, Nevada, 1, 2, 0, 0.33333, 30, 114, -84, 
1967, Texas Christian, 4, 6, 0, 0.40000, 113, 185, -72, 
1968, Texas Christian, 3, 7, 0, 0.30000, 176, 215, -39, 
1969, Texas Christian, 4, 6, 0, 0.40000, 177, 293, -116, 
1970, Texas Christian, 4, 6, 1, 0.40909, 189, 265, -76, 
1898, Tulsa (OK), 1, 0, 0, 1.00000, 1, 0, 1, 
1899, Tulsa (OK), 0, 1, 1, 0.25000, 0, 11, -11, 
1971, Wheaton (IL), 1, 8, 0, 0.11111, 145, 294, -149, 
1972, Wheaton (IL), 1, 8, 0, 0.11111, 128, 284, -156, 
1958, Arkansas St., 4, 5, 0, 0.44444, 162, 176, -14, 
1959, Arkansas St., 3, 6, 0, 0.33333, 171, 176, -5, 
1983, Howard (DC), 1, 9, 0, 0.10000, 114, 241, -127, 
1984, Virginia Union, 5, 3, 2, 0.60000, 226, 107, 119, 
1985, Virginia Union, 6, 4, 0, 0.60000, 260, 111, 149, 
1986, Virginia Union, 11, 1, 0, 0.91667, 341, 139, 202, 
1987, Virginia Union, 7, 3, 0, 0.70000, 218, 136, 82, 
1988, Virginia Union, 7, 2, 0, 0.77778, 266, 173, 93, 
1989, Virginia Union, 6, 2, 1, 0.72222, 237, 220, 17, 
1990, Virginia Union, 10, 2, 0, 0.83333, 404, 287, 117, 
1991, Virginia Union, 8, 3, 0, 0.72727, 404, 220, 184, 
1992, Hampton (VA), 9, 2, 1, 0.79167, 496, 204, 292, 
1993, Hampton (VA), 12, 1, 0, 0.92308, 482, 151, 331, 
1994, Hampton (VA), 10, 1, 0, 0.90909, 510, 157, 353, 
1995, Hampton (VA), 8, 3, 0, 0.72727, 342, 221, 121, 
1996, Hampton (VA), 5, 6, 0, 0.45455, 266, 241, 25, 
1997, Hampton (VA), 10, 2, 0, 0.83333, 258, 167, 91, 
1998, Hampton (VA), 9, 3, 0, 0.75000, 387, 201, 186, 
1999, Hampton (VA), 8, 4, 0, 0.66667, 290, 255, 35, 
2000, Hampton (VA), 7, 4, 0, 0.63636, 380, 311, 69, 
2001, Hampton (VA), 7, 4, 0, 0.63636, 334, 315, 19, 
2002, Hampton (VA), 7, 5, 0, 0.58333, 405, 250, 155, 
2003, Hampton (VA), 7, 4, 0, 0.63636, 351, 212, 139, 
2004, Hampton (VA), 10, 2, 0, 0.83333, 523, 279, 244, 
2005, Hampton (VA), 11, 1, 0, 0.91667, 376, 168, 208, 
2006, Hampton (VA), 10, 2, 0, 0.83333, 410, 174, 236, 
2007, Hampton (VA), 6, 5, 0, 0.54545, 329, 258, 71, 
2008, Florida A&M;, 9, 3, 0, 0.75000, 422, 284, 138, 
2009, Florida A&M;, 8, 3, 0, 0.72727, 308, 233, 75, 
2010, Florida A&M;, 8, 3, 0, 0.72727, 241, 202, 39, 
2011, Florida A&M;, 7, 4, 0, 0.63636, 309, 271, 38, 
2012, Florida A&M;, 3, 6, 0, 0.33333, 186, 212, -26, 
1949, Oregon St., 7, 3, 0, 0.70000, 232, 188, 44, 
1950, Oregon St., 3, 6, 0, 0.33333, 114, 183, -69, 
1951, Oregon St., 4, 6, 0, 0.40000, 204, 180, 24, 
1952, Oregon St., 2, 7, 0, 0.22222, 123, 267, -144, 
1953, Oregon St., 3, 6, 0, 0.33333, 39, 187, -148, 
1954, Oregon St., 1, 8, 0, 0.11111, 60, 296, -236, 
1984, Texas Southern, 5, 6, 0, 0.45455, 235, 273, -38, 
1985, Texas Southern, 1, 10, 0, 0.09091, 158, 359, -201, 
1986, Texas Southern, 2, 8, 1, 0.22727, 313, 405, -92, 
1987, Texas Southern, 5, 6, 0, 0.45455, 216, 264, -48, 
1988, Texas Southern, 0, 11, 0, 0.00000, 94, 321, -227, 
1881, Richmond (VA), 2, 0, 0, 1.00000, 6, 0, 6, 
2004, North Greenville (SC), 3, 7, 0, 0.30000, 206, 327, -121, 
2005, North Greenville (SC), 2, 8, 0, 0.20000, 279, 313, -34, 
2006, North Greenville (SC), 10, 2, 0, 0.83333, 476, 235, 241, 
2007, North Greenville (SC), 5, 6, 0, 0.45455, 442, 323, 119, 
2008, North Greenville (SC), 2, 9, 0, 0.18182, 183, 382, -199, 
1974, Morgan St. (MD), 5, 5, 0, 0.50000, 135, 150, -15, 
1975, Morgan St. (MD), 4, 5, 1, 0.45000, 165, 230, -65, 
1928, Johnson C. Smith (NC), 4, 4, 0, 0.50000, 123, 87, 36, 
1977, Boston (MA), 3, 7, 0, 0.30000, 177, 313, -136, 
1978, Boston (MA), 6, 4, 0, 0.60000, 169, 177, -8, 
1979, Boston (MA), 8, 1, 1, 0.85000, 209, 120, 89, 
1980, Boston (MA), 9, 2, 0, 0.81818, 272, 184, 88, 
1981, Boston (MA), 6, 5, 0, 0.54545, 263, 184, 79, 
1982, Boston (MA), 5, 6, 0, 0.45455, 250, 223, 27, 
1983, Boston (MA), 9, 4, 0, 0.69231, 315, 198, 117, 
1984, Boston (MA), 9, 3, 0, 0.75000, 287, 187, 100, 
1975, Truman St. (MO), 7, 4, 0, 0.63636, 219, 174, 45, 
1976, Truman St. (MO), 5, 3, 1, 0.61111, 220, 147, 73, 
1977, Truman St. (MO), 8, 3, 0, 0.72727, 325, 155, 170, 
1978, Truman St. (MO), 6, 4, 1, 0.59091, 186, 155, 31, 
1931, Prairie View A&M; (TX), 9, 1, 0, 0.90000, 248, 29, 219, 
1932, Prairie View A&M; (TX), 6, 3, 2, 0.63636, 140, 41, 99, 
1933, Prairie View A&M; (TX), 7, 1, 0, 0.87500, 151, 19, 132, 
1934, Prairie View A&M; (TX), 5, 4, 0, 0.55556, 158, 64, 94, 
1935, Prairie View A&M; (TX), 4, 3, 4, 0.54545, 110, 27, 83, 
1936, Prairie View A&M; (TX), 4, 4, 2, 0.50000, 38, 35, 3, 
1937, Prairie View A&M; (TX), 7, 4, 0, 0.63636, 159, 77, 82, 
1938, Prairie View A&M; (TX), 4, 2, 3, 0.61111, 143, 65, 78, 
1939, Prairie View A&M; (TX), 5, 2, 1, 0.68750, 114, 44, 70, 
1940, Prairie View A&M; (TX), 5, 3, 0, 0.62500, 134, 41, 93, 
1941, Prairie View A&M; (TX), 8, 1, 2, 0.81818, 268, 101, 167, 
1942, Prairie View A&M; (TX), 5, 2, 0, 0.71429, 103, 36, 67, 
1943, Prairie View A&M; (TX), 3, 1, 1, 0.70000, 105, 25, 80, 
1945, Virginia Union, 4, 5, 1, 0.45000, 88, 149, -61, 
1946, Virginia Union, 2, 5, 1, 0.31250, 65, 98, -33, 
1947, Virginia Union, 3, 6, 0, 0.33333, 80, 94, -14, 
1948, Virginia Union, 6, 5, 0, 0.54545, 117, 118, -1, 
1959, Kentucky St., 3, 5, 1, 0.38889, 139, 141, -2, 
1960, Kentucky St., 2, 8, 0, 0.20000, 112, 191, -79, 
1961, Kentucky St., 6, 3, 0, 0.66667, 197, 116, 81, 
1962, Kentucky St., 4, 4, 0, 0.50000, 113, 118, -5, 
1969, Albion (MI), 8, 0, 0, 1.00000, 177, 68, 109, 
1970, Albion (MI), 3, 6, 0, 0.33333, 91, 182, -91, 
1971, Albion (MI), 0, 7, 2, 0.11111, 44, 199, -155, 
1972, Albion (MI), 3, 6, 0, 0.33333, 115, 202, -87, 
1891, Virginia Military Institute, 3, 0, 1, 0.87500, 52, 12, 40, 
1930, Monmouth (IL), 5, 4, 0, 0.55556, 126, 78, 48, 
1931, Monmouth (IL), 9, 0, 1, 0.95000, 150, 55, 95, 
1928, Morgan St. (MD), 5, 2, 1, 0.68750, 114, 58, 56, 
1937, Arkansas-Pine Bluff, 7, 0, 3, 0.85000, 102, 34, 68, 
1938, Arkansas-Pine Bluff, 4, 4, 1, 0.50000, 78, 77, 1, 
1939, Arkansas-Pine Bluff, 5, 4, 1, 0.55000, 79, 97, -18, 
1940, Arkansas-Pine Bluff, 3, 7, 1, 0.31818, 82, 145, -63, 
2013, Urbana (OH), 7, 4, 0, 0.63636, 334, 237, 97, 
1969, Angelo St. (TX), 6, 4, 0, 0.60000, 232, 225, 7, 
1970, Angelo St. (TX), 6, 4, 0, 0.60000, 277, 155, 122, 
1971, Angelo St. (TX), 7, 3, 0, 0.70000, 260, 146, 114, 
1972, Baylor (TX), 5, 6, 0, 0.45455, 180, 156, 24, 
1973, Baylor (TX), 2, 9, 0, 0.18182, 192, 359, -167, 
1974, Baylor (TX), 8, 4, 0, 0.66667, 252, 223, 29, 
1975, Baylor (TX), 3, 6, 2, 0.36364, 181, 235, -54, 
1976, Baylor (TX), 7, 3, 1, 0.68182, 209, 183, 26, 
1977, Baylor (TX), 5, 6, 0, 0.45455, 228, 220, 8, 
1978, Baylor (TX), 3, 8, 0, 0.27273, 225, 242, -17, 
1979, Baylor (TX), 8, 4, 0, 0.66667, 258, 187, 71, 
1980, Baylor (TX), 10, 2, 0, 0.83333, 317, 159, 158, 
1981, Baylor (TX), 5, 6, 0, 0.45455, 252, 245, 7, 
1982, Baylor (TX), 4, 6, 1, 0.40909, 233, 261, -28, 
1983, Baylor (TX), 7, 4, 1, 0.62500, 339, 266, 73, 
1984, Baylor (TX), 5, 6, 0, 0.45455, 248, 261, -13, 
1985, Baylor (TX), 9, 3, 0, 0.75000, 293, 152, 141, 
1986, Baylor (TX), 9, 3, 0, 0.75000, 325, 207, 118, 
1987, Baylor (TX), 6, 5, 0, 0.54545, 221, 228, -7, 
1988, Baylor (TX), 6, 5, 0, 0.54545, 232, 196, 36, 
1989, Baylor (TX), 5, 6, 0, 0.45455, 245, 190, 55, 
1990, Baylor (TX), 6, 4, 1, 0.59091, 225, 202, 23, 
1991, Baylor (TX), 8, 4, 0, 0.66667, 282, 204, 78, 
1992, Baylor (TX), 7, 5, 0, 0.58333, 344, 278, 66, 
1957, Citadel (SC), 5, 4, 1, 0.55000, 111, 135, -24, 
1958, Citadel (SC), 4, 6, 0, 0.40000, 130, 196, -66, 
1959, Citadel (SC), 8, 2, 0, 0.80000, 207, 142, 65, 
1960, Citadel (SC), 8, 2, 1, 0.77273, 181, 93, 88, 
1961, Citadel (SC), 7, 3, 0, 0.70000, 133, 155, -22, 
1962, Citadel (SC), 3, 7, 0, 0.30000, 143, 264, -121, 
1963, Citadel (SC), 4, 6, 0, 0.40000, 146, 194, -48, 
1964, Citadel (SC), 4, 6, 0, 0.40000, 128, 122, 6, 
1965, Citadel (SC), 2, 8, 0, 0.20000, 77, 158, -81, 
1925, North Carolina St., 3, 5, 1, 0.38889, 51, 74, -23, 
1926, North Carolina St., 4, 6, 0, 0.40000, 66, 102, -36, 
1927, North Carolina St., 9, 1, 0, 0.90000, 216, 69, 147, 
1928, North Carolina St., 4, 5, 1, 0.45000, 157, 100, 57, 
1929, North Carolina St., 1, 8, 0, 0.11111, 44, 207, -163, 
1934, Virginia, 3, 6, 0, 0.33333, 70, 151, -81, 
1935, Virginia, 1, 5, 4, 0.30000, 39, 133, -94, 
1936, Virginia, 2, 7, 0, 0.22222, 73, 222, -149, 
2002, California, 7, 5, 0, 0.58333, 427, 318, 109, 
2003, California, 8, 6, 0, 0.57143, 457, 341, 116, 
2004, California, 10, 2, 0, 0.83333, 441, 192, 249, 
2005, California, 8, 4, 0, 0.66667, 395, 254, 141, 
2006, California, 10, 3, 0, 0.76923, 427, 251, 176, 
2007, California, 7, 6, 0, 0.53846, 381, 348, 33, 
2008, California, 9, 4, 0, 0.69231, 424, 259, 165, 
2009, California, 8, 5, 0, 0.61538, 378, 331, 47, 
2010, California, 5, 7, 0, 0.41667, 310, 271, 39, 
2011, California, 7, 6, 0, 0.53846, 368, 314, 54, 
2012, California, 3, 9, 0, 0.25000, 276, 397, -121, 
1900, Eastern Michigan, 2, 4, 0, 0.33333, 27, 80, -53, 
1901, Eastern Michigan, 3, 5, 0, 0.37500, 60, 167, -107, 
1902, Eastern Michigan, 1, 5, 1, 0.21429, 43, 125, -82, 
1909, Utah St., 2, 2, 1, 0.50000, 34, 55, -21, 
1910, Utah St., 5, 2, 0, 0.71429, 102, 33, 69, 
1911, Utah St., 5, 0, 0, 1.00000, 164, 0, 164, 
1912, Utah St., 4, 2, 1, 0.64286, 154, 40, 114, 
1913, Utah St., 3, 3, 0, 0.50000, 97, 69, 28, 
1914, Utah St., 2, 5, 0, 0.28571, 56, 208, -152, 
1915, Utah St., 3, 4, 0, 0.42857, 56, 99, -43, 
1985, Maine, 6, 5, 0, 0.54545, 268, 211, 57, 
1986, Maine, 7, 4, 0, 0.63636, 297, 213, 84, 
1987, Dartmouth (NH), 2, 8, 0, 0.20000, 110, 302, -192, 
1988, Dartmouth (NH), 5, 5, 0, 0.50000, 209, 198, 11, 
1989, Dartmouth (NH), 5, 5, 0, 0.50000, 170, 178, -8, 
1990, Dartmouth (NH), 7, 2, 1, 0.75000, 211, 121, 90, 
1991, Dartmouth (NH), 7, 2, 1, 0.75000, 283, 209, 74, 
1992, Tulane (LA), 2, 9, 0, 0.18182, 146, 349, -203, 
1993, Tulane (LA), 4, 8, 0, 0.33333, 154, 355, -201, 
1994, Tulane (LA), 1, 10, 0, 0.09091, 135, 358, -223, 
1995, Tulane (LA), 2, 9, 0, 0.18182, 187, 303, -116, 
1996, Tulane (LA), 2, 9, 0, 0.18182, 213, 268, -55, 
2002, Stanford (CA), 2, 9, 0, 0.18182, 225, 377, -152, 
2003, Stanford (CA), 4, 7, 0, 0.36364, 186, 324, -138, 
2004, Stanford (CA), 4, 7, 0, 0.36364, 242, 233, 9, 
2005, Dartmouth (NH), 2, 8, 0, 0.20000, 126, 260, -134, 
2006, Dartmouth (NH), 2, 8, 0, 0.20000, 147, 254, -107, 
2007, Dartmouth (NH), 3, 7, 0, 0.30000, 271, 347, -76, 
2008, Dartmouth (NH), 0, 10, 0, 0.00000, 129, 343, -214, 
2009, Dartmouth (NH), 2, 8, 0, 0.20000, 161, 282, -121, 
2010, Dartmouth (NH), 6, 4, 0, 0.60000, 264, 212, 52, 
2011, Dartmouth (NH), 5, 5, 0, 0.50000, 220, 219, 1, 
2012, Dartmouth (NH), 6, 4, 0, 0.60000, 251, 210, 41, 
2013, Dartmouth (NH), 6, 4, 0, 0.60000, 286, 195, 91, 
1989, Columbia (NY), 1, 9, 0, 0.10000, 130, 287, -157, 
1990, Columbia (NY), 1, 9, 0, 0.10000, 115, 292, -177, 
1991, Columbia (NY), 1, 9, 0, 0.10000, 154, 249, -95, 
1992, Columbia (NY), 3, 7, 0, 0.30000, 205, 286, -81, 
1993, Columbia (NY), 2, 8, 0, 0.20000, 155, 294, -139, 
1994, Columbia (NY), 5, 4, 1, 0.55000, 240, 230, 10, 
1995, Columbia (NY), 3, 6, 1, 0.35000, 201, 281, -80, 
1996, Columbia (NY), 8, 2, 0, 0.80000, 181, 159, 22, 
1997, Columbia (NY), 4, 6, 0, 0.40000, 141, 259, -118, 
1998, Columbia (NY), 4, 6, 0, 0.40000, 146, 175, -29, 
1999, Columbia (NY), 3, 7, 0, 0.30000, 175, 301, -126, 
2000, Columbia (NY), 3, 7, 0, 0.30000, 256, 306, -50, 
2001, Columbia (NY), 3, 7, 0, 0.30000, 206, 326, -120, 
2002, Columbia (NY), 1, 9, 0, 0.10000, 161, 295, -134, 
2007, Georgia Tech, 0, 1, 0, 0.00000, 28, 40, -12, 
2013, Morehead St. (KY), 3, 9, 0, 0.25000, 273, 556, -283, 
1991, Illinois, 0, 1, 0, 0.00000, 3, 6, -3, 
1992, Illinois, 6, 5, 1, 0.54167, 228, 235, -7, 
1993, Illinois, 5, 6, 0, 0.45455, 204, 210, -6, 
1994, Illinois, 7, 5, 0, 0.58333, 309, 156, 153, 
1995, Illinois, 5, 5, 1, 0.50000, 193, 198, -5, 
1996, Illinois, 2, 9, 0, 0.18182, 190, 372, -182, 
2000, Edinboro (PA), 5, 6, 0, 0.45455, 163, 209, -46, 
2001, Edinboro (PA), 4, 6, 0, 0.40000, 202, 209, -7, 
2002, Edinboro (PA), 5, 6, 0, 0.45455, 253, 260, -7, 
2003, Edinboro (PA), 9, 3, 0, 0.75000, 357, 196, 161, 
2004, Edinboro (PA), 9, 3, 0, 0.75000, 398, 259, 139, 
2005, Edinboro (PA), 8, 2, 0, 0.80000, 314, 93, 221, 
2006, Indiana (PA), 8, 2, 0, 0.80000, 261, 144, 117, 
2007, Indiana (PA), 9, 3, 0, 0.75000, 462, 274, 188, 
2008, Indiana (PA), 8, 2, 0, 0.80000, 385, 114, 271, 
2009, Indiana (PA), 5, 6, 0, 0.45455, 253, 235, 18, 
2010, Indiana (PA), 6, 5, 0, 0.54545, 257, 223, 34, 
1938, Eastern New Mexico, 3, 5, 2, 0.40000, 105, 118, -13, 
1972, Morehead St. (KY), 3, 6, 1, 0.35000, 167, 251, -84, 
1973, Morehead St. (KY), 6, 5, 0, 0.54545, 266, 259, 7, 
1974, Morehead St. (KY), 3, 8, 0, 0.27273, 147, 249, -102, 
1975, Morehead St. (KY), 3, 7, 0, 0.30000, 88, 155, -67, 
1938, Western Kentucky, 7, 2, 0, 0.77778, 217, 46, 171, 
1939, Western Kentucky, 7, 1, 1, 0.83333, 132, 52, 80, 
1940, Western Kentucky, 7, 1, 1, 0.83333, 115, 20, 95, 
1941, Western Kentucky, 4, 5, 1, 0.45000, 128, 149, -21, 
1946, San Diego St. (CA), 6, 4, 0, 0.60000, 152, 105, 47, 
1996, Bemidji St. (MN), 2, 8, 0, 0.20000, 145, 326, -181, 
1997, Bemidji St. (MN), 2, 8, 0, 0.20000, 149, 370, -221, 
1998, Bemidji St. (MN), 6, 4, 0, 0.60000, 272, 238, 34, 
1999, Bemidji St. (MN), 8, 3, 0, 0.72727, 362, 265, 97, 
2000, Bemidji St. (MN), 9, 2, 0, 0.81818, 367, 250, 117, 
2001, Bemidji St. (MN), 7, 4, 0, 0.63636, 415, 261, 154, 
2002, Bemidji St. (MN), 6, 5, 0, 0.54545, 310, 266, 44, 
2003, Bemidji St. (MN), 7, 4, 0, 0.63636, 342, 271, 71, 
2004, Bemidji St. (MN), 8, 3, 0, 0.72727, 422, 242, 180, 
2005, Bemidji St. (MN), 7, 3, 0, 0.70000, 353, 268, 85, 
2006, Bemidji St. (MN), 9, 3, 0, 0.75000, 349, 218, 131, 
2007, Bemidji St. (MN), 7, 4, 0, 0.63636, 337, 189, 148, 
2008, Bemidji St. (MN), 5, 6, 0, 0.45455, 228, 305, -77, 
2009, Bemidji St. (MN), 8, 3, 0, 0.72727, 368, 225, 143, 
2010, Bemidji St. (MN), 7, 4, 0, 0.63636, 277, 186, 91, 
2011, Bemidji St. (MN), 8, 3, 0, 0.72727, 295, 176, 119, 
2012, Bemidji St. (MN), 7, 4, 0, 0.63636, 265, 206, 59, 
2013, Bemidji St. (MN), 3, 8, 0, 0.27273, 199, 302, -103, 
1968, Beloit (WI), 3, 5, 0, 0.37500, 131, 230, -99, 
1969, Beloit (WI), 0, 9, 0, 0.00000, 51, 345, -294, 
1970, Beloit (WI), 0, 9, 0, 0.00000, 104, 299, -195, 
1904, Susquehanna (PA), 2, 5, 0, 0.28571, 38, 145, -107, 
1905, Susquehanna (PA), 4, 4, 0, 0.50000, 97, 99, -2, 
1906, Susquehanna (PA), 1, 5, 2, 0.25000, 43, 104, -61, 
1907, Central Michigan, 2, 4, 0, 0.33333, 18, 164, -146, 
1913, Wyoming, 0, 5, 0, 0.00000, 0, 183, -183, 
1914, Wyoming, 1, 5, 0, 0.16667, 31, 158, -127, 
1915, Lake Forest (IL), 2, 4, 0, 0.33333, 77, 86, -9, 
1971, Virginia Military Institute, 1, 10, 0, 0.09091, 78, 257, -179, 
1972, Virginia Military Institute, 2, 9, 0, 0.18182, 150, 299, -149, 
1973, Virginia Military Institute, 3, 8, 0, 0.27273, 116, 316, -200, 
1974, Virginia Military Institute, 7, 4, 0, 0.63636, 212, 175, 37, 
1975, Virginia Military Institute, 3, 8, 0, 0.27273, 162, 187, -25, 
1976, Virginia Military Institute, 5, 5, 0, 0.50000, 138, 206, -68, 
1977, Virginia Military Institute, 7, 4, 0, 0.63636, 223, 155, 68, 
1978, Virginia Military Institute, 3, 8, 0, 0.27273, 114, 227, -113, 
1979, Virginia Military Institute, 6, 4, 1, 0.59091, 158, 210, -52, 
1980, Virginia Military Institute, 3, 7, 1, 0.31818, 142, 242, -100, 
1981, Virginia Military Institute, 6, 3, 1, 0.65000, 165, 156, 9, 
1982, Virginia Military Institute, 5, 6, 0, 0.45455, 221, 180, 41, 
1983, Virginia Military Institute, 2, 9, 0, 0.18182, 100, 339, -239, 
1984, Virginia Military Institute, 1, 9, 0, 0.10000, 121, 320, -199, 
1978, California, 6, 5, 0, 0.54545, 236, 289, -53, 
1979, California, 7, 5, 0, 0.58333, 257, 194, 63, 
1980, California, 3, 8, 0, 0.27273, 194, 328, -134, 
1981, California, 2, 9, 0, 0.18182, 197, 287, -90, 
1914, Presbyterian (SC), 4, 1, 1, 0.75000, 191, 15, 176, 
1990, Lock Haven (PA), 1, 10, 0, 0.09091, 121, 422, -301, 
1991, Lock Haven (PA), 4, 7, 0, 0.36364, 120, 305, -185, 
1992, Lock Haven (PA), 3, 7, 1, 0.31818, 193, 417, -224, 
1993, Lock Haven (PA), 2, 9, 0, 0.18182, 253, 465, -212, 
1994, Lock Haven (PA), 2, 9, 0, 0.18182, 222, 413, -191, 
1995, Lock Haven (PA), 2, 9, 0, 0.18182, 196, 433, -237, 
1903, Southwestern (KS), 4, 2, 0, 0.66667, 38, 55, -17, 
1904, Southwestern (KS), 5, 4, 1, 0.55000, 78, 55, 23, 
1922, Northwestern (IL), 3, 3, 1, 0.50000, 119, 92, 27, 
1923, Northwestern (IL), 2, 6, 0, 0.25000, 90, 112, -22, 
1924, Northwestern (IL), 4, 4, 0, 0.50000, 109, 66, 43, 
1925, Northwestern (IL), 5, 3, 0, 0.62500, 81, 69, 12, 
1926, Northwestern (IL), 7, 1, 0, 0.87500, 179, 22, 157, 
1927, Wisconsin, 4, 4, 0, 0.50000, 96, 75, 21, 
1928, Wisconsin, 7, 1, 1, 0.83333, 163, 38, 125, 
1929, Wisconsin, 4, 5, 0, 0.44444, 88, 78, 10, 
1930, Wisconsin, 6, 2, 1, 0.72222, 227, 40, 187, 
1931, Wisconsin, 5, 4, 1, 0.55000, 105, 110, -5, 
1934, Richmond (VA), 8, 1, 0, 0.88889, 126, 32, 94, 
1935, Richmond (VA), 3, 3, 3, 0.50000, 64, 65, -1, 
1936, Richmond (VA), 4, 4, 2, 0.50000, 61, 81, -20, 
1937, Richmond (VA), 5, 4, 1, 0.55000, 78, 103, -25, 
1938, Richmond (VA), 6, 3, 1, 0.65000, 91, 59, 32, 
1939, Richmond (VA), 7, 1, 2, 0.80000, 155, 20, 135, 
1940, Richmond (VA), 6, 3, 0, 0.66667, 141, 80, 61, 
1941, Richmond (VA), 2, 7, 0, 0.22222, 57, 184, -127, 
1908, Lock Haven (PA), 4, 4, 0, 0.50000, 71, 42, 29, 
1895, Nebraska, 6, 3, 0, 0.66667, 138, 62, 76, 
1901, Arkansas, 3, 5, 0, 0.37500, 98, 52, 46, 
1902, Arkansas, 6, 3, 0, 0.66667, 148, 73, 75, 
1974, Bowie St. (MD), 5, 3, 1, 0.61111, 244, 117, 127, 
1975, Bowie St. (MD), 9, 1, 0, 0.90000, 358, 94, 264, 
1978, Morgan St. (MD), 4, 6, 1, 0.40909, 78, 170, -92, 
1979, Morgan St. (MD), 9, 2, 0, 0.81818, 256, 135, 121, 
1980, Morgan St. (MD), 4, 7, 0, 0.36364, 163, 287, -124, 
1986, South Carolina St., 5, 6, 0, 0.45455, 223, 229, -6, 
1987, South Carolina St., 7, 4, 0, 0.63636, 239, 201, 38, 
1988, South Carolina St., 4, 7, 0, 0.36364, 178, 277, -99, 
1925, Tennessee-Chattanooga, 4, 4, 0, 0.50000, 73, 57, 16, 
1926, Tennessee-Chattanooga, 6, 2, 2, 0.70000, 278, 57, 221, 
1927, Tennessee-Chattanooga, 8, 1, 0, 0.88889, 240, 98, 142, 
1928, Tennessee-Chattanooga, 8, 2, 0, 0.80000, 284, 69, 215, 
1931, Alabama, 9, 1, 0, 0.90000, 360, 57, 303, 
1932, Alabama, 8, 2, 0, 0.80000, 200, 51, 149, 
1933, Alabama, 7, 1, 1, 0.83333, 130, 17, 113, 
1934, Alabama, 10, 0, 0, 1.00000, 316, 45, 271, 
1935, Alabama, 6, 2, 1, 0.72222, 185, 55, 130, 
1936, Alabama, 8, 0, 1, 0.94444, 168, 35, 133, 
1937, Alabama, 9, 1, 0, 0.90000, 225, 33, 192, 
1938, Alabama, 7, 1, 1, 0.83333, 149, 40, 109, 
1939, Alabama, 5, 3, 1, 0.61111, 101, 53, 48, 
1940, Alabama, 7, 2, 0, 0.77778, 166, 80, 86, 
1941, Alabama, 9, 2, 0, 0.81818, 263, 85, 178, 
1942, Alabama, 8, 3, 0, 0.72727, 246, 97, 149, 
1944, Alabama, 5, 2, 2, 0.66667, 272, 83, 189, 
1945, Alabama, 10, 0, 0, 1.00000, 430, 80, 350, 
1946, Alabama, 7, 4, 0, 0.63636, 186, 110, 76, 
1912, Butler (IN), 5, 3, 0, 0.62500, 180, 90, 90, 
1913, Butler (IN), 2, 4, 1, 0.35714, 50, 87, -37, 
1914, Butler (IN), 4, 2, 0, 0.66667, 37, 83, -46, 
1915, Butler (IN), 1, 6, 0, 0.14286, 62, 175, -113, 
1916, Butler (IN), 3, 5, 0, 0.37500, 147, 181, -34, 
1917, Butler (IN), 5, 3, 0, 0.62500, 121, 111, 10, 
1918, Butler (IN), 2, 1, 1, 0.62500, 38, 60, -22, 
1913, Tuskegee (AL), 2, 0, 3, 0.70000, 83, 0, 83, 
1914, Tuskegee (AL), 2, 2, 1, 0.50000, 53, 34, 19, 
1962, Hardin-Simmons (TX), 1, 9, 0, 0.10000, 72, 206, -134, 
1978, Mississippi Valley St., 6, 3, 1, 0.65000, 214, 117, 97, 
1979, Mississippi Valley St., 4, 5, 0, 0.44444, 159, 121, 38, 
2004, Nicholls St. (LA), 5, 5, 0, 0.50000, 233, 237, -4, 
2005, Nicholls St. (LA), 6, 4, 0, 0.60000, 308, 226, 82, 
2006, Nicholls St. (LA), 4, 7, 0, 0.36364, 189, 228, -39, 
2007, Nicholls St. (LA), 6, 5, 0, 0.54545, 296, 261, 35, 
2008, Nicholls St. (LA), 3, 6, 0, 0.33333, 231, 312, -81, 
2009, Nicholls St. (LA), 3, 8, 0, 0.27273, 216, 427, -211, 
2013, Northwestern St. (LA), 6, 6, 0, 0.50000, 330, 389, -59, 
2013, Puget Sound (WA), 1, 8, 0, 0.11111, 189, 459, -270, 
1933, Western Kentucky, 6, 2, 0, 0.75000, 181, 39, 142, 
1946, Western Kentucky, 2, 6, 0, 0.25000, 85, 213, -128, 
1947, Western Kentucky, 3, 4, 2, 0.44444, 82, 145, -63, 
1985, Morgan St. (MD), 0, 9, 0, 0.00000, 69, 287, -218, 
1986, Morgan St. (MD), 1, 9, 0, 0.10000, 112, 365, -253, 
1987, Morgan St. (MD), 2, 8, 0, 0.20000, 118, 309, -191, 
1929, Johnson C. Smith (NC), 6, 2, 1, 0.72222, 143, 46, 97, 
1930, Johnson C. Smith (NC), 5, 3, 3, 0.59091, 70, 79, -9, 
1998, Alcorn St. (MS), 5, 6, 0, 0.45455, 250, 291, -41, 
1999, Alcorn St. (MS), 3, 7, 0, 0.30000, 267, 302, -35, 
2000, Alcorn St. (MS), 1, 10, 0, 0.09091, 159, 297, -138, 
2001, Alcorn St. (MS), 6, 5, 0, 0.54545, 269, 312, -43, 
2002, Alcorn St. (MS), 6, 5, 0, 0.54545, 280, 283, -3, 
2003, Alcorn St. (MS), 7, 5, 0, 0.58333, 361, 318, 43, 
2004, Alcorn St. (MS), 7, 4, 0, 0.63636, 245, 230, 15, 
2005, Alcorn St. (MS), 6, 5, 0, 0.54545, 253, 282, -29, 
2006, Alcorn St. (MS), 6, 5, 0, 0.54545, 262, 260, 2, 
2007, Alcorn St. (MS), 2, 8, 0, 0.20000, 133, 222, -89, 
1891, Wabash (IN), 1, 3, 0, 0.25000, 31, 73, -42, 
2008, Campbellsville (KY), 3, 8, 0, 0.27273, 329, 430, -101, 
2009, Campbellsville (KY), 7, 4, 0, 0.63636, 260, 270, -10, 
2010, Campbellsville (KY), 7, 5, 0, 0.58333, 407, 386, 21, 
2011, Campbellsville (KY), 7, 5, 0, 0.58333, 347, 324, 23, 
2012, Campbellsville (KY), 3, 8, 0, 0.27273, 217, 345, -128, 
2013, Campbellsville (KY), 4, 6, 0, 0.40000, 254, 361, -107, 
1910, New Hampshire, 2, 3, 1, 0.41667, 52, 34, 18, 
1911, New Hampshire, 1, 5, 1, 0.21429, 26, 119, -93, 
1986, North Dakota, 2, 9, 0, 0.18182, 233, 396, -163, 
1987, North Dakota, 6, 4, 0, 0.60000, 243, 209, 34, 
1988, North Dakota, 7, 4, 0, 0.63636, 292, 228, 64, 
1989, North Dakota, 3, 7, 1, 0.31818, 204, 262, -58, 
1990, North Dakota, 7, 3, 0, 0.70000, 276, 215, 61, 
1991, North Dakota, 7, 2, 0, 0.77778, 228, 131, 97, 
1992, North Dakota, 6, 4, 1, 0.59091, 274, 165, 109, 
1993, North Dakota, 10, 3, 0, 0.76923, 313, 180, 133, 
1994, North Dakota, 10, 3, 0, 0.76923, 302, 166, 136, 
1995, North Dakota, 9, 2, 0, 0.81818, 318, 207, 111, 
1996, North Dakota, 7, 3, 0, 0.70000, 262, 150, 112, 
1997, North Dakota, 8, 2, 0, 0.80000, 277, 185, 92, 
1998, North Dakota, 8, 3, 0, 0.72727, 308, 201, 107, 
1909, Wichita St. (KS), 2, 5, 1, 0.31250, 46, 159, -113, 
1910, Wichita St. (KS), 6, 2, 1, 0.72222, 163, 57, 106, 
1911, Wichita St. (KS), 7, 1, 0, 0.87500, 109, 41, 68, 
1984, Tennessee St., 11, 0, 0, 1.00000, 450, 126, 324, 
1985, Tennessee St., 7, 4, 0, 0.63636, 246, 184, 62, 
1986, Tennessee St., 10, 2, 1, 0.80769, 275, 147, 128, 
1987, Tennessee St., 3, 7, 1, 0.31818, 198, 281, -83, 
1988, Tennessee St., 3, 7, 1, 0.31818, 167, 199, -32, 
1994, Texas Southern, 4, 7, 0, 0.36364, 225, 335, -110, 
1995, Texas Southern, 2, 8, 0, 0.20000, 200, 259, -59, 
1996, Texas Southern, 7, 4, 0, 0.63636, 261, 199, 62, 
1997, Texas Southern, 5, 6, 0, 0.45455, 249, 240, 9, 
1998, Texas Southern, 6, 5, 0, 0.54545, 309, 236, 73, 
1999, Texas Southern, 6, 5, 0, 0.54545, 236, 220, 16, 
2000, Texas Southern, 8, 3, 0, 0.72727, 280, 201, 79, 
2001, Texas Southern, 4, 6, 0, 0.40000, 191, 245, -54, 
2002, Texas Southern, 4, 7, 0, 0.36364, 314, 277, 37, 
2003, Texas Southern, 5, 6, 0, 0.45455, 213, 331, -118, 
1979, Fort Hays St. (KS), 5, 6, 0, 0.45455, 222, 195, 27, 
1980, Fort Hays St. (KS), 4, 4, 2, 0.50000, 240, 193, 47, 
1984, Fort Hays St. (KS), 0, 10, 0, 0.00000, 163, 205, -42, 
1925, Harding (AR), 1, 3, 0, 0.25000, 20, 67, -47, 
1911, Wake Forest (NC), 3, 5, 0, 0.37500, 159, 81, 78, 
1912, Wake Forest (NC), 2, 6, 0, 0.25000, 108, 87, 21, 
1913, Wake Forest (NC), 0, 8, 0, 0.00000, 30, 200, -170, 
2006, Stillman (AL), 7, 4, 0, 0.63636, 243, 166, 77, 
2007, Stillman (AL), 7, 4, 0, 0.63636, 302, 254, 48, 
2008, Stillman (AL), 3, 8, 0, 0.27273, 227, 280, -53, 
2009, Stillman (AL), 4, 7, 0, 0.36364, 233, 267, -34, 
1905, Hanover (IN), 1, 1, 0, 0.50000, 10, 6, 4, 
1906, Hanover (IN), 5, 1, 0, 0.83333, 142, 12, 130, 
1907, Hanover (IN), 3, 2, 1, 0.58333, 111, 57, 54, 
1908, Hanover (IN), 4, 4, 2, 0.50000, 131, 78, 53, 
1948, Augustana (SD), 3, 6, 0, 0.33333, 109, 190, -81, 
1949, Augustana (SD), 3, 6, 0, 0.33333, 71, 225, -154, 
1950, Augustana (SD), 2, 7, 0, 0.22222, 92, 212, -120, 
1939, Cameron (OK), 8, 1, 0, 0.88889, 192, 26, 166, 
1940, Cameron (OK), 8, 3, 0, 0.72727, 218, 89, 129, 
1941, Cameron (OK), 8, 2, 1, 0.77273, 166, 66, 100, 
1946, Cameron (OK), 10, 1, 0, 0.90909, 268, 78, 190, 
1947, Centenary (LA), 1, 9, 1, 0.13636, 100, 241, -141, 
1951, Cameron (OK), 6, 4, 0, 0.60000, 194, 121, 73, 
1952, Cameron (OK), 7, 3, 0, 0.70000, 229, 176, 53, 
1953, Cameron (OK), 4, 6, 0, 0.40000, 150, 152, -2, 
1954, Cameron (OK), 6, 3, 0, 0.66667, 205, 80, 125, 
2003, East Carolina (NC), 1, 11, 0, 0.08333, 217, 428, -211, 
2004, East Carolina (NC), 2, 9, 0, 0.18182, 231, 439, -208, 
2012, Arkansas St., 1, 0, 0, 1.00000, 17, 13, 4, 
2013, Arkansas St., 1, 0, 0, 1.00000, 23, 20, 3, 
1893, Kentucky, 5, 2, 1, 0.68750, 280, 110, 170, 
1908, Pittsburgh (PA), 8, 3, 0, 0.72727, 140, 36, 104, 
1909, Pittsburgh (PA), 6, 2, 1, 0.72222, 94, 26, 68, 
1910, Pittsburgh (PA), 9, 0, 0, 1.00000, 282, 0, 282, 
1911, Pittsburgh (PA), 4, 3, 1, 0.56250, 72, 29, 43, 
1912, Pittsburgh (PA), 3, 6, 0, 0.33333, 113, 118, -5, 
1914, Willamette (OR), 2, 4, 0, 0.33333, 72, 181, -109, 
1898, Lehigh (PA), 3, 6, 1, 0.35000, 49, 106, -57, 
1899, Lehigh (PA), 2, 9, 0, 0.18182, 60, 144, -84, 
1900, Texas, 6, 0, 0, 1.00000, 113, 13, 100, 
1901, Texas, 8, 2, 1, 0.77273, 153, 71, 82, 
1893, Carlisle Indian School (PA), 2, 1, 0, 0.66667, 60, 16, 44, 
2005, Abilene Christian (TX), 4, 6, 0, 0.40000, 253, 268, -15, 
2006, Abilene Christian (TX), 8, 3, 0, 0.72727, 390, 243, 147, 
2007, Abilene Christian (TX), 10, 3, 0, 0.76923, 639, 390, 249, 
2008, Abilene Christian (TX), 11, 1, 0, 0.91667, 628, 275, 353, 
2009, Abilene Christian (TX), 9, 4, 0, 0.69231, 376, 256, 120, 
2010, Abilene Christian (TX), 11, 1, 0, 0.91667, 520, 258, 262, 
2011, Abilene Christian (TX), 8, 3, 0, 0.72727, 410, 324, 86, 
2012, Texas Tech, 1, 0, 0, 1.00000, 34, 31, 3, 
1929, Arkansas, 7, 2, 0, 0.77778, 230, 93, 137, 
1930, Arkansas, 3, 6, 0, 0.33333, 78, 154, -76, 
1931, Arkansas, 3, 5, 1, 0.38889, 82, 126, -44, 
1932, Arkansas, 1, 6, 2, 0.22222, 65, 133, -68, 
1933, Arkansas, 7, 3, 1, 0.68182, 213, 61, 152, 
1934, Arkansas, 4, 4, 2, 0.50000, 95, 76, 19, 
1935, Arkansas, 5, 5, 0, 0.50000, 152, 109, 43, 
1936, Arkansas, 7, 3, 0, 0.70000, 178, 87, 91, 
1937, Arkansas, 6, 2, 2, 0.70000, 186, 89, 97, 
1938, Arkansas, 2, 7, 1, 0.25000, 128, 125, 3, 
1939, Arkansas, 4, 5, 1, 0.45000, 115, 117, -2, 
1940, Arkansas, 4, 6, 0, 0.40000, 112, 174, -62, 
1941, Arkansas, 3, 7, 0, 0.30000, 118, 149, -31, 
1949, Missouri St., 5, 4, 1, 0.55000, 183, 201, -18, 
1950, Missouri St., 5, 4, 2, 0.54545, 224, 203, 21, 
1951, Missouri St., 6, 3, 1, 0.65000, 150, 152, -2, 
1952, Missouri St., 3, 6, 0, 0.33333, 119, 157, -38, 
1898, Eastern Michigan, 1, 5, 2, 0.25000, 19, 96, -77, 
2002, North Central (IL), 6, 4, 0, 0.60000, 225, 281, -56, 
2003, North Central (IL), 7, 3, 0, 0.70000, 255, 198, 57, 
2004, North Central (IL), 7, 3, 0, 0.70000, 275, 180, 95, 
2005, North Central (IL), 9, 2, 0, 0.81818, 412, 199, 213, 
2006, North Central (IL), 9, 3, 0, 0.75000, 381, 216, 165, 
2007, North Central (IL), 9, 3, 0, 0.75000, 442, 263, 179, 
2008, North Central (IL), 11, 1, 0, 0.91667, 425, 216, 209, 
2009, North Central (IL), 8, 2, 0, 0.80000, 490, 186, 304, 
2010, North Central (IL), 12, 1, 0, 0.92308, 489, 120, 369, 
2011, North Central (IL), 10, 2, 0, 0.83333, 524, 151, 373, 
2012, North Central (IL), 9, 3, 0, 0.75000, 447, 198, 249, 
2013, North Central (IL), 13, 1, 0, 0.92857, 639, 222, 417, 
1896, Yale (CT), 13, 1, 0, 0.92857, 218, 44, 174, 
1933, Stanford (CA), 8, 2, 1, 0.77273, 131, 43, 88, 
1934, Stanford (CA), 9, 1, 1, 0.86364, 224, 43, 181, 
1935, Stanford (CA), 8, 1, 0, 0.88889, 121, 13, 108, 
1936, Stanford (CA), 2, 5, 2, 0.33333, 80, 109, -29, 
1937, Stanford (CA), 4, 3, 2, 0.55556, 68, 53, 15, 
1938, Stanford (CA), 3, 6, 0, 0.33333, 67, 92, -25, 
1939, Stanford (CA), 1, 7, 1, 0.16667, 54, 146, -92, 
1894, Vanderbilt (TN), 7, 1, 0, 0.87500, 238, 20, 218, 
1960, Bethune-Cookman (FL), 3, 4, 0, 0.42857, 98, 166, -68, 
1915, Northern Arizona, 2, 4, 0, 0.33333, 52, 183, -131, 
1916, Northern Arizona, 5, 1, 0, 0.83333, 98, 129, -31, 
1917, Northern Arizona, 2, 0, 0, 1.00000, 39, 34, 5, 
1922, Mount Union (OH), 6, 2, 1, 0.72222, 126, 46, 80, 
1923, Mount Union (OH), 5, 4, 0, 0.55556, 117, 130, -13, 
1924, Mount Union (OH), 5, 4, 1, 0.55000, 81, 85, -4, 
1925, Mount Union (OH), 7, 2, 1, 0.75000, 169, 21, 148, 
1926, Mount Union (OH), 6, 3, 0, 0.66667, 106, 52, 54, 
1927, Mount Union (OH), 6, 2, 1, 0.72222, 168, 80, 88, 
1928, Mount Union (OH), 4, 5, 0, 0.44444, 100, 95, 5, 
1929, Mount Union (OH), 5, 3, 1, 0.61111, 124, 55, 69, 
1930, Mount Union (OH), 4, 5, 1, 0.45000, 171, 184, -13, 
1931, Mount Union (OH), 7, 2, 1, 0.75000, 204, 25, 179, 
1912, Fordham (NY), 4, 4, 0, 0.50000, 57, 99, -42, 
1913, Fordham (NY), 3, 3, 2, 0.50000, 89, 199, -110, 
1922, New York (NY), 5, 4, 0, 0.55556, 89, 116, -27, 
1923, New York (NY), 6, 2, 1, 0.72222, 98, 34, 64, 
1924, New York (NY), 4, 3, 1, 0.56250, 61, 114, -53, 
2006, Bacone (OK), 2, 8, 0, 0.20000, 83, 325, -242, 
2007, Bacone (OK), 4, 7, 0, 0.36364, 263, 378, -115, 
2008, Bacone (OK), 7, 4, 0, 0.63636, 255, 291, -36, 
2009, Belhaven (MS), 6, 5, 0, 0.54545, 243, 285, -42, 
2010, Belhaven (MS), 4, 7, 0, 0.36364, 310, 312, -2, 
2011, Belhaven (MS), 5, 6, 0, 0.45455, 270, 311, -41, 
2012, Belhaven (MS), 6, 5, 0, 0.54545, 362, 188, 174, 
2013, Belhaven (MS), 3, 8, 0, 0.27273, 288, 468, -180, 
1934, South Dakota St., 6, 4, 0, 0.60000, 190, 72, 118, 
1935, South Dakota St., 4, 4, 1, 0.50000, 123, 92, 31, 
1936, South Dakota St., 3, 6, 1, 0.35000, 52, 116, -64, 
1937, South Dakota St., 4, 5, 0, 0.44444, 102, 147, -45, 
1968, Southeast Missouri St., 6, 4, 0, 0.60000, 234, 154, 80, 
1969, Southeast Missouri St., 8, 2, 0, 0.80000, 239, 222, 17, 
1970, Southeast Missouri St., 5, 5, 0, 0.50000, 189, 137, 52, 
1971, Southeast Missouri St., 7, 3, 1, 0.68182, 219, 163, 56, 
1972, Southeast Missouri St., 5, 4, 1, 0.55000, 187, 159, 28, 
1973, Southeast Missouri St., 6, 4, 0, 0.60000, 185, 137, 48, 
1913, Wabash (IN), 2, 3, 1, 0.41667, 48, 49, -1, 
1914, Wabash (IN), 5, 3, 0, 0.62500, 109, 95, 14, 
1956, Edinboro (PA), 5, 4, 0, 0.55556, 173, 103, 70, 
1957, Edinboro (PA), 3, 4, 0, 0.42857, 137, 53, 84, 
1958, Edinboro (PA), 4, 4, 1, 0.50000, 120, 111, 9, 
1959, Edinboro (PA), 3, 4, 1, 0.43750, 89, 117, -28, 
2007, Houston (TX), 0, 1, 0, 0.00000, 13, 20, -7, 
1974, Sam Houston St. (TX), 4, 7, 0, 0.36364, 204, 228, -24, 
1975, Sam Houston St. (TX), 3, 8, 0, 0.27273, 177, 326, -149, 
1976, Sam Houston St. (TX), 3, 5, 1, 0.38889, 121, 215, -94, 
1977, Sam Houston St. (TX), 1, 10, 0, 0.09091, 135, 246, -111, 
1910, Kentucky Wesleyan, 1, 3, 1, 0.30000, 28, 104, -76, 
1915, Kentucky, 6, 1, 1, 0.81250, 149, 38, 111, 
1916, Kentucky, 4, 1, 2, 0.71429, 152, 51, 101, 
1977, Southern (LA), 0, 4, 0, 0.00000, 49, 115, -66, 
2003, Elizabeth City St. (NC), 2, 8, 0, 0.20000, 95, 242, -147, 
2004, Elizabeth City St. (NC), 3, 7, 0, 0.30000, 117, 204, -87, 
2005, Elizabeth City St. (NC), 2, 8, 0, 0.20000, 122, 193, -71, 
2006, Elizabeth City St. (NC), 9, 3, 0, 0.75000, 302, 157, 145, 
2007, Elizabeth City St. (NC), 5, 5, 0, 0.50000, 170, 150, 20, 
2008, Elizabeth City St. (NC), 7, 4, 0, 0.63636, 361, 203, 158, 
2009, Elizabeth City St. (NC), 7, 4, 0, 0.63636, 357, 274, 83, 
2010, Elizabeth City St. (NC), 6, 4, 0, 0.60000, 291, 212, 79, 
2011, Elizabeth City St. (NC), 8, 4, 0, 0.66667, 334, 264, 70, 
2012, Elizabeth City St. (NC), 8, 4, 0, 0.66667, 298, 267, 31, 
2013, Elizabeth City St. (NC), 4, 6, 0, 0.40000, 309, 326, -17, 
1991, Wyoming, 4, 6, 1, 0.40909, 305, 357, -52, 
1992, Wyoming, 5, 7, 0, 0.41667, 302, 341, -39, 
1993, Wyoming, 8, 4, 0, 0.66667, 357, 329, 28, 
1994, Wyoming, 6, 6, 0, 0.50000, 319, 341, -22, 
1995, Wyoming, 6, 5, 0, 0.54545, 322, 264, 58, 
1996, Wyoming, 10, 2, 0, 0.83333, 464, 284, 180, 
1997, Purdue (IN), 9, 3, 0, 0.75000, 396, 267, 129, 
1998, Purdue (IN), 9, 4, 0, 0.69231, 444, 276, 168, 
1999, Purdue (IN), 7, 5, 0, 0.58333, 384, 305, 79, 
2000, Purdue (IN), 8, 4, 0, 0.66667, 381, 266, 115, 
2001, Purdue (IN), 6, 6, 0, 0.50000, 250, 278, -28, 
2002, Purdue (IN), 7, 6, 0, 0.53846, 386, 288, 98, 
2003, Purdue (IN), 9, 4, 0, 0.69231, 349, 226, 123, 
2004, Purdue (IN), 7, 5, 0, 0.58333, 381, 206, 175, 
2005, Purdue (IN), 5, 6, 0, 0.45455, 330, 309, 21, 
2006, Purdue (IN), 8, 6, 0, 0.57143, 364, 374, -10, 
2007, Purdue (IN), 8, 5, 0, 0.61538, 446, 345, 101, 
2008, Purdue (IN), 4, 8, 0, 0.33333, 296, 301, -5, 
1971, Northwood (TX), 5, 3, 1, 0.61111, 190, 110, 80, 
1978, Arkansas-Monticello, 5, 6, 0, 0.45455, 232, 160, 72, 
1979, Arkansas-Monticello, 9, 2, 0, 0.81818, 307, 139, 168, 
1980, Arkansas-Monticello, 4, 7, 0, 0.36364, 220, 237, -17, 
1981, Arkansas-Monticello, 7, 2, 0, 0.77778, 206, 169, 37, 
1982, Arkansas-Monticello, 3, 6, 0, 0.33333, 147, 219, -72, 
1983, Arkansas-Monticello, 6, 2, 1, 0.72222, 190, 178, 12, 
1984, Arkansas-Monticello, 5, 5, 0, 0.50000, 156, 171, -15, 
1955, Wichita St. (KS), 7, 2, 1, 0.75000, 252, 132, 120, 
1956, Wichita St. (KS), 4, 6, 0, 0.40000, 117, 198, -81, 
1942, Virginia Tech, 7, 2, 1, 0.75000, 161, 114, 47, 
1970, Allegheny (PA), 2, 5, 0, 0.28571, 116, 125, -9, 
1971, Allegheny (PA), 4, 4, 0, 0.50000, 110, 123, -13, 
1972, Allegheny (PA), 5, 4, 0, 0.55556, 127, 134, -7, 
1973, Allegheny (PA), 5, 3, 1, 0.61111, 184, 101, 83, 
1974, Allegheny (PA), 7, 1, 0, 0.87500, 250, 85, 165, 
1975, Allegheny (PA), 6, 2, 0, 0.75000, 155, 82, 73, 
1976, Allegheny (PA), 6, 2, 0, 0.75000, 166, 95, 71, 
1977, Allegheny (PA), 5, 3, 0, 0.62500, 113, 86, 27, 
1978, Allegheny (PA), 4, 3, 1, 0.56250, 96, 81, 15, 
1979, Allegheny (PA), 3, 5, 0, 0.37500, 111, 136, -25, 
1980, Allegheny (PA), 3, 4, 1, 0.43750, 113, 137, -24, 
1981, Allegheny (PA), 3, 5, 0, 0.37500, 151, 147, 4, 
1982, Allegheny (PA), 3, 6, 0, 0.33333, 118, 168, -50, 
1983, Allegheny (PA), 4, 5, 0, 0.44444, 135, 163, -28, 
1937, Louisiana College, 3, 6, 0, 0.33333, 69, 189, -120, 
1938, Louisiana College, 4, 4, 1, 0.50000, 77, 89, -12, 
1948, Louisiana St., 3, 7, 0, 0.30000, 99, 271, -172, 
1949, Louisiana St., 8, 3, 0, 0.72727, 231, 109, 122, 
1950, Louisiana St., 4, 5, 2, 0.45455, 165, 151, 14, 
1951, Louisiana St., 7, 3, 1, 0.68182, 128, 111, 17, 
1952, Louisiana St., 3, 7, 0, 0.30000, 148, 214, -66, 
1953, Louisiana St., 5, 3, 3, 0.59091, 194, 159, 35, 
1954, Louisiana St., 5, 6, 0, 0.45455, 125, 173, -48, 
2008, West Virginia Tech, 0, 11, 0, 0.00000, 233, 447, -214, 
2009, West Virginia Tech, 3, 8, 0, 0.27273, 208, 359, -151, 
2010, West Virginia Tech, 2, 9, 0, 0.18182, 282, 410, -128, 
2011, West Virginia Tech, 1, 9, 0, 0.10000, 137, 369, -232, 
1932, Allegheny (PA), 1, 5, 1, 0.21429, 22, 64, -42, 
1933, Allegheny (PA), 0, 5, 0, 0.00000, 0, 60, -60, 
1934, Allegheny (PA), 2, 4, 1, 0.35714, 26, 78, -52, 
1935, Clarion (PA), 1, 6, 0, 0.14286, 21, 183, -162, 
1936, Clarion (PA), 0, 6, 0, 0.00000, 14, 144, -130, 
1937, Clarion (PA), 3, 3, 0, 0.50000, 39, 55, -16, 
1938, Clarion (PA), 5, 3, 0, 0.62500, 99, 83, 16, 
1939, Clarion (PA), 5, 1, 1, 0.78571, 124, 51, 73, 
1940, Clarion (PA), 4, 3, 0, 0.57143, 143, 77, 66, 
1941, Clarion (PA), 3, 2, 1, 0.58333, 109, 38, 71, 
1942, Clarion (PA), 1, 3, 0, 0.25000, 28, 51, -23, 
1946, Clarion (PA), 3, 4, 0, 0.42857, 123, 84, 39, 
1947, Clarion (PA), 2, 5, 0, 0.28571, 59, 103, -44, 
1952, Clarion (PA), 9, 0, 0, 1.00000, 191, 30, 161, 
1953, Clarion (PA), 6, 2, 0, 0.75000, 176, 67, 109, 
1954, Clarion (PA), 5, 2, 0, 0.71429, 175, 85, 90, 
1955, Clarion (PA), 4, 3, 1, 0.56250, 114, 108, 6, 
1956, Clarion (PA), 2, 6, 0, 0.25000, 54, 119, -65, 
1918, Texas Christian, 4, 4, 0, 0.50000, 96, 92, 4, 
1996, Nevada, 9, 3, 0, 0.75000, 515, 278, 237, 
1997, Nevada, 5, 6, 0, 0.45455, 353, 320, 33, 
1998, Nevada, 6, 5, 0, 0.54545, 371, 316, 55, 
1999, Nevada, 3, 8, 0, 0.27273, 283, 418, -135, 
1953, New Mexico, 5, 3, 1, 0.61111, 154, 103, 51, 
1954, New Mexico, 5, 5, 0, 0.50000, 152, 168, -16, 
1955, New Mexico, 2, 8, 0, 0.20000, 61, 213, -152, 
1957, San Jose St. (CA), 3, 7, 0, 0.30000, 123, 196, -73, 
1958, San Jose St. (CA), 4, 5, 0, 0.44444, 174, 106, 68, 
1959, San Jose St. (CA), 4, 6, 0, 0.40000, 192, 278, -86, 
1960, San Jose St. (CA), 5, 4, 0, 0.55556, 175, 176, -1, 
1961, San Jose St. (CA), 6, 4, 0, 0.60000, 183, 185, -2, 
1962, San Jose St. (CA), 2, 8, 1, 0.22727, 133, 261, -128, 
1963, San Jose St. (CA), 5, 5, 0, 0.50000, 187, 194, -7, 
1964, San Jose St. (CA), 4, 6, 0, 0.40000, 151, 145, 6, 
1971, Texas Christian, 3, 1, 0, 0.75000, 55, 72, -17, 
1972, Texas Christian, 5, 6, 0, 0.45455, 213, 245, -32, 
1973, Texas Christian, 3, 8, 0, 0.27273, 189, 290, -101, 
1979, Pacific (CA), 3, 7, 0, 0.30000, 162, 193, -31, 
1980, Pacific (CA), 4, 8, 0, 0.33333, 211, 330, -119, 
1981, Pacific (CA), 5, 6, 0, 0.45455, 170, 253, -83, 
1982, Pacific (CA), 2, 9, 0, 0.18182, 200, 330, -130, 
1996, UCLA, 5, 6, 0, 0.45455, 330, 318, 12, 
1997, UCLA, 10, 2, 0, 0.83333, 477, 247, 230, 
1998, UCLA, 10, 2, 0, 0.83333, 476, 340, 136, 
1999, UCLA, 5, 6, 0, 0.45455, 230, 311, -81, 
2000, UCLA, 6, 6, 0, 0.50000, 353, 368, -15, 
2001, UCLA, 7, 4, 0, 0.63636, 317, 225, 92, 
2002, UCLA, 7, 5, 0, 0.58333, 360, 313, 47, 
2007, Tulane (LA), 4, 8, 0, 0.33333, 293, 375, -82, 
2008, Tulane (LA), 2, 10, 0, 0.16667, 200, 414, -214, 
2009, Tulane (LA), 3, 9, 0, 0.25000, 193, 440, -247, 
2010, Tulane (LA), 4, 8, 0, 0.33333, 299, 446, -147, 
2011, Tulane (LA), 2, 5, 0, 0.28571, 173, 248, -75, 
1977, Elon (NC), 9, 2, 0, 0.81818, 313, 143, 170, 
1978, Elon (NC), 11, 2, 1, 0.82143, 303, 176, 127, 
1979, Elon (NC), 5, 5, 0, 0.50000, 186, 149, 37, 
1980, Elon (NC), 13, 1, 0, 0.92857, 378, 189, 189, 
1981, Elon (NC), 11, 1, 1, 0.88462, 328, 149, 179, 
1969, Marshall (WV), 3, 7, 0, 0.30000, 207, 281, -74, 
1970, Marshall (WV), 3, 6, 0, 0.33333, 138, 202, -64, 
1983, Southern California, 4, 6, 1, 0.40909, 210, 238, -28, 
1984, Southern California, 9, 3, 0, 0.75000, 220, 173, 47, 
1985, Southern California, 6, 6, 0, 0.50000, 223, 187, 36, 
1986, Southern California, 7, 5, 0, 0.58333, 264, 239, 25, 
1994, San Diego St. (CA), 4, 7, 0, 0.36364, 332, 339, -7, 
1995, San Diego St. (CA), 8, 4, 0, 0.66667, 401, 283, 118, 
1996, San Diego St. (CA), 8, 3, 0, 0.72727, 428, 303, 125, 
1997, San Diego St. (CA), 5, 7, 0, 0.41667, 257, 333, -76, 
1998, San Diego St. (CA), 7, 5, 0, 0.58333, 243, 244, -1, 
1999, San Diego St. (CA), 5, 6, 0, 0.45455, 272, 226, 46, 
2000, San Diego St. (CA), 3, 8, 0, 0.27273, 170, 273, -103, 
2001, San Diego St. (CA), 3, 8, 0, 0.27273, 184, 290, -106, 
1946, Mesa St. (CO), 7, 2, 0, 0.77778, 111, 63, 48, 
1947, Mesa St. (CO), 5, 3, 1, 0.61111, 142, 90, 52, 
1948, Mesa St. (CO), 6, 3, 1, 0.65000, 217, 116, 101, 
1949, Mesa St. (CO), 3, 7, 0, 0.30000, 137, 230, -93, 
2013, Knox (IL), 1, 9, 0, 0.10000, 173, 312, -139, 
1977, Hawaii, 5, 6, 0, 0.45455, 250, 233, 17, 
1978, Hawaii, 6, 5, 0, 0.54545, 251, 280, -29, 
1979, Hawaii, 6, 5, 0, 0.54545, 330, 213, 117, 
1980, Hawaii, 8, 3, 0, 0.72727, 260, 212, 48, 
1981, Hawaii, 9, 2, 0, 0.81818, 328, 130, 198, 
1982, Hawaii, 6, 5, 0, 0.54545, 240, 230, 10, 
1983, Hawaii, 5, 5, 1, 0.50000, 251, 236, 15, 
1984, Hawaii, 7, 4, 0, 0.63636, 217, 181, 36, 
1985, Hawaii, 4, 6, 2, 0.41667, 269, 262, 7, 
1986, Hawaii, 7, 5, 0, 0.58333, 238, 235, 3, 
1987, Arizona, 4, 4, 3, 0.50000, 263, 220, 43, 
1988, Arizona, 7, 4, 0, 0.63636, 279, 218, 61, 
1989, Arizona, 8, 4, 0, 0.66667, 248, 178, 70, 
1990, Arizona, 7, 5, 0, 0.58333, 267, 311, -44, 
1991, Arizona, 4, 7, 0, 0.36364, 248, 361, -113, 
1992, Arizona, 6, 5, 1, 0.54167, 232, 118, 114, 
1993, Arizona, 10, 2, 0, 0.83333, 294, 161, 133, 
1994, Arizona, 8, 4, 0, 0.66667, 278, 190, 88, 
1995, Arizona, 6, 5, 0, 0.54545, 207, 199, 8, 
1996, Arizona, 5, 6, 0, 0.45455, 310, 280, 30, 
1997, Arizona, 7, 5, 0, 0.58333, 317, 312, 5, 
1998, Arizona, 12, 1, 0, 0.92308, 439, 236, 203, 
1999, Arizona, 6, 6, 0, 0.50000, 339, 364, -25, 
2000, Arizona, 5, 6, 0, 0.45455, 254, 237, 17, 
2005, San Jose St. (CA), 3, 8, 0, 0.27273, 248, 357, -109, 
2006, San Jose St. (CA), 9, 4, 0, 0.69231, 324, 270, 54, 
2007, San Jose St. (CA), 5, 7, 0, 0.41667, 245, 352, -107, 
2008, San Jose St. (CA), 6, 6, 0, 0.50000, 224, 259, -35, 
2009, San Jose St. (CA), 2, 10, 0, 0.16667, 165, 414, -249, 
1943, Arkansas, 2, 7, 0, 0.22222, 105, 192, -87, 
1945, Arkansas St., 2, 4, 1, 0.35714, 51, 95, -44, 
1947, Pacific Lutheran (WA), 7, 0, 2, 0.88889, 161, 42, 119, 
1948, Pacific Lutheran (WA), 6, 2, 1, 0.72222, 129, 55, 74, 
1949, Pacific Lutheran (WA), 2, 5, 2, 0.33333, 103, 168, -65, 
1950, Pacific Lutheran (WA), 4, 3, 1, 0.56250, 91, 122, -31, 
1960, Austin Peay St. (TN), 2, 8, 0, 0.20000, 114, 186, -72, 
1961, Austin Peay St. (TN), 2, 8, 0, 0.20000, 92, 214, -122, 
1962, Austin Peay St. (TN), 0, 10, 0, 0.00000, 47, 218, -171, 
1966, Connecticut, 2, 6, 1, 0.27778, 92, 156, -64, 
1967, Connecticut, 5, 4, 0, 0.55556, 137, 151, -14, 
1968, Connecticut, 4, 6, 0, 0.40000, 216, 191, 25, 
1969, Connecticut, 5, 4, 0, 0.55556, 193, 187, 6, 
1970, Connecticut, 4, 4, 2, 0.50000, 240, 193, 47, 
1900, Colorado St., 1, 4, 0, 0.20000, 16, 110, -94, 
1901, Colorado St., 1, 0, 0, 1.00000, 1, 0, 1, 
1928, California-Davis, 6, 3, 0, 0.66667, 91, 41, 50, 
1929, California-Davis, 6, 2, 0, 0.75000, 116, 25, 91, 
1930, California-Davis, 0, 7, 1, 0.06250, 17, 134, -117, 
1931, California-Davis, 4, 2, 2, 0.62500, 92, 75, 17, 
1932, California-Davis, 1, 8, 1, 0.15000, 42, 211, -169, 
1933, California-Davis, 2, 5, 0, 0.28571, 40, 118, -78, 
1934, California-Davis, 0, 5, 3, 0.18750, 16, 163, -147, 
1935, California-Davis, 2, 6, 1, 0.27778, 47, 199, -152, 
1936, California-Davis, 3, 4, 0, 0.42857, 86, 115, -29, 
2001, Davidson (NC), 5, 4, 0, 0.55556, 199, 206, -7, 
2002, Davidson (NC), 7, 3, 0, 0.70000, 320, 227, 93, 
2003, Davidson (NC), 3, 8, 0, 0.27273, 246, 364, -118, 
2004, Davidson (NC), 2, 7, 0, 0.22222, 132, 254, -122, 
2005, Merchant Marine (NY), 3, 7, 0, 0.30000, 172, 257, -85, 
2006, Merchant Marine (NY), 3, 7, 0, 0.30000, 197, 251, -54, 
2007, Merchant Marine (NY), 1, 9, 0, 0.10000, 139, 402, -263, 
2008, Merchant Marine (NY), 3, 7, 0, 0.30000, 166, 262, -96, 
2009, Merchant Marine (NY), 4, 6, 0, 0.40000, 196, 267, -71, 
2010, Merchant Marine (NY), 4, 6, 0, 0.40000, 245, 280, -35, 
2011, Merchant Marine (NY), 3, 7, 0, 0.30000, 196, 318, -122, 
2012, Merchant Marine (NY), 5, 5, 0, 0.50000, 245, 347, -102, 
2013, Merchant Marine (NY), 4, 4, 0, 0.50000, 130, 178, -48, 
1922, Delaware Valley (PA), 0, 8, 0, 0.00000, 19, 151, -132, 
1987, Louisiana Tech, 3, 8, 0, 0.27273, 108, 197, -89, 
1997, North Carolina, 1, 0, 0, 1.00000, 42, 3, 39, 
1998, North Carolina, 7, 5, 0, 0.58333, 288, 283, 5, 
1999, North Carolina, 3, 8, 0, 0.27273, 186, 272, -86, 
2000, North Carolina, 6, 5, 0, 0.54545, 269, 284, -15, 
1995, Idaho, 6, 5, 0, 0.54545, 287, 209, 78, 
1996, Idaho, 6, 5, 0, 0.54545, 374, 296, 78, 
1997, Idaho, 5, 6, 0, 0.45455, 302, 263, 39, 
1998, Idaho, 9, 3, 0, 0.75000, 392, 317, 75, 
1999, Idaho, 7, 4, 0, 0.63636, 304, 283, 21, 
2000, Nevada, 2, 10, 0, 0.16667, 207, 464, -257, 
2001, Nevada, 3, 8, 0, 0.27273, 286, 431, -145, 
2002, Nevada, 5, 7, 0, 0.41667, 331, 371, -40, 
2003, Nevada, 6, 6, 0, 0.50000, 282, 338, -56, 
1987, Princeton (NJ), 6, 4, 0, 0.60000, 230, 155, 75, 
1988, Princeton (NJ), 6, 4, 0, 0.60000, 269, 208, 61, 
1989, Princeton (NJ), 7, 2, 1, 0.75000, 237, 177, 60, 
1990, Princeton (NJ), 3, 7, 0, 0.30000, 168, 224, -56, 
1991, Princeton (NJ), 8, 2, 0, 0.80000, 253, 171, 82, 
1992, Princeton (NJ), 8, 2, 0, 0.80000, 264, 175, 89, 
1993, Princeton (NJ), 8, 2, 0, 0.80000, 241, 136, 105, 
1994, Princeton (NJ), 7, 3, 0, 0.70000, 201, 147, 54, 
1995, Princeton (NJ), 8, 1, 1, 0.85000, 243, 124, 119, 
1996, Princeton (NJ), 3, 7, 0, 0.30000, 144, 202, -58, 
1997, Princeton (NJ), 6, 4, 0, 0.60000, 148, 132, 16, 
1998, Princeton (NJ), 5, 5, 0, 0.50000, 225, 162, 63, 
1999, Princeton (NJ), 3, 7, 0, 0.30000, 184, 225, -41, 
2002, Mississippi Valley St., 5, 6, 0, 0.45455, 241, 260, -19, 
2003, Mississippi Valley St., 2, 9, 0, 0.18182, 181, 331, -150, 
2004, Mississippi Valley St., 3, 8, 0, 0.27273, 248, 314, -66, 
2005, Mississippi Valley St., 6, 5, 0, 0.54545, 360, 292, 68, 
2006, Mississippi Valley St., 6, 5, 0, 0.54545, 199, 245, -46, 
2007, Mississippi Valley St., 3, 8, 0, 0.27273, 175, 326, -151, 
2008, Mississippi Valley St., 3, 8, 0, 0.27273, 232, 400, -168, 
2009, Mississippi Valley St., 3, 8, 0, 0.27273, 146, 295, -149, 
1967, Southern Illinois, 3, 7, 0, 0.30000, 120, 227, -107, 
1968, Southern Illinois, 6, 3, 0, 0.66667, 205, 161, 44, 
1969, Southern Illinois, 5, 5, 0, 0.50000, 246, 173, 73, 
1970, Southern Illinois, 6, 3, 0, 0.66667, 265, 175, 90, 
1971, Southern Illinois, 6, 4, 0, 0.60000, 226, 195, 31, 
1972, Southern Illinois, 1, 8, 1, 0.15000, 55, 181, -126, 
1973, Southern Illinois, 3, 7, 1, 0.31818, 267, 296, -29, 
1917, Wabash (IN), 1, 6, 1, 0.18750, 19, 127, -108, 
1918, Wabash (IN), 1, 3, 0, 0.25000, 40, 168, -128, 
1932, North Carolina Central, 3, 5, 0, 0.37500, 73, 109, -36, 
1933, North Carolina Central, 4, 4, 0, 0.50000, 92, 68, 24, 
1934, North Carolina Central, 5, 5, 0, 0.50000, 115, 87, 28, 
1935, North Carolina Central, 4, 4, 0, 0.50000, 53, 115, -62, 
1959, Nevada, 4, 3, 0, 0.57143, 130, 91, 39, 
1960, Nevada, 3, 6, 0, 0.33333, 121, 153, -32, 
1961, Nevada, 5, 4, 0, 0.55556, 153, 179, -26, 
1962, Nevada, 5, 3, 1, 0.61111, 139, 87, 52, 
1963, Nevada, 3, 6, 0, 0.33333, 134, 182, -48, 
1964, Nevada, 1, 9, 0, 0.10000, 104, 263, -159, 
1965, Nevada, 6, 4, 0, 0.60000, 210, 162, 48, 
1966, Nevada, 6, 3, 0, 0.66667, 217, 153, 64, 
1967, Nevada, 4, 4, 1, 0.50000, 150, 159, -9, 
1968, Nevada, 3, 6, 1, 0.35000, 176, 183, -7, 
1957, Dickinson St. (ND), 2, 4, 1, 0.35714, 45, 99, -54, 
1958, Dickinson St. (ND), 6, 1, 0, 0.85714, 85, 45, 40, 
1959, Dickinson St. (ND), 5, 2, 0, 0.71429, 106, 67, 39, 
1960, Dickinson St. (ND), 5, 3, 0, 0.62500, 200, 114, 86, 
1961, Dickinson St. (ND), 5, 3, 0, 0.62500, 191, 95, 96, 
1962, Dickinson St. (ND), 2, 5, 0, 0.28571, 92, 109, -17, 
1908, Southern California, 6, 1, 1, 0.81250, 183, 18, 165, 
2009, Rhode Island, 1, 10, 0, 0.09091, 232, 406, -174, 
2010, Rhode Island, 5, 6, 0, 0.45455, 217, 268, -51, 
2011, Rhode Island, 3, 8, 0, 0.27273, 243, 312, -69, 
2012, Rhode Island, 0, 11, 0, 0.00000, 105, 432, -327, 
2013, Rhode Island, 3, 9, 0, 0.25000, 159, 402, -243, 
1956, Eureka (IL), 1, 6, 0, 0.14286, 51, 199, -148, 
1957, Eureka (IL), 3, 4, 0, 0.42857, 71, 158, -87, 
1958, Eureka (IL), 1, 7, 0, 0.12500, 60, 286, -226, 
1959, Eureka (IL), 0, 5, 3, 0.18750, 20, 178, -158, 
1960, Eureka (IL), 1, 4, 2, 0.28571, 50, 186, -136, 
1961, Eureka (IL), 3, 2, 1, 0.58333, 107, 81, 26, 
1962, Eureka (IL), 1, 6, 0, 0.14286, 46, 170, -124, 
1963, Eureka (IL), 0, 7, 0, 0.00000, 28, 198, -170, 
1964, Eureka (IL), 0, 7, 0, 0.00000, 13, 218, -205, 
1965, Eureka (IL), 1, 7, 0, 0.12500, 50, 188, -138, 
1966, Eureka (IL), 0, 7, 0, 0.00000, 29, 182, -153, 
1982, Navy (MD), 6, 5, 0, 0.54545, 220, 196, 24, 
1983, Navy (MD), 3, 8, 0, 0.27273, 202, 272, -70, 
1984, Navy (MD), 4, 6, 1, 0.40909, 240, 254, -14, 
1985, Navy (MD), 4, 7, 0, 0.36364, 253, 239, 14, 
1986, Navy (MD), 3, 8, 0, 0.27273, 238, 306, -68, 
1930, Chadron St. (NE), 5, 2, 0, 0.71429, 85, 44, 41, 
1931, Chadron St. (NE), 3, 4, 0, 0.42857, 66, 91, -25, 
1932, Chadron St. (NE), 4, 3, 0, 0.57143, 77, 54, 23, 
1933, Chadron St. (NE), 6, 1, 0, 0.85714, 128, 50, 78, 
1934, Chadron St. (NE), 6, 2, 0, 0.75000, 118, 48, 70, 
1935, Chadron St. (NE), 2, 5, 0, 0.28571, 68, 125, -57, 
1936, Chadron St. (NE), 4, 3, 0, 0.57143, 80, 92, -12, 
1937, Chadron St. (NE), 3, 3, 0, 0.50000, 60, 82, -22, 
1932, Canisius (NY), 0, 3, 1, 0.12500, 6, 51, -45, 
2011, Miami (OH), 4, 8, 0, 0.33333, 256, 275, -19, 
2012, Miami (OH), 4, 8, 0, 0.33333, 280, 419, -139, 
2013, Miami (OH), 0, 5, 0, 0.00000, 44, 178, -134, 
1895, North Carolina, 7, 1, 1, 0.83333, 146, 17, 129, 
1896, West Virginia, 3, 7, 2, 0.33333, 14, 101, -87, 
1897, Pittsburgh (PA), 1, 3, 0, 0.25000, 13, 91, -78, 
1913, North Carolina, 5, 4, 0, 0.55556, 91, 76, 15, 
1914, North Carolina, 10, 1, 0, 0.90909, 359, 52, 307, 
1915, North Carolina, 4, 3, 1, 0.56250, 105, 98, 7, 
1986, Youngstown St. (OH), 2, 9, 0, 0.18182, 223, 288, -65, 
1987, Youngstown St. (OH), 8, 4, 0, 0.66667, 240, 231, 9, 
1988, Youngstown St. (OH), 4, 7, 0, 0.36364, 190, 267, -77, 
1989, Youngstown St. (OH), 9, 4, 0, 0.69231, 372, 245, 127, 
1990, Youngstown St. (OH), 11, 1, 0, 0.91667, 340, 146, 194, 
1991, Youngstown St. (OH), 12, 3, 0, 0.80000, 413, 256, 157, 
1992, Youngstown St. (OH), 11, 3, 1, 0.76667, 448, 295, 153, 
1993, Youngstown St. (OH), 13, 2, 0, 0.86667, 448, 232, 216, 
1994, Youngstown St. (OH), 14, 0, 1, 0.96667, 418, 152, 266, 
1995, Youngstown St. (OH), 3, 8, 0, 0.27273, 188, 236, -48, 
1996, Youngstown St. (OH), 8, 3, 0, 0.72727, 261, 131, 130, 
1997, Youngstown St. (OH), 13, 2, 0, 0.86667, 460, 230, 230, 
1998, Youngstown St. (OH), 6, 5, 0, 0.54545, 250, 261, -11, 
1999, Youngstown St. (OH), 12, 3, 0, 0.80000, 421, 362, 59, 
2000, Youngstown St. (OH), 9, 3, 0, 0.75000, 296, 189, 107, 
2001, Ohio St., 7, 5, 0, 0.58333, 312, 244, 68, 
2002, Ohio St., 14, 0, 0, 1.00000, 410, 183, 227, 
2003, Ohio St., 11, 2, 0, 0.84615, 322, 229, 93, 
2004, Ohio St., 8, 4, 0, 0.66667, 290, 219, 71, 
2005, Ohio St., 10, 2, 0, 0.83333, 392, 183, 209, 
2006, Ohio St., 12, 1, 0, 0.92308, 450, 166, 284, 
2007, Ohio St., 11, 2, 0, 0.84615, 408, 166, 242, 
2008, Ohio St., 10, 3, 0, 0.76923, 359, 181, 178, 
2009, Ohio St., 11, 2, 0, 0.84615, 377, 163, 214, 
2010, Ohio St., 0, 1, 0, 0.00000, 504, 186, 318, 
1994, Harding (AR), 5, 4, 1, 0.55000, 235, 204, 31, 
1995, Harding (AR), 4, 6, 0, 0.40000, 149, 231, -82, 
1996, Harding (AR), 6, 4, 0, 0.60000, 324, 277, 47, 
1997, Harding (AR), 5, 5, 0, 0.50000, 280, 281, -1, 
1998, Harding (AR), 8, 3, 0, 0.72727, 212, 238, -26, 
1999, Harding (AR), 5, 5, 0, 0.50000, 309, 263, 46, 
2000, Harding (AR), 5, 6, 0, 0.45455, 345, 369, -24, 
2001, Harding (AR), 4, 6, 0, 0.40000, 229, 266, -37, 
2002, Harding (AR), 9, 2, 0, 0.81818, 333, 248, 85, 
2003, Harding (AR), 4, 6, 0, 0.40000, 198, 265, -67, 
2004, Harding (AR), 6, 5, 0, 0.54545, 266, 284, -18, 
2005, Harding (AR), 6, 5, 0, 0.54545, 246, 234, 12, 
2006, Harding (AR), 6, 4, 0, 0.60000, 244, 248, -4, 
2007, Harding (AR), 1, 1, 0, 0.50000, 63, 88, -25, 
1972, Iona (NY), 5, 3, 1, 0.61111, 162, 158, 4, 
1973, Iona (NY), 8, 2, 0, 0.80000, 207, 98, 109, 
1999, Glenville St. (WV), 5, 6, 0, 0.45455, 269, 266, 3, 
1907, Franklin & Marshall (PA), 4, 6, 0, 0.40000, 81, 170, -89, 
1948, Wichita St. (KS), 5, 4, 1, 0.55000, 196, 234, -38, 
1949, Wichita St. (KS), 3, 6, 1, 0.35000, 212, 211, 1, 
1950, Wichita St. (KS), 5, 4, 1, 0.55000, 203, 243, -40, 
1969, San Francisco (CA), 3, 6, 0, 0.33333, 94, 278, -184, 
1970, San Francisco (CA), 0, 9, 0, 0.00000, 97, 288, -191, 
1971, San Francisco (CA), 0, 10, 0, 0.00000, 154, 308, -154, 
1979, South Dakota, 5, 6, 0, 0.45455, 234, 205, 29, 
1980, South Dakota, 5, 6, 0, 0.45455, 151, 255, -104, 
1981, South Dakota, 5, 6, 0, 0.45455, 209, 220, -11, 
1982, South Dakota, 6, 5, 0, 0.54545, 181, 213, -32, 
1983, South Dakota, 7, 4, 0, 0.63636, 259, 196, 63, 
1984, South Dakota, 8, 3, 0, 0.72727, 247, 234, 13, 
1985, South Dakota, 10, 3, 0, 0.76923, 378, 227, 151, 
1986, South Dakota, 11, 3, 0, 0.78571, 427, 233, 194, 
1987, South Dakota, 7, 4, 0, 0.63636, 232, 160, 72, 
1988, South Dakota, 6, 5, 0, 0.54545, 217, 183, 34, 
1988, Lane (TN), 3, 6, 0, 0.33333, 135, 208, -73, 
1989, Lane (TN), 1, 9, 1, 0.13636, 174, 439, -265, 
1990, Lane (TN), 1, 8, 0, 0.11111, 78, 379, -301, 
1991, Lane (TN), 0, 9, 0, 0.00000, 41, 370, -329, 
1992, Lane (TN), 0, 7, 0, 0.00000, 15, 238, -223, 
1949, Stetson (FL), 4, 5, 1, 0.45000, 206, 155, 51, 
2003, Huntingdon College (AL), 0, 7, 0, 0.00000, 99, 343, -244, 
1952, Eastern Michigan, 5, 3, 1, 0.61111, 154, 146, 8, 
1953, Eastern Michigan, 7, 1, 1, 0.83333, 212, 105, 107, 
1954, Eastern Michigan, 8, 1, 0, 0.88889, 210, 67, 143, 
1955, Eastern Michigan, 7, 2, 0, 0.77778, 138, 70, 68, 
1956, Eastern Michigan, 4, 4, 0, 0.50000, 158, 84, 74, 
1957, Eastern Michigan, 6, 3, 0, 0.66667, 237, 127, 110, 
1958, Eastern Michigan, 4, 5, 0, 0.44444, 108, 88, 20, 
1959, Eastern Michigan, 1, 7, 0, 0.12500, 50, 217, -167, 
1960, Eastern Michigan, 0, 8, 1, 0.05556, 38, 230, -192, 
1961, Eastern Michigan, 0, 8, 1, 0.05556, 49, 171, -122, 
1962, Eastern Michigan, 2, 5, 0, 0.28571, 75, 90, -15, 
1963, Eastern Michigan, 2, 6, 0, 0.25000, 96, 201, -105, 
1964, Eastern Michigan, 4, 3, 0, 0.57143, 110, 73, 37, 
2013, Missouri Valley, 9, 3, 0, 0.75000, 322, 133, 189, 
1920, UCLA, 0, 5, 0, 0.00000, 21, 224, -203, 
1921, UCLA, 0, 5, 0, 0.00000, 14, 214, -200, 
1922, UCLA, 2, 3, 1, 0.41667, 84, 62, 22, 
1943, Willamette (OR), 2, 1, 0, 0.66667, 52, 18, 34, 
1944, Willamette (OR), 3, 2, 0, 0.60000, 78, 131, -53, 
1903, West Virginia, 7, 1, 0, 0.87500, 145, 61, 84, 
1974, Idaho, 2, 8, 1, 0.22727, 198, 280, -82, 
1975, Idaho, 4, 5, 2, 0.45455, 251, 316, -65, 
1976, Idaho, 7, 4, 0, 0.63636, 224, 236, -12, 
1977, Idaho, 3, 8, 0, 0.27273, 245, 365, -120, 
2006, Franklin & Marshall (PA), 3, 7, 0, 0.30000, 185, 229, -44, 
2007, Franklin & Marshall (PA), 4, 6, 0, 0.40000, 208, 254, -46, 
2008, Franklin & Marshall (PA), 4, 6, 0, 0.40000, 208, 181, 27, 
2009, Franklin & Marshall (PA), 9, 2, 0, 0.81818, 334, 252, 82, 
2010, Franklin & Marshall (PA), 6, 5, 0, 0.54545, 323, 270, 53, 
2011, Franklin & Marshall (PA), 3, 7, 0, 0.30000, 192, 241, -49, 
2012, Franklin & Marshall (PA), 7, 4, 0, 0.63636, 321, 267, 54, 
2013, Franklin & Marshall (PA), 7, 4, 0, 0.63636, 346, 267, 79, 
2000, Southwestern Assemblies (TX), 3, 8, 0, 0.27273, 134, 359, -225, 
2001, Southwestern Assemblies (TX), 1, 10, 0, 0.09091, 93, 428, -335, 
1939, West Alabama, 6, 5, 0, 0.54545, 137, 171, -34, 
1940, West Alabama, 6, 1, 1, 0.81250, 108, 27, 81, 
1941, West Alabama, 1, 6, 0, 0.14286, 53, 207, -154, 
1935, Miami (FL), 5, 3, 0, 0.62500, 91, 52, 39, 
1936, Miami (FL), 6, 2, 2, 0.70000, 129, 39, 90, 
1937, Iowa, 1, 7, 0, 0.12500, 36, 120, -84, 
1938, Iowa, 1, 6, 1, 0.18750, 46, 135, -89, 
1995, Mississippi, 6, 5, 0, 0.54545, 209, 208, 1, 
1996, Mississippi, 5, 6, 0, 0.45455, 203, 270, -67, 
1997, Mississippi, 8, 4, 0, 0.66667, 267, 240, 27, 
1998, Mississippi, 6, 5, 0, 0.54545, 245, 256, -11, 
1999, Auburn (AL), 5, 6, 0, 0.45455, 233, 236, -3, 
2000, Auburn (AL), 9, 4, 0, 0.69231, 316, 266, 50, 
2001, Auburn (AL), 7, 5, 0, 0.58333, 254, 281, -27, 
2002, Auburn (AL), 9, 4, 0, 0.69231, 388, 231, 157, 
2003, Auburn (AL), 8, 5, 0, 0.61538, 342, 212, 130, 
2004, Auburn (AL), 13, 0, 0, 1.00000, 417, 147, 270, 
2005, Auburn (AL), 9, 3, 0, 0.75000, 386, 186, 200, 
2006, Auburn (AL), 11, 2, 0, 0.84615, 322, 181, 141, 
2007, Auburn (AL), 9, 4, 0, 0.69231, 315, 220, 95, 
2008, Auburn (AL), 5, 7, 0, 0.41667, 208, 216, -8, 
2010, Texas Tech, 8, 5, 0, 0.61538, 430, 402, 28, 
2011, Texas Tech, 5, 7, 0, 0.41667, 406, 471, -65, 
2012, Texas Tech, 7, 5, 0, 0.58333, 453, 382, 71, 
2013, Cincinnati (OH), 9, 4, 0, 0.69231, 417, 273, 144, 
1990, Livingstone (NC), 3, 6, 0, 0.33333, 188, 210, -22, 
1991, Livingstone (NC), 5, 5, 0, 0.50000, 197, 228, -31, 
1992, Livingstone (NC), 3, 7, 0, 0.30000, 183, 270, -87, 
1993, Livingstone (NC), 1, 10, 0, 0.09091, 148, 380, -232, 
1960, Elon (NC), 4, 6, 0, 0.40000, 102, 174, -72, 
1961, Elon (NC), 4, 6, 0, 0.40000, 113, 191, -78, 
1962, Elon (NC), 7, 3, 0, 0.70000, 158, 123, 35, 
1963, Elon (NC), 6, 4, 0, 0.60000, 171, 102, 69, 
1964, Elon (NC), 8, 1, 1, 0.85000, 223, 90, 133, 
1933, Arkansas Tech, 3, 3, 1, 0.50000, 91, 75, 16, 
1934, Arkansas Tech, 4, 1, 2, 0.71429, 108, 6, 102, 
1935, Arkansas Tech, 8, 0, 1, 0.94444, 192, 13, 179, 
1936, Arkansas Tech, 6, 2, 0, 0.75000, 258, 57, 201, 
1937, Arkansas Tech, 7, 2, 0, 0.77778, 214, 47, 167, 
1938, Arkansas Tech, 4, 2, 2, 0.62500, 142, 86, 56, 
1939, Arkansas Tech, 7, 0, 2, 0.88889, 184, 29, 155, 
1940, Arkansas Tech, 5, 3, 1, 0.61111, 178, 72, 106, 
1941, Arkansas Tech, 6, 3, 0, 0.66667, 121, 40, 81, 
1945, Arkansas Tech, 8, 0, 0, 1.00000, 308, 6, 302, 
1946, Arkansas Tech, 9, 1, 0, 0.90000, 253, 51, 202, 
1947, Arkansas Tech, 8, 1, 0, 0.88889, 223, 60, 163, 
1915, Savannah St. (GA), 1, 1, 0, 0.50000, 28, 12, 16, 
1923, Savannah St. (GA), 1, 0, 0, 1.00000, 35, 0, 35, 
1925, Savannah St. (GA), 1, 0, 0, 1.00000, 6, 3, 3, 
1926, Savannah St. (GA), 0, 1, 0, 0.00000, 0, 24, -24, 
1927, Savannah St. (GA), 1, 3, 0, 0.25000, 19, 88, -69, 
1928, Savannah St. (GA), 0, 3, 0, 0.00000, 13, 79, -66, 
1954, Tennessee Tech, 4, 4, 2, 0.50000, 197, 139, 58, 
1955, Tennessee Tech, 7, 3, 0, 0.70000, 263, 109, 154, 
1956, Tennessee Tech, 5, 4, 1, 0.55000, 181, 183, -2, 
1957, Tennessee Tech, 6, 4, 0, 0.60000, 127, 164, -37, 
1958, Tennessee Tech, 7, 3, 0, 0.70000, 132, 129, 3, 
1959, Tennessee Tech, 6, 2, 2, 0.70000, 196, 113, 83, 
1960, Tennessee Tech, 8, 3, 0, 0.72727, 177, 138, 39, 
1961, Tennessee Tech, 7, 3, 0, 0.70000, 156, 126, 30, 
1962, Tennessee Tech, 2, 8, 0, 0.20000, 88, 194, -106, 
1963, Tennessee Tech, 6, 4, 0, 0.60000, 193, 152, 41, 
1964, Tennessee Tech, 1, 9, 0, 0.10000, 74, 219, -145, 
1965, Tennessee Tech, 3, 7, 0, 0.30000, 177, 181, -4, 
1966, Tennessee Tech, 5, 5, 0, 0.50000, 170, 163, 7, 
1967, Tennessee Tech, 3, 7, 0, 0.30000, 187, 264, -77, 
1915, Parsons (IA), 4, 4, 0, 0.50000, 185, 96, 89, 
1920, Louisiana-Lafayette, 2, 8, 0, 0.20000, 83, 232, -149, 
2013, Washington, 1, 0, 0, 1.00000, 31, 16, 15, 
1949, Gannon (PA), 8, 0, 0, 1.00000, 184, 20, 164, 
1950, Gannon (PA), 6, 2, 0, 0.75000, 230, 119, 111, 
1990, Eureka (IL), 5, 5, 0, 0.50000, 176, 190, -14, 
1991, Eureka (IL), 10, 1, 0, 0.90909, 378, 126, 252, 
1992, Eureka (IL), 5, 5, 0, 0.50000, 237, 196, 41, 
1993, Eureka (IL), 3, 7, 0, 0.30000, 222, 203, 19, 
1994, Eureka (IL), 8, 3, 0, 0.72727, 414, 233, 181, 
2013, Whitworth (WA), 4, 6, 0, 0.40000, 285, 289, -4, 
1990, Southern Arkansas, 8, 3, 1, 0.70833, 312, 273, 39, 
1991, Southern Arkansas, 7, 4, 0, 0.63636, 189, 215, -26, 
1992, Southern Arkansas, 1, 10, 0, 0.09091, 155, 270, -115, 
1993, Southern Arkansas, 6, 4, 0, 0.60000, 244, 196, 48, 
1914, Carson-Newman (TN), 1, 5, 0, 0.16667, 10, 127, -117, 
1928, Harding (AR), 2, 2, 2, 0.50000, 78, 32, 46, 
2004, Huntingdon College (AL), 4, 5, 0, 0.44444, 240, 274, -34, 
2005, Huntingdon College (AL), 7, 2, 0, 0.77778, 306, 171, 135, 
2006, Huntingdon College (AL), 6, 4, 0, 0.60000, 249, 209, 40, 
2007, Huntingdon College (AL), 5, 5, 0, 0.50000, 272, 224, 48, 
2008, Huntingdon College (AL), 8, 2, 0, 0.80000, 417, 158, 259, 
2009, Huntingdon College (AL), 8, 3, 0, 0.72727, 408, 293, 115, 
2010, Huntingdon College (AL), 6, 4, 0, 0.60000, 372, 326, 46, 
2011, Huntingdon College (AL), 7, 3, 0, 0.70000, 333, 253, 80, 
2012, Huntingdon College (AL), 6, 3, 0, 0.66667, 330, 228, 102, 
2013, Huntingdon College (AL), 7, 3, 0, 0.70000, 436, 336, 100, 
1914, Wheaton (IL), 1, 5, 0, 0.16667, 35, 182, -147, 
1915, Wheaton (IL), 5, 2, 0, 0.71429, 135, 130, 5, 
1903, Buffalo (NY), 4, 4, 0, 0.50000, 51, 129, -78, 
1975, Bemidji St. (MN), 2, 7, 0, 0.22222, 118, 311, -193, 
1976, Bemidji St. (MN), 6, 4, 0, 0.60000, 219, 200, 19, 
1977, Bemidji St. (MN), 6, 4, 0, 0.60000, 248, 147, 101, 
1984, Chadron St. (NE), 2, 7, 1, 0.25000, 137, 262, -125, 
1985, Chadron St. (NE), 5, 3, 1, 0.61111, 279, 223, 56, 
1986, Chadron St. (NE), 3, 6, 0, 0.33333, 124, 223, -99, 
1987, Dubuque (IA), 6, 5, 0, 0.54545, 272, 229, 43, 
1988, Dubuque (IA), 3, 7, 0, 0.30000, 194, 276, -82, 
1989, Dubuque (IA), 4, 6, 0, 0.40000, 217, 320, -103, 
1942, North Carolina Central, 2, 4, 0, 0.33333, 75, 71, 4, 
1916, Kentucky Wesleyan, 0, 3, 0, 0.00000, 0, 231, -231, 
1990, Henderson St. (AR), 6, 3, 1, 0.65000, 174, 136, 38, 
1991, Henderson St. (AR), 2, 7, 1, 0.25000, 196, 209, -13, 
1992, Henderson St. (AR), 4, 6, 1, 0.40909, 197, 235, -38, 
1993, Henderson St. (AR), 4, 6, 0, 0.40000, 183, 232, -49, 
1904, Hamilton (NY), 5, 3, 0, 0.62500, 124, 129, -5, 
1907, Purdue (IN), 0, 5, 0, 0.00000, 10, 108, -98, 
1992, San Jose St. (CA), 7, 4, 0, 0.63636, 330, 309, 21, 
1997, Illinois, 0, 11, 0, 0.00000, 119, 368, -249, 
1998, Illinois, 3, 8, 0, 0.27273, 149, 326, -177, 
1999, Illinois, 8, 4, 0, 0.66667, 388, 275, 113, 
2000, Illinois, 5, 6, 0, 0.45455, 294, 286, 8, 
2001, Illinois, 10, 2, 0, 0.83333, 390, 285, 105, 
2002, Illinois, 5, 7, 0, 0.41667, 346, 307, 39, 
2003, Illinois, 1, 11, 0, 0.08333, 203, 398, -195, 
2004, Illinois, 3, 8, 0, 0.27273, 240, 323, -83, 
2013, Florida International, 1, 11, 0, 0.08333, 117, 444, -327, 
1949, Benedict (SC), 6, 1, 0, 0.85714, 156, 34, 122, 
1950, Benedict (SC), 6, 2, 1, 0.72222, 165, 73, 92, 
1922, Tuskegee (AL), 1, 5, 1, 0.21429, 31, 123, -92, 
1934, Northwestern St. (LA), 4, 3, 1, 0.56250, 50, 36, 14, 
1935, Northwestern St. (LA), 2, 9, 0, 0.18182, 55, 155, -100, 
1936, Northwestern St. (LA), 5, 4, 1, 0.55000, 64, 113, -49, 
1937, Northwestern St. (LA), 4, 4, 1, 0.50000, 35, 87, -52, 
1938, Northwestern St. (LA), 5, 5, 0, 0.50000, 93, 77, 16, 
1939, Northwestern St. (LA), 11, 0, 0, 1.00000, 195, 18, 177, 
1940, Northwestern St. (LA), 6, 3, 1, 0.65000, 111, 98, 13, 
1941, Northwestern St. (LA), 4, 3, 1, 0.56250, 73, 49, 24, 
1942, Northwestern St. (LA), 6, 2, 0, 0.75000, 135, 71, 64, 
1944, Northwestern St. (LA), 2, 4, 1, 0.35714, 61, 74, -13, 
1945, Northwestern St. (LA), 2, 6, 1, 0.27778, 35, 124, -89, 
1946, Northwestern St. (LA), 4, 6, 0, 0.40000, 142, 147, -5, 
1947, Northwestern St. (LA), 4, 5, 0, 0.44444, 110, 172, -62, 
1948, Northwestern St. (LA), 5, 3, 1, 0.61111, 209, 94, 115, 
1949, Northwestern St. (LA), 5, 4, 0, 0.55556, 171, 201, -30, 
1950, Northwestern St. (LA), 6, 4, 0, 0.60000, 219, 121, 98, 
1951, Northwestern St. (LA), 1, 8, 0, 0.11111, 139, 308, -169, 
1952, Northwestern St. (LA), 1, 7, 1, 0.16667, 59, 201, -142, 
1953, Northwestern St. (LA), 6, 2, 0, 0.75000, 94, 67, 27, 
1954, Northwestern St. (LA), 7, 2, 0, 0.77778, 210, 97, 113, 
1955, Northwestern St. (LA), 4, 5, 0, 0.44444, 142, 121, 21, 
1956, Northwestern St. (LA), 6, 2, 2, 0.70000, 157, 106, 51, 
1911, Southern Arkansas, 0, 2, 0, 0.00000, 0, 28, -28, 
1912, Southern Arkansas, 2, 2, 1, 0.50000, 65, 80, -15, 
1913, Southern Arkansas, 3, 3, 0, 0.50000, 38, 65, -27, 
1914, Southern Arkansas, 3, 2, 1, 0.58333, 158, 139, 19, 
1915, Southern Arkansas, 3, 2, 0, 0.60000, 40, 36, 4, 
1916, Southern Arkansas, 0, 5, 1, 0.08333, 0, 204, -204, 
1917, Southern Arkansas, 0, 4, 0, 0.00000, 6, 150, -144, 
1981, Fordham (NY), 5, 5, 0, 0.50000, 139, 131, 8, 
1982, Fordham (NY), 2, 8, 0, 0.20000, 140, 181, -41, 
1983, Fordham (NY), 2, 9, 0, 0.18182, 76, 249, -173, 
1984, Fordham (NY), 5, 5, 0, 0.50000, 216, 172, 44, 
1985, Fordham (NY), 6, 5, 0, 0.54545, 218, 162, 56, 
1925, Cedarville (OH), 2, 4, 1, 0.35714, 50, 65, -15, 
1927, Atlantic Christian (NC), 2, 5, 0, 0.28571, 14, 167, -153, 
1922, Brigham Young (UT), 1, 5, 0, 0.16667, 10, 184, -174, 
1923, Brigham Young (UT), 2, 5, 0, 0.28571, 47, 156, -109, 
1924, Brigham Young (UT), 2, 3, 1, 0.41667, 44, 61, -17, 
1973, Mississippi St., 4, 5, 2, 0.45455, 219, 255, -36, 
1974, Mississippi St., 9, 3, 0, 0.75000, 327, 224, 103, 
1975, Mississippi St., 2, 9, 0, 0.18182, 165, 166, -1, 
1976, Mississippi St., 0, 11, 0, 0.00000, 269, 178, 91, 
1977, Mississippi St., 0, 11, 0, 0.00000, 193, 227, -34, 
1978, Mississippi St., 6, 5, 0, 0.54545, 232, 205, 27, 
1981, North Texas, 2, 9, 0, 0.18182, 111, 235, -124, 
1898, Rhode Island, 5, 0, 0, 1.00000, 68, 6, 62, 
1899, Rhode Island, 2, 3, 1, 0.41667, 44, 50, -6, 
1900, Rhode Island, 2, 2, 3, 0.50000, 44, 58, -14, 
1901, Rhode Island, 0, 2, 0, 0.00000, 0, 37, -37, 
1903, Rhode Island, 2, 4, 1, 0.35714, 16, 149, -133, 
1904, Rhode Island, 3, 3, 1, 0.50000, 124, 72, 52, 
1905, Rhode Island, 3, 3, 1, 0.50000, 101, 51, 50, 
1906, Rhode Island, 1, 2, 1, 0.37500, 14, 53, -39, 
1907, Rhode Island, 3, 1, 2, 0.66667, 68, 17, 51, 
1908, Rhode Island, 4, 2, 0, 0.66667, 51, 16, 35, 
1913, Davis & Elkins (WV), 5, 2, 1, 0.68750, 145, 118, 27, 
2013, Sul Ross St. (TX), 1, 9, 0, 0.10000, 209, 419, -210, 
1928, Susquehanna (PA), 4, 3, 0, 0.57143, 103, 196, -93, 
1929, Susquehanna (PA), 2, 6, 0, 0.25000, 45, 76, -31, 
1930, Susquehanna (PA), 2, 4, 2, 0.37500, 67, 79, -12, 
1931, Susquehanna (PA), 2, 5, 0, 0.28571, 64, 110, -46, 
1932, Susquehanna (PA), 7, 0, 1, 0.93750, 151, 24, 127, 
1933, Susquehanna (PA), 4, 3, 0, 0.57143, 62, 35, 27, 
1934, Susquehanna (PA), 3, 3, 2, 0.50000, 46, 93, -47, 
1981, Adams St. (CO), 3, 5, 1, 0.38889, 131, 184, -53, 
1925, Wichita St. (KS), 3, 1, 4, 0.62500, 34, 60, -26, 
1926, Wichita St. (KS), 6, 2, 0, 0.75000, 73, 78, -5, 
1927, Wichita St. (KS), 3, 4, 0, 0.42857, 79, 81, -2, 
1984, Ferris St. (MI), 2, 8, 0, 0.20000, 114, 306, -192, 
1985, Ferris St. (MI), 6, 4, 0, 0.60000, 262, 214, 48, 
1969, Southern Mississippi, 5, 5, 0, 0.50000, 162, 307, -145, 
1970, Southern Mississippi, 5, 6, 0, 0.45455, 228, 299, -71, 
1971, Southern Mississippi, 6, 5, 0, 0.54545, 202, 192, 10, 
1972, Southern Mississippi, 3, 7, 1, 0.31818, 182, 231, -49, 
1973, Southern Mississippi, 6, 4, 1, 0.59091, 227, 166, 61, 
1974, Southern Mississippi, 6, 5, 0, 0.54545, 160, 195, -35, 
2013, Saint Cloud St. (MN), 12, 2, 0, 0.85714, 551, 319, 232, 
1904, North Central (IL), 3, 3, 1, 0.50000, 63, 50, 13, 
1905, North Central (IL), 0, 4, 2, 0.16667, 12, 101, -89, 
1872, Stevens Tech (NJ), 0, 1, 0, 0.00000, 0, 6, -6, 
1873, Stevens Tech (NJ), 3, 3, 0, 0.50000, 15, 13, 2, 
1874, Stevens Tech (NJ), 2, 3, 0, 0.40000, 10, 20, -10, 
1875, Stevens Tech (NJ), 4, 4, 0, 0.50000, 21, 20, 1, 
1876, Stevens Tech (NJ), 2, 3, 1, 0.41667, 16, 19, -3, 
1877, Stevens Tech (NJ), 4, 1, 1, 0.75000, 11, 15, -4, 
1878, Stevens Tech (NJ), 3, 3, 3, 0.50000, 3, 9, -6, 
1879, Stevens Tech (NJ), 2, 3, 5, 0.45000, 8, 14, -6, 
1880, Stevens Tech (NJ), 1, 5, 0, 0.16667, 3, 16, -13, 
1881, Stevens Tech (NJ), 3, 8, 3, 0.32143, 16, 29, -13, 
1882, Lawrence (WI), 7, 8, 1, 0.46875, 17, 25, -8, 
1883, Stevens Tech (NJ), 7, 6, 1, 0.53571, 187, 128, 59, 
1884, Stevens Tech (NJ), 7, 10, 0, 0.41176, 151, 261, -110, 
1885, Stevens Tech (NJ), 5, 18, 1, 0.22917, 359, 622, -263, 
1886, Stevens Tech (NJ), 9, 15, 2, 0.38462, 180, 565, -385, 
1887, Stevens Tech (NJ), 8, 12, 1, 0.40476, 157, 445, -288, 
1888, Stevens Tech (NJ), 6, 17, 3, 0.28846, 192, 787, -595, 
1889, New York (NY), 8, 21, 4, 0.30303, 278, 647, -369, 
1890, New York (NY), 25, 14, 2, 0.63415, 727, 538, 189, 
1891, Delaware, 33, 30, 7, 0.52143, 982, 985, -3, 
1892, Beloit (WI), 29, 31, 3, 0.48413, 726, 797, -71, 
1893, Saint Mary's (CA), 39, 35, 3, 0.52597, 1091, 903, 188, 
1894, Manhattan (NY), 38, 33, 8, 0.53165, 971, 750, 221, 
1895, Delaware, 44, 36, 6, 0.54651, 889, 844, 45, 
1896, Manhattan (NY), 51, 49, 6, 0.50943, 949, 1164, -215, 
1897, Stevens Tech (NJ), 37, 50, 4, 0.42857, 661, 1048, -387, 
1898, Saint Mary's (CA), 37, 43, 9, 0.46629, 781, 1050, -269, 
1899, Manhattan (NY), 35, 41, 6, 0.46341, 599, 1074, -475, 
1900, Manhattan (NY), 44, 47, 11, 0.48529, 997, 1049, -52, 
1901, Ferris St. (MI), 51, 44, 7, 0.53431, 906, 852, 54, 
1902, Tulsa (OK), 56, 48, 5, 0.53670, 1053, 927, 126, 
1903, Manhattan (NY), 30, 48, 7, 0.39412, 762, 1303, -541, 
1904, Saint Francis (NY), 45, 55, 9, 0.45413, 803, 1396, -593, 
1905, Bluffton (OH), 40, 60, 5, 0.40476, 879, 1490, -611, 
1906, Ferris St. (MI), 30, 41, 11, 0.43293, 637, 820, -183, 
1907, Ferris St. (MI), 30, 43, 11, 0.42262, 597, 1113, -516, 
1908, Western Illinois, 34, 42, 10, 0.45349, 726, 907, -181, 
1909, Stevens Tech (NJ), 23, 52, 3, 0.31410, 509, 1264, -755, 
1910, East Stroudsburg (PA), 20, 30, 4, 0.40741, 422, 754, -332, 
1911, Western Illinois, 30, 44, 5, 0.41139, 560, 867, -307, 
1912, Indiana (PA), 37, 56, 7, 0.40500, 1140, 1463, -323, 
1913, Saint Francis (NY), 47, 66, 8, 0.42149, 1472, 2391, -919, 
1914, Delaware Valley (PA), 42, 50, 6, 0.45918, 1220, 1585, -365, 
1915, Western Illinois, 34, 35, 11, 0.49375, 932, 1217, -285, 
1916, Morgan St. (MD), 45, 44, 7, 0.50521, 1506, 1286, 220, 
1917, Morgan St. (MD), 21, 23, 2, 0.47826, 414, 934, -520, 
1918, Arkansas St., 7, 21, 2, 0.26667, 264, 467, -203, 
1919, Western Illinois, 48, 42, 7, 0.53093, 1296, 1108, 188, 
1920, Virginia Union, 28, 40, 2, 0.41429, 506, 913, -407, 
1921, Cooper Union (NY), 20, 34, 4, 0.37931, 446, 1112, -666, 
1922, North Carolina A&T;, 28, 36, 6, 0.44286, 729, 941, -212, 
1923, Cooper Union (NY), 27, 44, 2, 0.38356, 630, 1077, -447, 
1924, East Stroudsburg (PA), 36, 42, 7, 0.46471, 998, 1243, -245, 
1925, Saint Anselm (NH), 41, 30, 10, 0.56790, 1082, 897, 185, 
1926, Saint Anselm (NH), 25, 31, 5, 0.45082, 695, 785, -90, 
1927, Bethune-Cookman (FL), 30, 33, 9, 0.47917, 961, 902, 59, 
1928, Saint Anselm (NH), 28, 24, 7, 0.53390, 564, 1095, -531, 
1929, Saint Anselm (NH), 26, 32, 5, 0.45238, 623, 843, -220, 
1930, Saint Anselm (NH), 38, 28, 12, 0.56410, 812, 580, 232, 
1931, Campbell (NC), 22, 17, 5, 0.55682, 471, 428, 43, 
1932, Fort Valley St. (GA), 18, 35, 3, 0.34821, 585, 859, -274, 
1933, Campbell (NC), 22, 16, 3, 0.57317, 503, 406, 97, 
1934, Fort Valley St. (GA), 14, 9, 5, 0.58929, 444, 187, 257, 
1935, Florida Southern, 7, 15, 2, 0.33333, 177, 210, -33, 
1936, Stillman (AL), 5, 8, 1, 0.39286, 166, 203, -37, 
1937, Albany St. (GA), 6, 8, 0, 0.42857, 104, 241, -137, 
1938, West Alabama, 9, 11, 0, 0.45000, 176, 255, -79, 
1939, Elizabeth City St. (NC), 11, 18, 0, 0.37931, 240, 390, -150, 
1940, Elizabeth City St. (NC), 15, 11, 4, 0.56667, 368, 293, 75, 
1941, Fort Valley St. (GA), 4, 16, 7, 0.27778, 198, 504, -306, 
1942, Brevard College (NC), 12, 6, 2, 0.65000, 257, 189, 68, 
1943, Clark Atlanta (GA), 12, 8, 0, 0.60000, 338, 225, 113, 
1944, Abilene Christian (TX), 9, 11, 1, 0.45238, 158, 255, -97, 
1945, Albany St. (GA), 14, 25, 2, 0.36585, 424, 519, -95, 
1946, Fort Valley St. (GA), 7, 35, 3, 0.18889, 172, 1116, -944, 
1947, Fort Valley St. (GA), 11, 12, 4, 0.48148, 205, 439, -234, 
1948, Virginia-Lynchburg, 8, 11, 2, 0.42857, 157, 406, -249, 
1949, Virginia-Lynchburg, 8, 10, 2, 0.45000, 333, 283, 50, 
1950, Virginia-Lynchburg, 2, 3, 0, 0.40000, 53, 98, -45, 
1951, Lane (TN), 8, 6, 0, 0.57143, 295, 234, 61, 
1952, Lane (TN), 9, 5, 1, 0.63333, 220, 206, 14, 
1953, Lane (TN), 1, 7, 0, 0.12500, 58, 215, -157, 
1954, Lane (TN), 2, 6, 0, 0.25000, 105, 135, -30, 
1955, Lane (TN), 2, 4, 0, 0.33333, 83, 129, -46, 
1957, San Francisco (CA), 2, 9, 0, 0.18182, 119, 222, -103, 
1958, San Francisco (CA), 2, 2, 0, 0.50000, 58, 93, -35, 
1959, Azusa Pacific (CA), 2, 6, 0, 0.25000, 131, 170, -39, 
1960, Azusa Pacific (CA), 4, 3, 1, 0.56250, 103, 76, 27, 
1961, Azusa Pacific (CA), 3, 3, 0, 0.50000, 123, 147, -24, 
1963, San Francisco (CA), 2, 5, 0, 0.28571, 58, 98, -40, 
1964, New York (NY), 0, 2, 0, 0.00000, 20, 48, -28, 
1965, Adelphi (NY), 4, 8, 0, 0.33333, 198, 216, -18, 
1966, Fairfield (CT), 18, 22, 2, 0.45238, 545, 652, -107, 
1967, La Salle (PA), 25, 31, 0, 0.44643, 846, 1080, -234, 
1968, Centenary (LA), 17, 42, 2, 0.29508, 726, 1393, -667, 
1969, Bluffton (OH), 33, 44, 0, 0.42857, 1058, 1557, -499, 
1970, Saint John's (NY), 35, 55, 1, 0.39011, 1396, 1806, -410, 
1971, Bluffton (OH), 43, 47, 1, 0.47802, 1380, 1420, -40, 
1972, Marquette (WI), 39, 44, 2, 0.47059, 1217, 1352, -135, 
1973, Brooklyn (NY), 30, 52, 1, 0.36747, 1007, 1611, -604, 
1974, Marquette (WI), 33, 36, 3, 0.47917, 959, 1169, -210, 
1975, Marquette (WI), 31, 22, 4, 0.57895, 1042, 932, 110, 
1976, Bluffton (OH), 23, 33, 1, 0.41228, 862, 1186, -324, 
1977, Manhattan (NY), 14, 28, 1, 0.33721, 568, 923, -355, 
1978, Fairfield (CT), 5, 7, 1, 0.42308, 194, 203, -9, 
1979, Fairfield (CT), 10, 10, 0, 0.50000, 265, 272, -7, 
1980, Westfield St. (MA), 6, 5, 4, 0.53333, 184, 196, -12, 
1981, San Francisco (CA), 17, 16, 0, 0.51515, 585, 541, 44, 
1982, Manhattan (NY), 18, 20, 0, 0.47368, 592, 767, -175, 
1983, SUNY-Stony Brook (NY), 15, 11, 0, 0.57692, 474, 453, 21, 
1984, Stonehill (MA), 7, 12, 0, 0.36842, 231, 439, -208, 
1985, Manhattan (NY), 10, 10, 0, 0.50000, 313, 316, -3, 
1986, Marquette (WI), 13, 17, 0, 0.43333, 497, 564, -67, 
1987, Marquette (WI), 10, 17, 0, 0.37037, 389, 487, -98, 
1988, Marquette (WI), 1, 5, 0, 0.16667, 80, 125, -45, 
1989, Marquette (WI), 4, 4, 0, 0.50000, 209, 151, 58, 
1990, Marquette (WI), 1, 7, 0, 0.12500, 80, 180, -100, 
1991, Marquette (WI), 1, 5, 0, 0.16667, 106, 182, -76, 
1992, Marquette (WI), 2, 5, 0, 0.28571, 81, 129, -48, 
1993, Marquette (WI), 7, 1, 0, 0.87500, 212, 126, 86, 
1994, Marquette (WI), 1, 6, 0, 0.14286, 125, 184, -59, 
1995, Marquette (WI), 3, 4, 0, 0.42857, 141, 191, -50, 
1996, Marquette (WI), 3, 5, 0, 0.37500, 139, 182, -43, 
1998, Madison College (WI), 2, 15, 0, 0.11765, 221, 613, -392, 
1999, Marquette (WI), 0, 7, 0, 0.00000, 110, 298, -188, 
2000, Marquette (WI), 1, 5, 0, 0.16667, 60, 96, -36, 
2001, Marquette (WI), 2, 7, 0, 0.22222, 156, 208, -52, 
2002, Marquette (WI), 4, 4, 0, 0.50000, 169, 222, -53, 
2003, Marquette (WI), 1, 6, 0, 0.14286, 71, 151, -80, 
2004, Stevens Tech (NJ), 0, 7, 0, 0.00000, 59, 281, -222, 
2005, Stevens Tech (NJ), 2, 6, 0, 0.25000, 92, 250, -158, 
2006, Stevens Tech (NJ), 1, 7, 0, 0.12500, 75, 235, -160, 
2007, Marquette (WI), 3, 5, 0, 0.37500, 162, 236, -74, 
2008, Stevens Tech (NJ), 0, 8, 0, 0.00000, 75, 325, -250, 
2009, Stevens Tech (NJ), 0, 2, 0, 0.00000, 14, 62, -48, 
2011, Stevens Tech (NJ), 0, 1, 0, 0.00000, 27, 49, -22, 
2012, Stevens Tech (NJ), 0, 2, 0, 0.00000, 26, 48, -22, 
2013, Stevens Tech (NJ), 0, 2, 0, 0.00000, 13, 74, -61, 
1905, Idaho St., 3, 0, 2, 0.80000, 94, 13, 81, 
1906, Idaho St., 0, 2, 1, 0.16667, 0, 10, -10, 
1919, Jamestown (ND), 2, 2, 0, 0.50000, 59, 26, 33, 
1920, Jamestown (ND), 5, 0, 1, 0.91667, 237, 7, 230, 
1930, Tennessee St., 2, 3, 0, 0.40000, 63, 39, 24, 
1931, Tennessee St., 1, 1, 0, 0.50000, 13, 30, -17, 
1895, Vanderbilt (TN), 5, 3, 1, 0.61111, 67, 50, 17, 
1921, Canisius (NY), 4, 3, 2, 0.55556, 96, 74, 22, 
1922, Canisius (NY), 5, 2, 1, 0.68750, 170, 38, 132, 
1923, Canisius (NY), 8, 1, 0, 0.88889, 227, 21, 206, 
1924, Canisius (NY), 4, 3, 0, 0.57143, 59, 103, -44, 
1925, Canisius (NY), 4, 4, 0, 0.50000, 40, 100, -60, 
1926, Canisius (NY), 2, 5, 1, 0.31250, 52, 83, -31, 
1927, Canisius (NY), 7, 1, 0, 0.87500, 173, 42, 131, 
1928, Canisius (NY), 5, 1, 1, 0.78571, 48, 37, 11, 
1929, Canisius (NY), 3, 4, 1, 0.43750, 53, 129, -76, 
1930, Canisius (NY), 4, 3, 1, 0.56250, 99, 90, 9, 
1969, Eureka (IL), 1, 7, 0, 0.12500, 79, 186, -107, 
1970, Eureka (IL), 5, 3, 0, 0.62500, 144, 113, 31, 
1971, Eureka (IL), 3, 5, 1, 0.38889, 101, 202, -101, 
1972, Eureka (IL), 2, 5, 1, 0.31250, 94, 200, -106, 
1973, Eureka (IL), 3, 6, 0, 0.33333, 115, 181, -66, 
1945, Parsons (IA), 1, 5, 0, 0.16667, 32, 106, -74, 
1966, Buffalo (NY), 5, 5, 0, 0.50000, 220, 172, 48, 
1967, Buffalo (NY), 6, 4, 0, 0.60000, 241, 191, 50, 
1968, Buffalo (NY), 7, 3, 0, 0.70000, 185, 183, 2, 
1969, Northern Illinois, 3, 7, 0, 0.30000, 191, 284, -93, 
1970, Northern Illinois, 3, 7, 0, 0.30000, 168, 281, -113, 
1967, Wabash (IN), 2, 7, 0, 0.22222, 58, 213, -155, 
1968, Wabash (IN), 3, 6, 0, 0.33333, 105, 197, -92, 
1969, Wabash (IN), 3, 6, 0, 0.33333, 142, 155, -13, 
1970, Wabash (IN), 3, 3, 2, 0.50000, 178, 136, 42, 
1921, Lenoir-Rhyne (NC), 2, 4, 0, 0.33333, 104, 209, -105, 
1975, Western Michigan, 1, 10, 0, 0.09091, 119, 297, -178, 
1976, Western Michigan, 7, 4, 0, 0.63636, 270, 202, 68, 
1977, Western Michigan, 4, 7, 0, 0.36364, 254, 231, 23, 
1978, Western Michigan, 7, 4, 0, 0.63636, 220, 152, 68, 
1979, Western Michigan, 6, 5, 0, 0.54545, 186, 127, 59, 
1980, Western Michigan, 7, 4, 0, 0.63636, 233, 179, 54, 
1981, Western Michigan, 6, 5, 0, 0.54545, 206, 170, 36, 
1987, Navy (MD), 2, 9, 0, 0.18182, 160, 317, -157, 
1988, Navy (MD), 3, 8, 0, 0.27273, 221, 274, -53, 
1989, Navy (MD), 3, 8, 0, 0.27273, 145, 272, -127, 
1986, Allegheny (PA), 6, 4, 0, 0.60000, 171, 118, 53, 
1987, Allegheny (PA), 9, 1, 1, 0.86364, 257, 125, 132, 
1988, Allegheny (PA), 8, 2, 0, 0.80000, 252, 145, 107, 
1989, Allegheny (PA), 6, 4, 0, 0.60000, 210, 148, 62, 
1992, Holy Cross (MA), 6, 5, 0, 0.54545, 153, 175, -22, 
1993, Holy Cross (MA), 3, 8, 0, 0.27273, 205, 326, -121, 
1994, Holy Cross (MA), 3, 8, 0, 0.27273, 175, 327, -152, 
1995, Holy Cross (MA), 2, 9, 0, 0.18182, 180, 326, -146, 
1903, Richmond (VA), 6, 3, 1, 0.65000, 168, 94, 74, 
